id,LVal,RVal,DiffVal,TotVal,DCE,DICE,LogLVal,LogRVal,LogDiff,LogTot,LogDCE,LogDICE,ChosenITM,CorrectITM,Corr,ChoiceRT,Conf,ConfRT,BlockCond
1,100,112,12,212,112,100,4.60517018598809,4.71849887129509,0.113328685307002,9.32366905728319,4.71849887129509,4.60517018598809,1,0,0,1.645,2,0.915,LESS
1,100,102,2,202,102,100,4.60517018598809,4.62497281328427,0.0198026272961789,9.23014299927236,4.62497281328427,4.60517018598809,1,0,0,2.607,3,0.679,LESS
1,100,86,14,186,86,100,4.60517018598809,4.45434729625351,0.150822889734584,9.0595174822416,4.45434729625351,4.60517018598809,1,1,1,2.167,2,0.857,LESS
1,150,141,9,291,150,141,5.01063529409626,4.94875989037817,0.0618754037180871,9.95939518447442,5.01063529409626,4.94875989037817,0,1,0,1.691,1,0.636,LESS
1,168,150,18,318,168,150,5.12396397940326,5.01063529409626,0.113328685307003,10.1345992734995,5.12396397940326,5.01063529409626,0,1,0,3.458,1,0.676,LESS
1,102,100,2,202,100,102,4.62497281328427,4.60517018598809,0.0198026272961789,9.23014299927236,4.60517018598809,4.62497281328427,1,1,1,3.403,2,1.141,LESS
1,92,100,8,192,100,92,4.52178857704904,4.60517018598809,0.0833816089390513,9.12695876303713,4.60517018598809,4.52178857704904,1,0,0,2.398,4,0.519,LESS
1,135,150,15,285,150,135,4.90527477843843,5.01063529409626,0.105360515657826,9.91591007253469,5.01063529409626,4.90527477843843,1,0,0,2.47,2,0.741,LESS
1,171,150,21,321,150,171,5.14166355650266,5.01063529409626,0.131028262406405,10.1522988505989,5.01063529409626,5.14166355650266,1,1,1,1.585,2,0.78,LESS
1,47,50,3,97,47,50,3.85014760171006,3.91202300542815,0.0618754037180875,7.7621706071382,3.85014760171006,3.91202300542815,0,0,1,1.718,2,1.624,LESS
1,55,50,5,105,50,55,4.00733318523247,3.91202300542815,0.0953101798043252,7.91935619066062,3.91202300542815,4.00733318523247,1,1,1,1.424,4,0.855,LESS
1,150,180,30,330,150,180,5.01063529409626,5.19295685089021,0.182321556793955,10.2035921449865,5.01063529409626,5.19295685089021,0,0,1,2.755,2,0.578,LESS
1,132,150,18,282,132,150,4.88280192258637,5.01063529409626,0.127833371509885,9.89343721668263,4.88280192258637,5.01063529409626,0,0,1,2.109,1,0.526,LESS
1,59,50,9,109,50,59,4.07753744390572,3.91202300542815,0.165514438477574,7.98956044933387,3.91202300542815,4.07753744390572,1,1,1,1.458,3,0.645,LESS
1,100,84,16,184,84,100,4.60517018598809,4.43081679884331,0.174353387144778,9.03598698483141,4.43081679884331,4.60517018598809,1,1,1,1.544,2,0.501,LESS
1,50,53,3,103,50,53,3.91202300542815,3.97029191355212,0.058268908123976,7.88231491898027,3.91202300542815,3.97029191355212,0,0,1,2.048,1,0.42,LESS
1,100,104,4,204,100,104,4.60517018598809,4.64439089914137,0.0392207131532807,9.24956108512946,4.60517018598809,4.64439089914137,0,0,1,1.942,1,1.004,LESS
1,40,50,10,90,40,50,3.68887945411394,3.91202300542815,0.22314355131421,7.60090245954208,3.68887945411394,3.91202300542815,0,0,1,1.159,3,0.708,LESS
1,120,100,20,220,100,120,4.78749174278205,4.60517018598809,0.182321556793954,9.39266192877014,4.60517018598809,4.78749174278205,1,1,1,1.306,2,0.538,LESS
1,150,177,27,327,150,177,5.01063529409626,5.17614973257383,0.165514438477573,10.1867850266701,5.01063529409626,5.17614973257383,0,0,1,1.244,2,0.572,LESS
1,40,50,10,90,40,50,3.68887945411394,3.91202300542815,0.22314355131421,7.60090245954208,3.68887945411394,3.91202300542815,0,0,1,1.361,3,0.594,LESS
1,100,84,16,184,84,100,4.60517018598809,4.43081679884331,0.174353387144778,9.03598698483141,4.43081679884331,4.60517018598809,1,1,1,1.635,3,0.553,LESS
1,41,50,9,91,50,41,3.71357206670431,3.91202300542815,0.198450938723838,7.62559507213245,3.91202300542815,3.71357206670431,1,0,0,1.406,3,0.781,LESS
1,52,50,2,102,50,52,3.95124371858143,3.91202300542815,0.0392207131532816,7.86326672400957,3.91202300542815,3.95124371858143,1,1,1,1.713,2,0.86,LESS
1,96,100,4,196,100,96,4.56434819146784,4.60517018598809,0.0408219945202557,9.16951837745593,4.60517018598809,4.56434819146784,1,0,0,1.721,3,0.518,LESS
1,138,150,12,288,138,150,4.92725368515721,5.01063529409626,0.0833816089390504,9.93788897925346,4.92725368515721,5.01063529409626,0,0,1,1.491,1,0.952,LESS
1,150,135,15,285,150,135,5.01063529409626,4.90527477843843,0.105360515657826,9.91591007253469,5.01063529409626,4.90527477843843,0,1,0,2.437,1,0.403,LESS
1,54,50,4,104,54,50,3.98898404656427,3.91202300542815,0.0769610411361286,7.90100705199242,3.98898404656427,3.91202300542815,0,1,0,2.298,2,0.817,LESS
1,150,168,18,318,150,168,5.01063529409626,5.12396397940326,0.113328685307003,10.1345992734995,5.01063529409626,5.12396397940326,0,0,1,1.386,1,1.117,LESS
1,108,100,8,208,100,108,4.68213122712422,4.60517018598809,0.0769610411361281,9.28730141311231,4.60517018598809,4.68213122712422,1,1,1,2.239,2,0.405,LESS
1,150,171,21,321,150,171,5.01063529409626,5.14166355650266,0.131028262406405,10.1522988505989,5.01063529409626,5.14166355650266,0,0,1,1.752,1,0.381,LESS
1,50,60,10,110,50,60,3.91202300542815,4.0943445622221,0.182321556793954,8.00636756765025,3.91202300542815,4.0943445622221,0,0,1,1.851,2,0.757,LESS
1,50,40,10,90,40,50,3.91202300542815,3.68887945411394,0.22314355131421,7.60090245954208,3.68887945411394,3.91202300542815,1,1,1,1.569,4,1.16,LESS
1,50,51,1,101,51,50,3.91202300542815,3.93182563272433,0.0198026272961798,7.84384863815247,3.93182563272433,3.91202300542815,1,0,0,1.353,3,0.543,LESS
1,100,94,6,194,94,100,4.60517018598809,4.54329478227,0.061875403718088,9.1484649682581,4.54329478227,4.60517018598809,1,1,1,1.308,4,0.664,LESS
1,171,150,21,321,171,150,5.14166355650266,5.01063529409626,0.131028262406405,10.1522988505989,5.14166355650266,5.01063529409626,0,1,0,1.115,1,0.422,LESS
1,165,150,15,315,165,150,5.10594547390058,5.01063529409626,0.0953101798043248,10.1165807679968,5.10594547390058,5.01063529409626,0,1,0,1.621,1,0.39,LESS
1,84,100,16,184,84,100,4.43081679884331,4.60517018598809,0.174353387144778,9.03598698483141,4.43081679884331,4.60517018598809,0,0,1,1.37,3,1.054,LESS
1,90,100,10,190,90,100,4.49980967033027,4.60517018598809,0.105360515657827,9.10497985631836,4.49980967033027,4.60517018598809,0,0,1,1.406,1,0.349,LESS
1,55,50,5,105,55,50,4.00733318523247,3.91202300542815,0.0953101798043252,7.91935619066062,4.00733318523247,3.91202300542815,0,1,0,1.734,2,0.936,LESS
1,118,100,18,218,100,118,4.77068462446567,4.60517018598809,0.165514438477573,9.37585481045376,4.60517018598809,4.77068462446567,1,1,1,1.588,2,0.726,LESS
1,129,150,21,279,129,150,4.85981240436167,5.01063529409626,0.150822889734584,9.87044769845793,4.85981240436167,5.01063529409626,0,0,1,1.314,2,0.714,LESS
1,100,80,20,180,80,100,4.60517018598809,4.38202663467388,0.223143551314211,8.98719682066197,4.38202663467388,4.60517018598809,1,1,1,1.234,3,0.435,LESS
1,159,150,9,309,159,150,5.06890420222023,5.01063529409626,0.058268908123976,10.0795394963165,5.06890420222023,5.01063529409626,0,1,0,1.195,1,0.349,LESS
1,168,150,18,318,150,168,5.12396397940326,5.01063529409626,0.113328685307003,10.1345992734995,5.01063529409626,5.12396397940326,1,1,1,1.383,3,0.458,LESS
1,100,88,12,188,88,100,4.60517018598809,4.47733681447821,0.127833371509885,9.0825070004663,4.47733681447821,4.60517018598809,1,1,1,1.725,2,0.763,LESS
1,102,100,2,202,100,102,4.62497281328427,4.60517018598809,0.0198026272961789,9.23014299927236,4.60517018598809,4.62497281328427,1,1,1,1.876,1,0.359,LESS
1,90,100,10,190,90,100,4.49980967033027,4.60517018598809,0.105360515657827,9.10497985631836,4.49980967033027,4.60517018598809,0,0,1,1.572,1,0.404,LESS
1,153,150,3,303,153,150,5.03043792139244,5.01063529409626,0.0198026272961798,10.0410732154887,5.03043792139244,5.01063529409626,0,1,0,1.294,1,0.36,LESS
1,59,50,9,109,50,59,4.07753744390572,3.91202300542815,0.165514438477574,7.98956044933387,3.91202300542815,4.07753744390572,1,1,1,2.002,2,0.565,LESS
1,88,100,12,188,88,100,4.47733681447821,4.60517018598809,0.127833371509885,9.0825070004663,4.47733681447821,4.60517018598809,0,0,1,1.386,1,0.39,LESS
1,150,174,24,324,150,174,5.01063529409626,5.15905529921453,0.148420005118274,10.1696905933108,5.01063529409626,5.15905529921453,0,0,1,1.103,1,0.415,LESS
1,150,174,24,324,150,174,5.01063529409626,5.15905529921453,0.148420005118274,10.1696905933108,5.01063529409626,5.15905529921453,0,0,1,1.507,1,0.697,LESS
1,50,43,7,93,43,50,3.91202300542815,3.76120011569356,0.150822889734584,7.67322312112171,3.76120011569356,3.91202300542815,1,1,1,1.307,4,0.381,LESS
1,141,150,9,291,150,141,4.94875989037817,5.01063529409626,0.0618754037180871,9.95939518447442,5.01063529409626,4.94875989037817,1,0,0,1.906,2,0.338,LESS
1,50,41,9,91,41,50,3.91202300542815,3.71357206670431,0.198450938723838,7.62559507213245,3.71357206670431,3.91202300542815,1,1,1,1.217,4,0.429,LESS
1,49,50,1,99,49,50,3.89182029811063,3.91202300542815,0.0202027073175195,7.80384330353877,3.89182029811063,3.91202300542815,0,0,1,1.302,1,0.352,LESS
1,180,150,30,330,180,150,5.19295685089021,5.01063529409626,0.182321556793955,10.2035921449865,5.19295685089021,5.01063529409626,0,1,0,1.109,1,0.393,LESS
1,82,100,18,182,82,100,4.40671924726425,4.60517018598809,0.198450938723838,9.01188943325235,4.40671924726425,4.60517018598809,0,0,1,1.583,2,0.314,LESS
1,100,114,14,214,114,100,4.60517018598809,4.7361984483945,0.131028262406404,9.34136863438259,4.7361984483945,4.60517018598809,1,0,0,1.542,3,0.421,LESS
1,56,50,6,106,50,56,4.02535169073515,3.91202300542815,0.113328685307004,7.9373746961633,3.91202300542815,4.02535169073515,1,1,1,1.246,3,0.403,LESS
1,150,156,6,306,150,156,5.01063529409626,5.04985600724954,0.0392207131532816,10.0604913013458,5.01063529409626,5.04985600724954,0,0,1,1.099,1,0.342,LESS
1,100,96,4,196,96,100,4.60517018598809,4.56434819146784,0.0408219945202557,9.16951837745593,4.56434819146784,4.60517018598809,1,1,1,1.248,3,0.423,LESS
1,54,50,4,104,50,54,3.98898404656427,3.91202300542815,0.0769610411361286,7.90100705199242,3.91202300542815,3.98898404656427,1,1,1,1.072,4,0.368,LESS
1,106,100,6,206,106,100,4.66343909411207,4.60517018598809,0.0582689081239751,9.26860928010016,4.66343909411207,4.60517018598809,0,1,0,1.354,1,0.345,LESS
1,49,50,1,99,50,49,3.89182029811063,3.91202300542815,0.0202027073175195,7.80384330353877,3.91202300542815,3.89182029811063,1,0,0,2.178,2,0.495,LESS
1,46,50,4,96,46,50,3.8286413964891,3.91202300542815,0.0833816089390509,7.74066440191724,3.8286413964891,3.91202300542815,0,0,1,1.559,1,0.371,LESS
1,48,50,2,98,50,48,3.87120101090789,3.91202300542815,0.0408219945202548,7.78322401633604,3.91202300542815,3.87120101090789,1,0,0,1.372,2,0.961,LESS
1,96,100,4,196,96,100,4.56434819146784,4.60517018598809,0.0408219945202557,9.16951837745593,4.56434819146784,4.60517018598809,0,0,1,1.245,1,0.755,LESS
1,50,58,8,108,58,50,3.91202300542815,4.06044301054642,0.148420005118273,7.97246601597456,4.06044301054642,3.91202300542815,1,0,0,1.403,3,0.37,LESS
1,46,50,4,96,50,46,3.8286413964891,3.91202300542815,0.0833816089390509,7.74066440191724,3.91202300542815,3.8286413964891,1,0,0,1.246,4,0.418,LESS
1,100,98,2,198,100,98,4.60517018598809,4.58496747867057,0.0202027073175195,9.19013766465866,4.60517018598809,4.58496747867057,0,1,0,1.084,1,1.286,LESS
1,100,106,6,206,106,100,4.60517018598809,4.66343909411207,0.0582689081239751,9.26860928010016,4.66343909411207,4.60517018598809,1,0,0,1.689,1,0.52,LESS
1,108,100,8,208,100,108,4.68213122712422,4.60517018598809,0.0769610411361281,9.28730141311231,4.60517018598809,4.68213122712422,1,1,1,1.289,3,0.415,LESS
1,100,96,4,196,100,96,4.60517018598809,4.56434819146784,0.0408219945202557,9.16951837745593,4.60517018598809,4.56434819146784,0,1,0,1.344,1,0.373,LESS
1,98,100,2,198,100,98,4.58496747867057,4.60517018598809,0.0202027073175195,9.19013766465866,4.60517018598809,4.58496747867057,1,0,0,1.536,1,0.496,LESS
1,100,106,6,206,100,106,4.60517018598809,4.66343909411207,0.0582689081239751,9.26860928010016,4.60517018598809,4.66343909411207,0,0,1,1.002,1,0.426,LESS
1,86,100,14,186,86,100,4.45434729625351,4.60517018598809,0.150822889734584,9.0595174822416,4.45434729625351,4.60517018598809,0,0,1,1.173,3,0.544,LESS
1,100,88,12,188,100,88,4.60517018598809,4.47733681447821,0.127833371509885,9.0825070004663,4.60517018598809,4.47733681447821,0,1,0,1.442,1,0.367,LESS
1,50,60,10,110,50,60,3.91202300542815,4.0943445622221,0.182321556793954,8.00636756765025,3.91202300542815,4.0943445622221,0,0,1,2.106,1,0.541,LESS
1,132,150,18,282,132,150,4.88280192258637,5.01063529409626,0.127833371509885,9.89343721668263,4.88280192258637,5.01063529409626,0,0,1,1.04,1,0.315,LESS
1,50,57,7,107,50,57,3.91202300542815,4.04305126783455,0.131028262406404,7.9550742732627,3.91202300542815,4.04305126783455,0,0,1,2.522,1,0.392,LESS
1,44,50,6,94,44,50,3.78418963391826,3.91202300542815,0.127833371509885,7.69621263934641,3.78418963391826,3.91202300542815,0,0,1,1.559,2,0.776,LESS
1,162,150,12,312,162,150,5.08759633523238,5.01063529409626,0.0769610411361281,10.0982316293286,5.08759633523238,5.01063529409626,0,1,0,0.953,1,0.556,LESS
1,100,120,20,220,100,120,4.60517018598809,4.78749174278205,0.182321556793954,9.39266192877014,4.60517018598809,4.78749174278205,0,0,1,2.335,2,0.456,LESS
1,150,162,12,312,150,162,5.01063529409626,5.08759633523238,0.0769610411361281,10.0982316293286,5.01063529409626,5.08759633523238,0,0,1,0.964,1,0.364,LESS
1,50,55,5,105,55,50,3.91202300542815,4.00733318523247,0.0953101798043252,7.91935619066062,4.00733318523247,3.91202300542815,1,0,0,1.312,3,0.382,LESS
1,44,50,6,94,44,50,3.78418963391826,3.91202300542815,0.127833371509885,7.69621263934641,3.78418963391826,3.91202300542815,0,0,1,1.71,2,0.337,LESS
1,100,82,18,182,100,82,4.60517018598809,4.40671924726425,0.198450938723838,9.01188943325235,4.60517018598809,4.40671924726425,0,1,0,1.195,1,0.359,LESS
1,50,45,5,95,45,50,3.91202300542815,3.80666248977032,0.105360515657826,7.71868549519847,3.80666248977032,3.91202300542815,1,1,1,1.051,4,0.376,LESS
1,48,50,2,98,50,48,3.87120101090789,3.91202300542815,0.0408219945202548,7.78322401633604,3.91202300542815,3.87120101090789,1,0,0,1.95,3,0.344,LESS
1,104,100,4,204,104,100,4.64439089914137,4.60517018598809,0.0392207131532807,9.24956108512946,4.64439089914137,4.60517018598809,0,1,0,1.191,1,0.287,LESS
1,110,100,10,210,100,110,4.70048036579242,4.60517018598809,0.0953101798043248,9.30565055178051,4.60517018598809,4.70048036579242,1,1,1,1.205,1,0.599,LESS
1,50,56,6,106,50,56,3.91202300542815,4.02535169073515,0.113328685307004,7.9373746961633,3.91202300542815,4.02535169073515,0,0,1,1.989,1,0.465,LESS
1,104,100,4,204,100,104,4.64439089914137,4.60517018598809,0.0392207131532807,9.24956108512946,4.60517018598809,4.64439089914137,1,1,1,1.07,1,0.533,LESS
1,50,41,9,91,41,50,3.91202300542815,3.71357206670431,0.198450938723838,7.62559507213245,3.71357206670431,3.91202300542815,1,1,1,1.146,4,0.416,LESS
1,50,52,2,102,50,52,3.91202300542815,3.95124371858143,0.0392207131532816,7.86326672400957,3.91202300542815,3.95124371858143,0,0,1,1.194,2,0.502,LESS
1,50,59,9,109,59,50,3.91202300542815,4.07753744390572,0.165514438477574,7.98956044933387,4.07753744390572,3.91202300542815,1,0,0,1.375,1,0.36,LESS
1,141,150,9,291,141,150,4.94875989037817,5.01063529409626,0.0618754037180871,9.95939518447442,4.94875989037817,5.01063529409626,0,0,1,1.117,1,0.469,LESS
1,150,168,18,318,168,150,5.01063529409626,5.12396397940326,0.113328685307003,10.1345992734995,5.12396397940326,5.01063529409626,1,0,0,1.089,1,0.385,LESS
1,53,50,3,103,53,50,3.97029191355212,3.91202300542815,0.058268908123976,7.88231491898027,3.97029191355212,3.91202300542815,0,1,0,1.537,1,0.37,LESS
1,100,114,14,214,114,100,4.60517018598809,4.7361984483945,0.131028262406404,9.34136863438259,4.7361984483945,4.60517018598809,1,0,0,1.125,2,0.455,LESS
1,138,150,12,288,138,150,4.92725368515721,5.01063529409626,0.0833816089390504,9.93788897925346,4.92725368515721,5.01063529409626,0,0,1,1.009,1,0.37,LESS
1,156,150,6,306,150,156,5.04985600724954,5.01063529409626,0.0392207131532816,10.0604913013458,5.01063529409626,5.04985600724954,1,1,1,1.486,2,0.502,LESS
1,150,147,3,297,150,147,5.01063529409626,4.99043258677874,0.0202027073175195,10.001067880875,5.01063529409626,4.99043258677874,0,1,0,1.032,1,0.344,LESS
1,123,150,27,273,150,123,4.81218435537242,5.01063529409626,0.198450938723838,9.82281964946867,5.01063529409626,4.81218435537242,1,0,0,1.857,2,0.384,LESS
1,100,82,18,182,82,100,4.60517018598809,4.40671924726425,0.198450938723838,9.01188943325235,4.40671924726425,4.60517018598809,1,1,1,1.081,3,0.378,LESS
1,60,50,10,110,50,60,4.0943445622221,3.91202300542815,0.182321556793954,8.00636756765025,3.91202300542815,4.0943445622221,1,1,1,1.204,4,0.398,LESS
1,150,153,3,303,150,153,5.01063529409626,5.03043792139244,0.0198026272961798,10.0410732154887,5.01063529409626,5.03043792139244,0,0,1,1.084,1,0.348,LESS
1,50,46,4,96,46,50,3.91202300542815,3.8286413964891,0.0833816089390509,7.74066440191724,3.8286413964891,3.91202300542815,1,1,1,1.157,3,0.578,LESS
1,159,150,9,309,159,150,5.06890420222023,5.01063529409626,0.058268908123976,10.0795394963165,5.06890420222023,5.01063529409626,0,1,0,1.284,1,0.344,LESS
1,100,92,8,192,92,100,4.60517018598809,4.52178857704904,0.0833816089390513,9.12695876303713,4.52178857704904,4.60517018598809,1,1,1,1.239,2,0.408,LESS
1,94,100,6,194,94,100,4.54329478227,4.60517018598809,0.061875403718088,9.1484649682581,4.54329478227,4.60517018598809,0,0,1,0.986,1,0.371,LESS
1,56,50,6,106,56,50,4.02535169073515,3.91202300542815,0.113328685307004,7.9373746961633,4.02535169073515,3.91202300542815,0,1,0,1.747,1,0.31,LESS
1,100,116,16,216,100,116,4.60517018598809,4.75359019110636,0.148420005118273,9.35876037709446,4.60517018598809,4.75359019110636,0,0,1,1.05,2,0.61,LESS
1,50,57,7,107,57,50,3.91202300542815,4.04305126783455,0.131028262406404,7.9550742732627,4.04305126783455,3.91202300542815,1,0,0,1.611,3,0.586,LESS
1,150,120,30,270,150,120,5.01063529409626,4.78749174278205,0.22314355131421,9.7981270368783,5.01063529409626,4.78749174278205,0,1,0,1.041,1,0.3,LESS
1,165,150,15,315,150,165,5.10594547390058,5.01063529409626,0.0953101798043248,10.1165807679968,5.01063529409626,5.10594547390058,1,1,1,1.173,1,0.47,LESS
1,94,100,6,194,94,100,4.54329478227,4.60517018598809,0.061875403718088,9.1484649682581,4.54329478227,4.60517018598809,0,0,1,1.195,1,0.359,LESS
1,60,50,10,110,50,60,4.0943445622221,3.91202300542815,0.182321556793954,8.00636756765025,3.91202300542815,4.0943445622221,1,1,1,1.222,4,0.614,LESS
1,51,50,1,101,51,50,3.93182563272433,3.91202300542815,0.0198026272961798,7.84384863815247,3.93182563272433,3.91202300542815,0,1,0,1.453,1,0.636,LESS
1,100,94,6,194,100,94,4.60517018598809,4.54329478227,0.061875403718088,9.1484649682581,4.60517018598809,4.54329478227,0,1,0,0.957,1,1.403,LESS
1,177,150,27,327,150,177,5.17614973257383,5.01063529409626,0.165514438477573,10.1867850266701,5.01063529409626,5.17614973257383,1,1,1,1.422,2,0.412,LESS
1,50,47,3,97,50,47,3.91202300542815,3.85014760171006,0.0618754037180875,7.7621706071382,3.91202300542815,3.85014760171006,0,1,0,1.873,1,0.435,LESS
1,135,150,15,285,150,135,4.90527477843843,5.01063529409626,0.105360515657826,9.91591007253469,5.01063529409626,4.90527477843843,1,0,0,1.273,2,0.384,LESS
1,150,126,24,276,126,150,5.01063529409626,4.83628190695148,0.174353387144778,9.84691720104773,4.83628190695148,5.01063529409626,1,1,1,1.645,3,0.471,LESS
1,150,180,30,330,150,180,5.01063529409626,5.19295685089021,0.182321556793955,10.2035921449865,5.01063529409626,5.19295685089021,0,0,1,0.963,1,0.356,LESS
1,106,100,6,206,100,106,4.66343909411207,4.60517018598809,0.0582689081239751,9.26860928010016,4.60517018598809,4.66343909411207,1,1,1,1.198,2,0.369,LESS
1,112,100,12,212,112,100,4.71849887129509,4.60517018598809,0.113328685307002,9.32366905728319,4.71849887129509,4.60517018598809,0,1,0,1.056,1,0.432,LESS
1,80,100,20,180,80,100,4.38202663467388,4.60517018598809,0.223143551314211,8.98719682066197,4.38202663467388,4.60517018598809,0,0,1,1.186,4,0.419,LESS
1,50,56,6,106,56,50,3.91202300542815,4.02535169073515,0.113328685307004,7.9373746961633,4.02535169073515,3.91202300542815,1,0,0,1.456,3,0.58,LESS
1,50,52,2,102,50,52,3.91202300542815,3.95124371858143,0.0392207131532816,7.86326672400957,3.91202300542815,3.95124371858143,0,0,1,1.105,1,0.36,LESS
1,153,150,3,303,150,153,5.03043792139244,5.01063529409626,0.0198026272961798,10.0410732154887,5.01063529409626,5.03043792139244,1,1,1,1.001,2,0.361,LESS
1,150,159,9,309,150,159,5.01063529409626,5.06890420222023,0.058268908123976,10.0795394963165,5.01063529409626,5.06890420222023,0,0,1,0.873,1,0.383,LESS
1,126,150,24,276,150,126,4.83628190695148,5.01063529409626,0.174353387144778,9.84691720104773,5.01063529409626,4.83628190695148,1,0,0,0.963,2,0.414,LESS
1,53,50,3,103,50,53,3.97029191355212,3.91202300542815,0.058268908123976,7.88231491898027,3.91202300542815,3.97029191355212,1,1,1,1.784,3,0.367,LESS
1,50,51,1,101,50,51,3.91202300542815,3.93182563272433,0.0198026272961798,7.84384863815247,3.91202300542815,3.93182563272433,0,0,1,1.223,1,0.349,LESS
1,150,135,15,285,135,150,5.01063529409626,4.90527477843843,0.105360515657826,9.91591007253469,4.90527477843843,5.01063529409626,1,1,1,1.085,2,0.377,LESS
1,177,150,27,327,177,150,5.17614973257383,5.01063529409626,0.165514438477573,10.1867850266701,5.17614973257383,5.01063529409626,0,1,0,0.831,1,0.406,LESS
1,57,50,7,107,50,57,4.04305126783455,3.91202300542815,0.131028262406404,7.9550742732627,3.91202300542815,4.04305126783455,1,1,1,1.306,3,0.394,LESS
1,150,120,30,270,120,150,5.01063529409626,4.78749174278205,0.22314355131421,9.7981270368783,4.78749174278205,5.01063529409626,1,1,1,1.072,4,0.407,LESS
1,150,171,21,321,150,171,5.01063529409626,5.14166355650266,0.131028262406405,10.1522988505989,5.01063529409626,5.14166355650266,0,0,1,1.012,1,0.375,LESS
1,100,112,12,212,112,100,4.60517018598809,4.71849887129509,0.113328685307002,9.32366905728319,4.71849887129509,4.60517018598809,1,0,0,1.156,2,0.379,LESS
1,100,80,20,180,80,100,4.60517018598809,4.38202663467388,0.223143551314211,8.98719682066197,4.38202663467388,4.60517018598809,1,1,1,1.018,4,1.075,LESS
1,116,100,16,216,116,100,4.75359019110636,4.60517018598809,0.148420005118273,9.35876037709446,4.75359019110636,4.60517018598809,0,1,0,0.987,1,0.33,LESS
1,150,156,6,306,156,150,5.01063529409626,5.04985600724954,0.0392207131532816,10.0604913013458,5.04985600724954,5.01063529409626,1,0,0,0.984,2,0.376,LESS
1,43,50,7,93,43,50,3.76120011569356,3.91202300542815,0.150822889734584,7.67322312112171,3.76120011569356,3.91202300542815,0,0,1,1.497,1,0.349,LESS
1,57,50,7,107,50,57,4.04305126783455,3.91202300542815,0.131028262406404,7.9550742732627,3.91202300542815,4.04305126783455,1,1,1,1.509,3,0.398,LESS
1,144,150,6,294,144,150,4.969813299576,5.01063529409626,0.0408219945202548,9.98044859367226,4.969813299576,5.01063529409626,0,0,1,0.93,1,0.319,LESS
1,52,50,2,102,50,52,3.95124371858143,3.91202300542815,0.0392207131532816,7.86326672400957,3.91202300542815,3.95124371858143,1,1,1,1.262,3,0.386,LESS
1,47,50,3,97,50,47,3.85014760171006,3.91202300542815,0.0618754037180875,7.7621706071382,3.91202300542815,3.85014760171006,1,0,0,2.573,1,0.292,LESS
1,50,40,10,90,40,50,3.91202300542815,3.68887945411394,0.22314355131421,7.60090245954208,3.68887945411394,3.91202300542815,1,1,1,1.102,4,0.336,LESS
1,50,53,3,103,50,53,3.91202300542815,3.97029191355212,0.058268908123976,7.88231491898027,3.91202300542815,3.97029191355212,0,0,1,1.101,1,0.336,LESS
1,100,120,20,220,120,100,4.60517018598809,4.78749174278205,0.182321556793954,9.39266192877014,4.78749174278205,4.60517018598809,1,0,0,1.121,2,0.394,LESS
1,150,123,27,273,150,123,5.01063529409626,4.81218435537242,0.198450938723838,9.82281964946867,5.01063529409626,4.81218435537242,0,1,0,0.888,1,0.37,LESS
1,123,150,27,273,150,123,4.81218435537242,5.01063529409626,0.198450938723838,9.82281964946867,5.01063529409626,4.81218435537242,1,0,0,0.954,1,0.369,LESS
1,50,54,4,104,54,50,3.91202300542815,3.98898404656427,0.0769610411361286,7.90100705199242,3.98898404656427,3.91202300542815,1,0,0,1.262,4,0.374,LESS
1,50,49,1,99,49,50,3.91202300542815,3.89182029811063,0.0202027073175195,7.80384330353877,3.89182029811063,3.91202300542815,1,1,1,1.527,3,0.368,LESS
1,129,150,21,279,129,150,4.85981240436167,5.01063529409626,0.150822889734584,9.87044769845793,4.85981240436167,5.01063529409626,0,0,1,0.918,1,0.264,LESS
1,100,118,18,218,100,118,4.60517018598809,4.77068462446567,0.165514438477573,9.37585481045376,4.60517018598809,4.77068462446567,0,0,1,1.796,3,0.408,LESS
1,120,100,20,220,100,120,4.78749174278205,4.60517018598809,0.182321556793954,9.39266192877014,4.60517018598809,4.78749174278205,1,1,1,0.799,3,0.822,LESS
1,88,100,12,188,88,100,4.47733681447821,4.60517018598809,0.127833371509885,9.0825070004663,4.47733681447821,4.60517018598809,0,0,1,1.378,1,0.306,LESS
1,50,58,8,108,50,58,3.91202300542815,4.06044301054642,0.148420005118273,7.97246601597456,3.91202300542815,4.06044301054642,0,0,1,1.528,1,0.34,LESS
1,100,108,8,208,108,100,4.60517018598809,4.68213122712422,0.0769610411361281,9.28730141311231,4.68213122712422,4.60517018598809,1,0,0,1.48,2,0.337,LESS
1,100,86,14,186,100,86,4.60517018598809,4.45434729625351,0.150822889734584,9.0595174822416,4.60517018598809,4.45434729625351,0,1,0,1.14,1,0.345,LESS
1,50,54,4,104,54,50,3.91202300542815,3.98898404656427,0.0769610411361286,7.90100705199242,3.98898404656427,3.91202300542815,1,0,0,1.425,2,0.347,LESS
1,100,90,10,190,100,90,4.60517018598809,4.49980967033027,0.105360515657827,9.10497985631836,4.60517018598809,4.49980967033027,0,1,0,1.064,1,0.337,LESS
1,43,50,7,93,50,43,3.76120011569356,3.91202300542815,0.150822889734584,7.67322312112171,3.91202300542815,3.76120011569356,1,0,0,1.088,3,0.509,LESS
1,50,44,6,94,50,44,3.91202300542815,3.78418963391826,0.127833371509885,7.69621263934641,3.91202300542815,3.78418963391826,0,1,0,1.244,1,0.364,LESS
1,58,50,8,108,50,58,4.06044301054642,3.91202300542815,0.148420005118273,7.97246601597456,3.91202300542815,4.06044301054642,1,1,1,1.056,2,0.39,LESS
1,45,50,5,95,45,50,3.80666248977032,3.91202300542815,0.105360515657826,7.71868549519847,3.80666248977032,3.91202300542815,0,0,1,1.13,1,0.372,LESS
1,80,100,20,180,100,80,4.38202663467388,4.60517018598809,0.223143551314211,8.98719682066197,4.60517018598809,4.38202663467388,1,0,0,1.726,3,0.524,LESS
1,150,144,6,294,144,150,5.01063529409626,4.969813299576,0.0408219945202548,9.98044859367226,4.969813299576,5.01063529409626,1,1,1,1.044,1,0.304,LESS
1,92,100,8,192,100,92,4.52178857704904,4.60517018598809,0.0833816089390513,9.12695876303713,4.60517018598809,4.52178857704904,1,0,0,1.625,2,0.351,LESS
1,120,150,30,270,120,150,4.78749174278205,5.01063529409626,0.22314355131421,9.7981270368783,4.78749174278205,5.01063529409626,0,0,1,1.617,1,0.2,LESS
1,150,159,9,309,159,150,5.01063529409626,5.06890420222023,0.058268908123976,10.0795394963165,5.06890420222023,5.01063529409626,1,0,0,1.152,4,0.378,LESS
1,50,47,3,97,50,47,3.91202300542815,3.85014760171006,0.0618754037180875,7.7621706071382,3.91202300542815,3.85014760171006,0,1,0,1.577,1,0.291,LESS
1,41,50,9,91,50,41,3.71357206670431,3.91202300542815,0.198450938723838,7.62559507213245,3.91202300542815,3.71357206670431,1,0,0,2.246,2,0.331,LESS
1,100,92,8,192,92,100,4.60517018598809,4.52178857704904,0.0833816089390513,9.12695876303713,4.52178857704904,4.60517018598809,1,1,1,1.245,3,0.347,LESS
1,58,50,8,108,50,58,4.06044301054642,3.91202300542815,0.148420005118273,7.97246601597456,3.91202300542815,4.06044301054642,1,1,1,1.028,4,0.406,LESS
1,150,126,24,276,126,150,5.01063529409626,4.83628190695148,0.174353387144778,9.84691720104773,4.83628190695148,5.01063529409626,1,1,1,1.258,3,0.365,LESS
1,100,118,18,218,118,100,4.60517018598809,4.77068462446567,0.165514438477573,9.37585481045376,4.77068462446567,4.60517018598809,1,0,0,1.212,1,0.344,LESS
1,51,50,1,101,50,51,3.93182563272433,3.91202300542815,0.0198026272961798,7.84384863815247,3.91202300542815,3.93182563272433,1,1,1,1.749,2,0.345,LESS
1,147,150,3,297,147,150,4.99043258677874,5.01063529409626,0.0202027073175195,10.001067880875,4.99043258677874,5.01063529409626,0,0,1,1.569,1,0.361,LESS
1,126,150,24,276,150,126,4.83628190695148,5.01063529409626,0.174353387144778,9.84691720104773,5.01063529409626,4.83628190695148,1,0,0,1.307,2,0.42,LESS
1,144,150,6,294,144,150,4.969813299576,5.01063529409626,0.0408219945202548,9.98044859367226,4.969813299576,5.01063529409626,0,0,1,1.502,1,0.357,LESS
1,50,44,6,94,44,50,3.91202300542815,3.78418963391826,0.127833371509885,7.69621263934641,3.78418963391826,3.91202300542815,1,1,1,1.28,4,0.396,LESS
1,84,100,16,184,84,100,4.43081679884331,4.60517018598809,0.174353387144778,9.03598698483141,4.43081679884331,4.60517018598809,0,0,1,1.011,2,0.37,LESS
1,42,50,8,92,50,42,3.73766961828337,3.91202300542815,0.174353387144778,7.64969262371151,3.91202300542815,3.73766961828337,1,0,0,1.447,1,0.291,LESS
1,150,165,15,315,150,165,5.01063529409626,5.10594547390058,0.0953101798043248,10.1165807679968,5.01063529409626,5.10594547390058,0,0,1,1.352,2,0.655,LESS
1,150,132,18,282,132,150,5.01063529409626,4.88280192258637,0.127833371509885,9.89343721668263,4.88280192258637,5.01063529409626,1,1,1,1.407,3,0.248,LESS
1,50,46,4,96,46,50,3.91202300542815,3.8286413964891,0.0833816089390509,7.74066440191724,3.8286413964891,3.91202300542815,1,1,1,1.264,4,0.345,LESS
1,50,55,5,105,55,50,3.91202300542815,4.00733318523247,0.0953101798043252,7.91935619066062,4.00733318523247,3.91202300542815,1,0,0,1.884,4,0.315,LESS
1,45,50,5,95,45,50,3.80666248977032,3.91202300542815,0.105360515657826,7.71868549519847,3.80666248977032,3.91202300542815,0,0,1,1.202,2,0.293,LESS
1,100,98,2,198,98,100,4.60517018598809,4.58496747867057,0.0202027073175195,9.19013766465866,4.58496747867057,4.60517018598809,1,1,1,1.384,1,0.294,LESS
1,86,100,14,186,86,100,4.45434729625351,4.60517018598809,0.150822889734584,9.0595174822416,4.45434729625351,4.60517018598809,0,0,1,1.435,3,0.555,LESS
1,100,116,16,216,116,100,4.60517018598809,4.75359019110636,0.148420005118273,9.35876037709446,4.75359019110636,4.60517018598809,1,0,0,1.088,1,0.339,LESS
1,162,150,12,312,162,150,5.08759633523238,5.01063529409626,0.0769610411361281,10.0982316293286,5.08759633523238,5.01063529409626,0,1,0,1.07,2,0.355,LESS
1,150,177,27,327,177,150,5.01063529409626,5.17614973257383,0.165514438477573,10.1867850266701,5.17614973257383,5.01063529409626,1,0,0,0.949,1,0.331,LESS
1,150,138,12,288,138,150,5.01063529409626,4.92725368515721,0.0833816089390504,9.93788897925346,4.92725368515721,5.01063529409626,1,1,1,1.432,2,0.488,LESS
1,118,100,18,218,100,118,4.77068462446567,4.60517018598809,0.165514438477573,9.37585481045376,4.60517018598809,4.77068462446567,1,1,1,1.019,3,0.393,LESS
1,120,150,30,270,120,150,4.78749174278205,5.01063529409626,0.22314355131421,9.7981270368783,4.78749174278205,5.01063529409626,0,0,1,1.477,3,0.742,LESS
1,100,102,2,202,100,102,4.60517018598809,4.62497281328427,0.0198026272961789,9.23014299927236,4.60517018598809,4.62497281328427,0,0,1,0.982,1,0.332,LESS
1,174,150,24,324,150,174,5.15905529921453,5.01063529409626,0.148420005118274,10.1696905933108,5.01063529409626,5.15905529921453,1,1,1,0.892,2,0.332,LESS
1,42,50,8,92,50,42,3.73766961828337,3.91202300542815,0.174353387144778,7.64969262371151,3.91202300542815,3.73766961828337,1,0,0,1.547,2,0.286,LESS
1,110,100,10,210,110,100,4.70048036579242,4.60517018598809,0.0953101798043248,9.30565055178051,4.70048036579242,4.60517018598809,0,1,0,1.414,1,0.281,LESS
1,114,100,14,214,100,114,4.7361984483945,4.60517018598809,0.131028262406404,9.34136863438259,4.60517018598809,4.7361984483945,1,1,1,1.142,2,0.483,LESS
1,100,90,10,190,90,100,4.60517018598809,4.49980967033027,0.105360515657827,9.10497985631836,4.49980967033027,4.60517018598809,1,1,1,1.179,4,0.405,LESS
1,100,108,8,208,100,108,4.60517018598809,4.68213122712422,0.0769610411361281,9.28730141311231,4.60517018598809,4.68213122712422,0,0,1,0.955,1,0.275,LESS
1,150,132,18,282,132,150,5.01063529409626,4.88280192258637,0.127833371509885,9.89343721668263,4.88280192258637,5.01063529409626,1,1,1,0.915,2,0.35,LESS
1,50,48,2,98,48,50,3.91202300542815,3.87120101090789,0.0408219945202548,7.78322401633604,3.87120101090789,3.91202300542815,1,1,1,1.192,4,0.37,LESS
1,150,165,15,315,150,165,5.01063529409626,5.10594547390058,0.0953101798043248,10.1165807679968,5.01063529409626,5.10594547390058,0,0,1,0.966,1,0.307,LESS
1,150,129,21,279,129,150,5.01063529409626,4.85981240436167,0.150822889734584,9.87044769845793,4.85981240436167,5.01063529409626,1,1,1,1.427,3,0.519,LESS
1,116,100,16,216,116,100,4.75359019110636,4.60517018598809,0.148420005118273,9.35876037709446,4.75359019110636,4.60517018598809,0,1,0,1.2,1,0.294,LESS
1,150,162,12,312,162,150,5.01063529409626,5.08759633523238,0.0769610411361281,10.0982316293286,5.08759633523238,5.01063529409626,1,0,0,1.383,2,0.291,LESS
1,50,45,5,95,45,50,3.91202300542815,3.80666248977032,0.105360515657826,7.71868549519847,3.80666248977032,3.91202300542815,1,1,1,1.302,3,0.316,LESS
1,50,42,8,92,42,50,3.91202300542815,3.73766961828337,0.174353387144778,7.64969262371151,3.73766961828337,3.91202300542815,1,1,1,1.653,3,0.264,LESS
1,100,104,4,204,100,104,4.60517018598809,4.64439089914137,0.0392207131532807,9.24956108512946,4.60517018598809,4.64439089914137,0,0,1,1.747,1,0.347,LESS
1,50,59,9,109,59,50,3.91202300542815,4.07753744390572,0.165514438477574,7.98956044933387,4.07753744390572,3.91202300542815,1,0,0,1.257,2,0.345,LESS
1,98,100,2,198,98,100,4.58496747867057,4.60517018598809,0.0202027073175195,9.19013766465866,4.58496747867057,4.60517018598809,0,0,1,1.124,1,0.366,LESS
1,147,150,3,297,150,147,4.99043258677874,5.01063529409626,0.0202027073175195,10.001067880875,5.01063529409626,4.99043258677874,1,0,0,1.186,1,0.338,LESS
1,114,100,14,214,100,114,4.7361984483945,4.60517018598809,0.131028262406404,9.34136863438259,4.60517018598809,4.7361984483945,1,1,1,1.28,2,0.305,LESS
1,150,123,27,273,150,123,5.01063529409626,4.81218435537242,0.198450938723838,9.82281964946867,5.01063529409626,4.81218435537242,0,1,0,1.216,1,0.349,LESS
1,150,147,3,297,147,150,5.01063529409626,4.99043258677874,0.0202027073175195,10.001067880875,4.99043258677874,5.01063529409626,1,1,1,0.954,2,0.31,LESS
1,150,144,6,294,150,144,5.01063529409626,4.969813299576,0.0408219945202548,9.98044859367226,5.01063529409626,4.969813299576,0,1,0,1.152,2,0.81,LESS
1,156,150,6,306,150,156,5.04985600724954,5.01063529409626,0.0392207131532816,10.0604913013458,5.01063529409626,5.04985600724954,1,1,1,0.991,2,0.735,LESS
1,112,100,12,212,100,112,4.71849887129509,4.60517018598809,0.113328685307002,9.32366905728319,4.60517018598809,4.71849887129509,1,1,1,1.322,1,0.72,LESS
1,100,110,10,210,110,100,4.60517018598809,4.70048036579242,0.0953101798043248,9.30565055178051,4.70048036579242,4.60517018598809,1,0,0,1.42,2,0.557,LESS
1,50,43,7,93,43,50,3.91202300542815,3.76120011569356,0.150822889734584,7.67322312112171,3.76120011569356,3.91202300542815,1,1,1,1.599,1,0.534,LESS
1,100,110,10,210,110,100,4.60517018598809,4.70048036579242,0.0953101798043248,9.30565055178051,4.70048036579242,4.60517018598809,1,0,0,1.108,2,0.556,LESS
1,50,49,1,99,49,50,3.91202300542815,3.89182029811063,0.0202027073175195,7.80384330353877,3.89182029811063,3.91202300542815,1,1,1,1.372,4,0.369,LESS
1,50,42,8,92,42,50,3.91202300542815,3.73766961828337,0.174353387144778,7.64969262371151,3.73766961828337,3.91202300542815,1,1,1,1.227,4,0.326,LESS
1,150,129,21,279,150,129,5.01063529409626,4.85981240436167,0.150822889734584,9.87044769845793,5.01063529409626,4.85981240436167,0,1,0,1.007,1,0.348,LESS
1,150,153,3,303,153,150,5.01063529409626,5.03043792139244,0.0198026272961798,10.0410732154887,5.03043792139244,5.01063529409626,1,0,0,0.983,2,0.275,LESS
1,174,150,24,324,150,174,5.15905529921453,5.01063529409626,0.148420005118274,10.1696905933108,5.01063529409626,5.15905529921453,1,1,1,1.572,3,0.371,LESS
1,82,100,18,182,82,100,4.40671924726425,4.60517018598809,0.198450938723838,9.01188943325235,4.40671924726425,4.60517018598809,0,0,1,1.315,1,0.286,LESS
1,150,138,12,288,138,150,5.01063529409626,4.92725368515721,0.0833816089390504,9.93788897925346,4.92725368515721,5.01063529409626,1,1,1,1.153,2,0.539,LESS
1,150,141,9,291,141,150,5.01063529409626,4.94875989037817,0.0618754037180871,9.95939518447442,4.94875989037817,5.01063529409626,1,1,1,1.052,2,0.498,LESS
1,180,150,30,330,180,150,5.19295685089021,5.01063529409626,0.182321556793955,10.2035921449865,5.19295685089021,5.01063529409626,0,1,0,1.017,1,0.302,LESS
1,50,48,2,98,48,50,3.91202300542815,3.87120101090789,0.0408219945202548,7.78322401633604,3.87120101090789,3.91202300542815,1,1,1,1.449,3,0.213,LESS
2,86,100,14,186,86,100,4.45434729625351,4.60517018598809,0.150822889734584,9.0595174822416,4.45434729625351,4.60517018598809,0,0,1,1.6635,2,1.5207,LESS
2,41,50,9,91,50,41,3.71357206670431,3.91202300542815,0.198450938723838,7.62559507213245,3.91202300542815,3.71357206670431,1,0,0,1.2253,3,1.6049,LESS
2,159,150,9,309,150,159,5.06890420222023,5.01063529409626,0.058268908123976,10.0795394963165,5.01063529409626,5.06890420222023,1,1,1,0.8745,2,1.8323,LESS
2,171,150,21,321,150,171,5.14166355650266,5.01063529409626,0.131028262406405,10.1522988505989,5.01063529409626,5.14166355650266,1,1,1,1.0063,2,1.4036,LESS
2,100,120,20,220,120,100,4.60517018598809,4.78749174278205,0.182321556793954,9.39266192877014,4.78749174278205,4.60517018598809,1,0,0,1.2486,2,1.1588,LESS
2,50,41,9,91,41,50,3.91202300542815,3.71357206670431,0.198450938723838,7.62559507213245,3.71357206670431,3.91202300542815,1,1,1,1.1504,3,1.0198,LESS
2,114,100,14,214,100,114,4.7361984483945,4.60517018598809,0.131028262406404,9.34136863438259,4.60517018598809,4.7361984483945,1,1,1,0.7942,4,1.0065,LESS
2,47,50,3,97,50,47,3.85014760171006,3.91202300542815,0.0618754037180875,7.7621706071382,3.91202300542815,3.85014760171006,1,0,0,0.9414,3,1.0046,LESS
2,57,50,7,107,50,57,4.04305126783455,3.91202300542815,0.131028262406404,7.9550742732627,3.91202300542815,4.04305126783455,1,1,1,0.9186,3,0.9021,LESS
2,100,108,8,208,108,100,4.60517018598809,4.68213122712422,0.0769610411361281,9.28730141311231,4.68213122712422,4.60517018598809,1,0,0,2.046,2,1.6397,LESS
2,56,50,6,106,50,56,4.02535169073515,3.91202300542815,0.113328685307004,7.9373746961633,3.91202300542815,4.02535169073515,1,1,1,0.9631,3,0.8685,LESS
2,53,50,3,103,50,53,3.97029191355212,3.91202300542815,0.058268908123976,7.88231491898027,3.91202300542815,3.97029191355212,1,1,1,1.1367,4,0.8211,LESS
2,100,90,10,190,90,100,4.60517018598809,4.49980967033027,0.105360515657827,9.10497985631836,4.49980967033027,4.60517018598809,1,1,1,1.0726,2,1.0472,LESS
2,50,54,4,104,50,54,3.91202300542815,3.98898404656427,0.0769610411361286,7.90100705199242,3.91202300542815,3.98898404656427,0,0,1,1.8269,2,1.169,LESS
2,42,50,8,92,42,50,3.73766961828337,3.91202300542815,0.174353387144778,7.64969262371151,3.73766961828337,3.91202300542815,0,0,1,1.3143,2,0.8594,LESS
2,180,150,30,330,150,180,5.19295685089021,5.01063529409626,0.182321556793955,10.2035921449865,5.01063529409626,5.19295685089021,1,1,1,1.0336,4,0.9638,LESS
2,112,100,12,212,100,112,4.71849887129509,4.60517018598809,0.113328685307002,9.32366905728319,4.60517018598809,4.71849887129509,1,1,1,0.8973,3,0.8582,LESS
2,92,100,8,192,100,92,4.52178857704904,4.60517018598809,0.0833816089390513,9.12695876303713,4.60517018598809,4.52178857704904,1,0,0,1.1705,4,0.8514,LESS
2,150,159,9,309,159,150,5.01063529409626,5.06890420222023,0.058268908123976,10.0795394963165,5.06890420222023,5.01063529409626,1,0,0,1.4738,2,0.8636,LESS
2,150,156,6,306,156,150,5.01063529409626,5.04985600724954,0.0392207131532816,10.0604913013458,5.04985600724954,5.01063529409626,1,0,0,1.3016,2,0.816,LESS
2,58,50,8,108,50,58,4.06044301054642,3.91202300542815,0.148420005118273,7.97246601597456,3.91202300542815,4.06044301054642,1,1,1,1.3175,3,1.5928,LESS
2,135,150,15,285,135,150,4.90527477843843,5.01063529409626,0.105360515657826,9.91591007253469,4.90527477843843,5.01063529409626,0,0,1,1.568,1,1.3807,LESS
2,50,53,3,103,50,53,3.91202300542815,3.97029191355212,0.058268908123976,7.88231491898027,3.91202300542815,3.97029191355212,0,0,1,1.2933,2,0.8691,LESS
2,150,132,18,282,132,150,5.01063529409626,4.88280192258637,0.127833371509885,9.89343721668263,4.88280192258637,5.01063529409626,1,1,1,0.802,3,0.8816,LESS
2,50,46,4,96,46,50,3.91202300542815,3.8286413964891,0.0833816089390509,7.74066440191724,3.8286413964891,3.91202300542815,1,1,1,1.4079,3,0.9316,LESS
2,100,112,12,212,100,112,4.60517018598809,4.71849887129509,0.113328685307002,9.32366905728319,4.60517018598809,4.71849887129509,0,0,1,1.5004,2,0.7807,LESS
2,150,165,15,315,165,150,5.01063529409626,5.10594547390058,0.0953101798043248,10.1165807679968,5.10594547390058,5.01063529409626,1,0,0,1.2313,2,0.8188,LESS
2,150,141,9,291,141,150,5.01063529409626,4.94875989037817,0.0618754037180871,9.95939518447442,4.94875989037817,5.01063529409626,1,1,1,0.988,4,0.5969,LESS
2,82,100,18,182,82,100,4.40671924726425,4.60517018598809,0.198450938723838,9.01188943325235,4.40671924726425,4.60517018598809,0,0,1,1.5633,2,0.6359,LESS
2,80,100,20,180,100,80,4.38202663467388,4.60517018598809,0.223143551314211,8.98719682066197,4.60517018598809,4.38202663467388,1,0,0,1.2637,2,1.2001,LESS
2,174,150,24,324,150,174,5.15905529921453,5.01063529409626,0.148420005118274,10.1696905933108,5.01063529409626,5.15905529921453,1,1,1,0.8397,4,0.6165,LESS
2,100,86,14,186,86,100,4.60517018598809,4.45434729625351,0.150822889734584,9.0595174822416,4.45434729625351,4.60517018598809,1,1,1,1.0265,4,0.565,LESS
2,120,100,20,220,100,120,4.78749174278205,4.60517018598809,0.182321556793954,9.39266192877014,4.60517018598809,4.78749174278205,1,1,1,1.0809,3,1.3319,LESS
2,100,106,6,206,106,100,4.60517018598809,4.66343909411207,0.0582689081239751,9.26860928010016,4.66343909411207,4.60517018598809,1,0,0,1.3564,2,1.2374,LESS
2,171,150,21,321,150,171,5.14166355650266,5.01063529409626,0.131028262406405,10.1522988505989,5.01063529409626,5.14166355650266,1,1,1,1.5427,1,0.8637,LESS
2,44,50,6,94,44,50,3.78418963391826,3.91202300542815,0.127833371509885,7.69621263934641,3.78418963391826,3.91202300542815,0,0,1,1.2288,3,0.8584,LESS
2,49,50,1,99,49,50,3.89182029811063,3.91202300542815,0.0202027073175195,7.80384330353877,3.89182029811063,3.91202300542815,0,0,1,1.8357,2,1.0066,LESS
2,150,180,30,330,150,180,5.01063529409626,5.19295685089021,0.182321556793955,10.2035921449865,5.01063529409626,5.19295685089021,0,0,1,1.8456,2,0.9729,LESS
2,150,126,24,276,126,150,5.01063529409626,4.83628190695148,0.174353387144778,9.84691720104773,4.83628190695148,5.01063529409626,1,1,1,1.1429,3,0.735,LESS
2,100,104,4,204,100,104,4.60517018598809,4.64439089914137,0.0392207131532807,9.24956108512946,4.60517018598809,4.64439089914137,0,0,1,1.2975,2,1.3207,LESS
2,150,156,6,306,150,156,5.01063529409626,5.04985600724954,0.0392207131532816,10.0604913013458,5.01063529409626,5.04985600724954,0,0,1,1.3448,3,0.8024,LESS
2,100,92,8,192,92,100,4.60517018598809,4.52178857704904,0.0833816089390513,9.12695876303713,4.52178857704904,4.60517018598809,1,1,1,1.8695,2,0.9439,LESS
2,48,50,2,98,48,50,3.87120101090789,3.91202300542815,0.0408219945202548,7.78322401633604,3.87120101090789,3.91202300542815,0,0,1,1.2485,4,0.8003,LESS
2,94,100,6,194,94,100,4.54329478227,4.60517018598809,0.061875403718088,9.1484649682581,4.54329478227,4.60517018598809,0,0,1,2.0344,2,0.7648,LESS
2,50,44,6,94,44,50,3.91202300542815,3.78418963391826,0.127833371509885,7.69621263934641,3.78418963391826,3.91202300542815,1,1,1,1.2409,3,0.585,LESS
2,150,162,12,312,150,162,5.01063529409626,5.08759633523238,0.0769610411361281,10.0982316293286,5.01063529409626,5.08759633523238,0,0,1,1.2311,1,0.9541,LESS
2,126,150,24,276,126,150,4.83628190695148,5.01063529409626,0.174353387144778,9.84691720104773,4.83628190695148,5.01063529409626,0,0,1,1.8102,2,0.7968,LESS
2,126,150,24,276,150,126,4.83628190695148,5.01063529409626,0.174353387144778,9.84691720104773,5.01063529409626,4.83628190695148,1,0,0,1.9472,3,0.8738,LESS
2,168,150,18,318,150,168,5.12396397940326,5.01063529409626,0.113328685307003,10.1345992734995,5.01063529409626,5.12396397940326,1,1,1,1.8213,2,0.8556,LESS
2,56,50,6,106,56,50,4.02535169073515,3.91202300542815,0.113328685307004,7.9373746961633,4.02535169073515,3.91202300542815,0,1,0,2.0909,2,1.0023,LESS
2,47,50,3,97,47,50,3.85014760171006,3.91202300542815,0.0618754037180875,7.7621706071382,3.85014760171006,3.91202300542815,0,0,1,1.5382,3,0.8418,LESS
2,150,171,21,321,150,171,5.01063529409626,5.14166355650266,0.131028262406405,10.1522988505989,5.01063529409626,5.14166355650266,0,0,1,1.2067,2,0.6831,LESS
2,150,123,27,273,123,150,5.01063529409626,4.81218435537242,0.198450938723838,9.82281964946867,4.81218435537242,5.01063529409626,1,1,1,1.8775,1,1.213,LESS
2,150,180,30,330,150,180,5.01063529409626,5.19295685089021,0.182321556793955,10.2035921449865,5.01063529409626,5.19295685089021,0,0,1,1.4904,3,0.8156,LESS
2,50,56,6,106,50,56,3.91202300542815,4.02535169073515,0.113328685307004,7.9373746961633,3.91202300542815,4.02535169073515,0,0,1,1.6014,2,0.925,LESS
2,59,50,9,109,50,59,4.07753744390572,3.91202300542815,0.165514438477574,7.98956044933387,3.91202300542815,4.07753744390572,1,1,1,1.1521,3,0.9144,LESS
2,153,150,3,303,153,150,5.03043792139244,5.01063529409626,0.0198026272961798,10.0410732154887,5.03043792139244,5.01063529409626,0,1,0,2.1849,2,0.6616,LESS
2,100,102,2,202,100,102,4.60517018598809,4.62497281328427,0.0198026272961789,9.23014299927236,4.60517018598809,4.62497281328427,0,0,1,1.4316,2,0.8645,LESS
2,132,150,18,282,132,150,4.88280192258637,5.01063529409626,0.127833371509885,9.89343721668263,4.88280192258637,5.01063529409626,0,0,1,1.3759,3,0.6563,LESS
2,108,100,8,208,100,108,4.68213122712422,4.60517018598809,0.0769610411361281,9.28730141311231,4.60517018598809,4.68213122712422,1,1,1,2.1207,2,0.9221,LESS
2,50,49,1,99,49,50,3.91202300542815,3.89182029811063,0.0202027073175195,7.80384330353877,3.89182029811063,3.91202300542815,1,1,1,1.6846,2,1.4596,LESS
2,150,126,24,276,150,126,5.01063529409626,4.83628190695148,0.174353387144778,9.84691720104773,5.01063529409626,4.83628190695148,0,1,0,2.0397,1,1.0971,LESS
2,50,46,4,96,50,46,3.91202300542815,3.8286413964891,0.0833816089390509,7.74066440191724,3.91202300542815,3.8286413964891,0,1,0,1.3365,3,0.6865,LESS
2,162,150,12,312,162,150,5.08759633523238,5.01063529409626,0.0769610411361281,10.0982316293286,5.08759633523238,5.01063529409626,0,1,0,1.2646,3,0.7929,LESS
2,52,50,2,102,52,50,3.95124371858143,3.91202300542815,0.0392207131532816,7.86326672400957,3.95124371858143,3.91202300542815,0,1,0,1.4142,4,0.6615,LESS
2,51,50,1,101,51,50,3.93182563272433,3.91202300542815,0.0198026272961798,7.84384863815247,3.93182563272433,3.91202300542815,0,1,0,1.3621,3,1.037,LESS
2,110,100,10,210,110,100,4.70048036579242,4.60517018598809,0.0953101798043248,9.30565055178051,4.70048036579242,4.60517018598809,0,1,0,2.4953,2,0.7818,LESS
2,112,100,12,212,100,112,4.71849887129509,4.60517018598809,0.113328685307002,9.32366905728319,4.60517018598809,4.71849887129509,1,1,1,1.3274,2,0.8157,LESS
2,50,59,9,109,50,59,3.91202300542815,4.07753744390572,0.165514438477574,7.98956044933387,3.91202300542815,4.07753744390572,0,0,1,1.4156,3,0.6484,LESS
2,144,150,6,294,144,150,4.969813299576,5.01063529409626,0.0408219945202548,9.98044859367226,4.969813299576,5.01063529409626,0,0,1,1.144,3,0.7469,LESS
2,50,41,9,91,41,50,3.91202300542815,3.71357206670431,0.198450938723838,7.62559507213245,3.71357206670431,3.91202300542815,1,1,1,1.1982,4,0.6654,LESS
2,100,98,2,198,100,98,4.60517018598809,4.58496747867057,0.0202027073175195,9.19013766465866,4.60517018598809,4.58496747867057,0,1,0,2.3608,2,0.3155,LESS
2,50,55,5,105,50,55,3.91202300542815,4.00733318523247,0.0953101798043252,7.91935619066062,3.91202300542815,4.00733318523247,0,0,1,1.1118,4,0.8263,LESS
2,50,44,6,94,50,44,3.91202300542815,3.78418963391826,0.127833371509885,7.69621263934641,3.91202300542815,3.78418963391826,0,1,0,1.7757,3,0.7499,LESS
2,102,100,2,202,102,100,4.62497281328427,4.60517018598809,0.0198026272961789,9.23014299927236,4.62497281328427,4.60517018598809,0,1,0,1.4728,3,0.924,LESS
2,150,138,12,288,150,138,5.01063529409626,4.92725368515721,0.0833816089390504,9.93788897925346,5.01063529409626,4.92725368515721,0,1,0,2.2095,1,1.26,LESS
2,150,147,3,297,147,150,5.01063529409626,4.99043258677874,0.0202027073175195,10.001067880875,4.99043258677874,5.01063529409626,1,1,1,1.9718,2,1.0203,LESS
2,132,150,18,282,132,150,4.88280192258637,5.01063529409626,0.127833371509885,9.89343721668263,4.88280192258637,5.01063529409626,0,0,1,1.3549,2,0.6531,LESS
2,50,48,2,98,50,48,3.91202300542815,3.87120101090789,0.0408219945202548,7.78322401633604,3.91202300542815,3.87120101090789,0,1,0,1.4112,3,0.8857,LESS
2,150,120,30,270,120,150,5.01063529409626,4.78749174278205,0.22314355131421,9.7981270368783,4.78749174278205,5.01063529409626,1,1,1,1.141,4,1.0908,LESS
2,123,150,27,273,123,150,4.81218435537242,5.01063529409626,0.198450938723838,9.82281964946867,4.81218435537242,5.01063529409626,0,0,1,0.9533,4,0.731,LESS
2,147,150,3,297,147,150,4.99043258677874,5.01063529409626,0.0202027073175195,10.001067880875,4.99043258677874,5.01063529409626,0,0,1,1.7829,2,0.6068,LESS
2,48,50,2,98,48,50,3.87120101090789,3.91202300542815,0.0408219945202548,7.78322401633604,3.87120101090789,3.91202300542815,0,0,1,1.3197,3,0.6022,LESS
2,118,100,18,218,100,118,4.77068462446567,4.60517018598809,0.165514438477573,9.37585481045376,4.60517018598809,4.77068462446567,1,1,1,1.2452,2,0.6994,LESS
2,150,141,9,291,141,150,5.01063529409626,4.94875989037817,0.0618754037180871,9.95939518447442,4.94875989037817,5.01063529409626,1,1,1,1.3069,2,0.8289,LESS
2,100,96,4,196,100,96,4.60517018598809,4.56434819146784,0.0408219945202557,9.16951837745593,4.60517018598809,4.56434819146784,0,1,0,1.0537,3,1.9875,LESS
2,50,47,3,97,47,50,3.91202300542815,3.85014760171006,0.0618754037180875,7.7621706071382,3.85014760171006,3.91202300542815,1,1,1,2.0745,2,0.7658,LESS
2,84,100,16,184,100,84,4.43081679884331,4.60517018598809,0.174353387144778,9.03598698483141,4.60517018598809,4.43081679884331,1,0,0,2.6123,2,0.64,LESS
2,150,165,15,315,150,165,5.01063529409626,5.10594547390058,0.0953101798043248,10.1165807679968,5.01063529409626,5.10594547390058,0,0,1,1.3089,1,0.789,LESS
2,177,150,27,327,150,177,5.17614973257383,5.01063529409626,0.165514438477573,10.1867850266701,5.01063529409626,5.17614973257383,1,1,1,1.7396,1,1.0781,LESS
2,40,50,10,90,40,50,3.68887945411394,3.91202300542815,0.22314355131421,7.60090245954208,3.68887945411394,3.91202300542815,0,0,1,1.3299,4,0.4597,LESS
2,147,150,3,297,147,150,4.99043258677874,5.01063529409626,0.0202027073175195,10.001067880875,4.99043258677874,5.01063529409626,0,0,1,1.4161,2,0.518,LESS
2,50,40,10,90,40,50,3.91202300542815,3.68887945411394,0.22314355131421,7.60090245954208,3.68887945411394,3.91202300542815,1,1,1,1.6469,2,0.904,LESS
2,100,98,2,198,100,98,4.60517018598809,4.58496747867057,0.0202027073175195,9.19013766465866,4.60517018598809,4.58496747867057,0,1,0,1.7923,1,0.7825,LESS
2,100,118,18,218,100,118,4.60517018598809,4.77068462446567,0.165514438477573,9.37585481045376,4.60517018598809,4.77068462446567,0,0,1,1.7871,3,0.4709,LESS
2,45,50,5,95,45,50,3.80666248977032,3.91202300542815,0.105360515657826,7.71868549519847,3.80666248977032,3.91202300542815,0,0,1,1.2948,4,0.5396,LESS
2,150,144,6,294,144,150,5.01063529409626,4.969813299576,0.0408219945202548,9.98044859367226,4.969813299576,5.01063529409626,1,1,1,1.9585,2,0.8673,LESS
2,129,150,21,279,129,150,4.85981240436167,5.01063529409626,0.150822889734584,9.87044769845793,4.85981240436167,5.01063529409626,0,0,1,1.5064,1,0.7164,LESS
2,43,50,7,93,43,50,3.76120011569356,3.91202300542815,0.150822889734584,7.67322312112171,3.76120011569356,3.91202300542815,0,0,1,1.312,4,0.5621,LESS
2,150,147,3,297,147,150,5.01063529409626,4.99043258677874,0.0202027073175195,10.001067880875,4.99043258677874,5.01063529409626,1,1,1,2.5536,1,0.5303,LESS
2,150,168,18,318,150,168,5.01063529409626,5.12396397940326,0.113328685307003,10.1345992734995,5.01063529409626,5.12396397940326,0,0,1,1.4107,3,0.8525,LESS
2,100,84,16,184,84,100,4.60517018598809,4.43081679884331,0.174353387144778,9.03598698483141,4.43081679884331,4.60517018598809,1,1,1,2.2507,2,0.6306,LESS
2,50,51,1,101,50,51,3.91202300542815,3.93182563272433,0.0198026272961798,7.84384863815247,3.91202300542815,3.93182563272433,0,0,1,1.2446,3,0.8235,LESS
2,150,123,27,273,123,150,5.01063529409626,4.81218435537242,0.198450938723838,9.82281964946867,4.81218435537242,5.01063529409626,1,1,1,1.4963,3,1.5013,LESS
2,96,100,4,196,96,100,4.56434819146784,4.60517018598809,0.0408219945202557,9.16951837745593,4.56434819146784,4.60517018598809,0,0,1,1.684,2,0.453,LESS
2,45,50,5,95,45,50,3.80666248977032,3.91202300542815,0.105360515657826,7.71868549519847,3.80666248977032,3.91202300542815,0,0,1,1.3181,3,0.7862,LESS
2,50,42,8,92,42,50,3.91202300542815,3.73766961828337,0.174353387144778,7.64969262371151,3.73766961828337,3.91202300542815,1,1,1,1.538,3,1.7697,LESS
2,174,150,24,324,174,150,5.15905529921453,5.01063529409626,0.148420005118274,10.1696905933108,5.15905529921453,5.01063529409626,0,1,0,4.3063,1,1.2539,LESS
2,156,150,6,306,156,150,5.04985600724954,5.01063529409626,0.0392207131532816,10.0604913013458,5.04985600724954,5.01063529409626,0,1,0,1.3454,2,0.7673,LESS
2,100,94,6,194,94,100,4.60517018598809,4.54329478227,0.061875403718088,9.1484649682581,4.54329478227,4.60517018598809,1,1,1,1.8831,2,1.2146,LESS
2,100,120,20,220,100,120,4.60517018598809,4.78749174278205,0.182321556793954,9.39266192877014,4.60517018598809,4.78749174278205,0,0,1,1.3387,3,0.7998,LESS
2,180,150,30,330,150,180,5.19295685089021,5.01063529409626,0.182321556793955,10.2035921449865,5.01063529409626,5.19295685089021,1,1,1,1.5391,2,0.9499,LESS
2,96,100,4,196,96,100,4.56434819146784,4.60517018598809,0.0408219945202557,9.16951837745593,4.56434819146784,4.60517018598809,0,0,1,1.5081,2,0.9979,LESS
2,150,174,24,324,150,174,5.01063529409626,5.15905529921453,0.148420005118274,10.1696905933108,5.01063529409626,5.15905529921453,0,0,1,1.3463,2,1.0087,LESS
2,50,60,10,110,50,60,3.91202300542815,4.0943445622221,0.182321556793954,8.00636756765025,3.91202300542815,4.0943445622221,0,0,1,1.8697,3,0.9845,LESS
2,100,86,14,186,86,100,4.60517018598809,4.45434729625351,0.150822889734584,9.0595174822416,4.45434729625351,4.60517018598809,1,1,1,1.26,3,1.6321,LESS
2,120,150,30,270,120,150,4.78749174278205,5.01063529409626,0.22314355131421,9.7981270368783,4.78749174278205,5.01063529409626,0,0,1,1.3766,4,1.1802,LESS
2,108,100,8,208,100,108,4.68213122712422,4.60517018598809,0.0769610411361281,9.28730141311231,4.60517018598809,4.68213122712422,1,1,1,1.3707,3,0.9196,LESS
2,114,100,14,214,100,114,4.7361984483945,4.60517018598809,0.131028262406404,9.34136863438259,4.60517018598809,4.7361984483945,1,1,1,1.3914,2,0.8805,LESS
2,150,120,30,270,120,150,5.01063529409626,4.78749174278205,0.22314355131421,9.7981270368783,4.78749174278205,5.01063529409626,1,1,1,1.5314,2,0.6015,LESS
2,141,150,9,291,141,150,4.94875989037817,5.01063529409626,0.0618754037180871,9.95939518447442,4.94875989037817,5.01063529409626,0,0,1,1.0222,3,0.7217,LESS
2,100,102,2,202,102,100,4.60517018598809,4.62497281328427,0.0198026272961789,9.23014299927236,4.62497281328427,4.60517018598809,1,0,0,1.3169,2,0.4013,LESS
2,162,150,12,312,162,150,5.08759633523238,5.01063529409626,0.0769610411361281,10.0982316293286,5.08759633523238,5.01063529409626,0,1,0,1.7189,2,0.3497,LESS
2,50,57,7,107,50,57,3.91202300542815,4.04305126783455,0.131028262406404,7.9550742732627,3.91202300542815,4.04305126783455,0,0,1,1.3225,4,0.385,LESS
2,138,150,12,288,138,150,4.92725368515721,5.01063529409626,0.0833816089390504,9.93788897925346,4.92725368515721,5.01063529409626,0,0,1,1.1555,3,0.4294,LESS
2,51,50,1,101,51,50,3.93182563272433,3.91202300542815,0.0198026272961798,7.84384863815247,3.93182563272433,3.91202300542815,0,1,0,1.8274,2,0.5047,LESS
2,43,50,7,93,43,50,3.76120011569356,3.91202300542815,0.150822889734584,7.67322312112171,3.76120011569356,3.91202300542815,0,0,1,1.6353,3,0.9523,LESS
2,100,94,6,194,94,100,4.60517018598809,4.54329478227,0.061875403718088,9.1484649682581,4.54329478227,4.60517018598809,1,1,1,1.8902,2,1.0016,LESS
2,50,49,1,99,49,50,3.91202300542815,3.89182029811063,0.0202027073175195,7.80384330353877,3.89182029811063,3.91202300542815,1,1,1,3.6047,1,0.558,LESS
2,100,116,16,216,100,116,4.60517018598809,4.75359019110636,0.148420005118273,9.35876037709446,4.60517018598809,4.75359019110636,0,0,1,1.7157,3,0.3638,LESS
2,94,100,6,194,94,100,4.54329478227,4.60517018598809,0.061875403718088,9.1484649682581,4.54329478227,4.60517018598809,0,0,1,2.7998,2,0.8974,LESS
2,54,50,4,104,50,54,3.98898404656427,3.91202300542815,0.0769610411361286,7.90100705199242,3.91202300542815,3.98898404656427,1,1,1,2.0114,2,0.4849,LESS
2,92,100,8,192,100,92,4.52178857704904,4.60517018598809,0.0833816089390513,9.12695876303713,4.60517018598809,4.52178857704904,1,0,0,2.0684,1,0.5065,LESS
2,49,50,1,99,49,50,3.89182029811063,3.91202300542815,0.0202027073175195,7.80384330353877,3.89182029811063,3.91202300542815,0,0,1,1.5086,2,0.9376,LESS
2,110,100,10,210,100,110,4.70048036579242,4.60517018598809,0.0953101798043248,9.30565055178051,4.60517018598809,4.70048036579242,1,1,1,2.1838,1,0.718,LESS
2,116,100,16,216,100,116,4.75359019110636,4.60517018598809,0.148420005118273,9.35876037709446,4.60517018598809,4.75359019110636,1,1,1,1.2185,3,0.7639,LESS
2,150,129,21,279,129,150,5.01063529409626,4.85981240436167,0.150822889734584,9.87044769845793,4.85981240436167,5.01063529409626,1,1,1,1.3773,3,1.0819,LESS
2,50,45,5,95,50,45,3.91202300542815,3.80666248977032,0.105360515657826,7.71868549519847,3.91202300542815,3.80666248977032,0,1,0,2.4625,2,0.4508,LESS
2,53,50,3,103,50,53,3.97029191355212,3.91202300542815,0.058268908123976,7.88231491898027,3.91202300542815,3.97029191355212,1,1,1,1.351,4,0.9698,LESS
2,98,100,2,198,98,100,4.58496747867057,4.60517018598809,0.0202027073175195,9.19013766465866,4.58496747867057,4.60517018598809,0,0,1,1.3965,2,0.3498,LESS
2,80,100,20,180,80,100,4.38202663467388,4.60517018598809,0.223143551314211,8.98719682066197,4.38202663467388,4.60517018598809,0,0,1,2.3234,1,0.4202,LESS
2,150,174,24,324,150,174,5.01063529409626,5.15905529921453,0.148420005118274,10.1696905933108,5.01063529409626,5.15905529921453,0,0,1,1.2622,3,0.4317,LESS
2,55,50,5,105,50,55,4.00733318523247,3.91202300542815,0.0953101798043252,7.91935619066062,3.91202300542815,4.00733318523247,1,1,1,1.4707,4,0.9584,LESS
2,118,100,18,218,100,118,4.77068462446567,4.60517018598809,0.165514438477573,9.37585481045376,4.60517018598809,4.77068462446567,1,1,1,1.1963,3,0.6312,LESS
2,46,50,4,96,50,46,3.8286413964891,3.91202300542815,0.0833816089390509,7.74066440191724,3.91202300542815,3.8286413964891,1,0,0,1.3507,3,0.956,LESS
2,50,48,2,98,48,50,3.91202300542815,3.87120101090789,0.0408219945202548,7.78322401633604,3.87120101090789,3.91202300542815,1,1,1,1.5918,2,0.7644,LESS
2,46,50,4,96,46,50,3.8286413964891,3.91202300542815,0.0833816089390509,7.74066440191724,3.8286413964891,3.91202300542815,0,0,1,1.5133,2,0.5834,LESS
2,100,82,18,182,82,100,4.60517018598809,4.40671924726425,0.198450938723838,9.01188943325235,4.40671924726425,4.60517018598809,1,1,1,1.2564,3,0.7723,LESS
2,50,43,7,93,43,50,3.91202300542815,3.76120011569356,0.150822889734584,7.67322312112171,3.76120011569356,3.91202300542815,1,1,1,1.1932,4,0.6348,LESS
2,55,50,5,105,50,55,4.00733318523247,3.91202300542815,0.0953101798043252,7.91935619066062,3.91202300542815,4.00733318523247,1,1,1,2.7677,2,0.4011,LESS
2,150,177,27,327,150,177,5.01063529409626,5.17614973257383,0.165514438477573,10.1867850266701,5.01063529409626,5.17614973257383,0,0,1,1.3275,3,1.1667,LESS
2,150,162,12,312,162,150,5.01063529409626,5.08759633523238,0.0769610411361281,10.0982316293286,5.08759633523238,5.01063529409626,1,0,0,2.8565,1,0.3239,LESS
2,120,100,20,220,100,120,4.78749174278205,4.60517018598809,0.182321556793954,9.39266192877014,4.60517018598809,4.78749174278205,1,1,1,1.1289,4,0.7813,LESS
2,141,150,9,291,141,150,4.94875989037817,5.01063529409626,0.0618754037180871,9.95939518447442,4.94875989037817,5.01063529409626,0,0,1,1.3592,2,0.3798,LESS
2,102,100,2,202,100,102,4.62497281328427,4.60517018598809,0.0198026272961789,9.23014299927236,4.60517018598809,4.62497281328427,1,1,1,1.0353,3,0.6535,LESS
2,50,56,6,106,50,56,3.91202300542815,4.02535169073515,0.113328685307004,7.9373746961633,3.91202300542815,4.02535169073515,0,0,1,1.3118,2,0.6529,LESS
2,100,108,8,208,108,100,4.60517018598809,4.68213122712422,0.0769610411361281,9.28730141311231,4.68213122712422,4.60517018598809,1,0,0,1.2652,3,1.1421,LESS
2,177,150,27,327,150,177,5.17614973257383,5.01063529409626,0.165514438477573,10.1867850266701,5.01063529409626,5.17614973257383,1,1,1,1.1432,4,0.5519,LESS
2,100,80,20,180,80,100,4.60517018598809,4.38202663467388,0.223143551314211,8.98719682066197,4.38202663467388,4.60517018598809,1,1,1,1.0682,4,0.5793,LESS
2,50,53,3,103,53,50,3.91202300542815,3.97029191355212,0.058268908123976,7.88231491898027,3.97029191355212,3.91202300542815,1,0,0,1.7168,2,0.3693,LESS
2,106,100,6,206,100,106,4.66343909411207,4.60517018598809,0.0582689081239751,9.26860928010016,4.60517018598809,4.66343909411207,1,1,1,1.4598,3,0.4042,LESS
2,150,171,21,321,150,171,5.01063529409626,5.14166355650266,0.131028262406405,10.1522988505989,5.01063529409626,5.14166355650266,0,0,1,1.3603,2,0.5134,LESS
2,100,82,18,182,82,100,4.60517018598809,4.40671924726425,0.198450938723838,9.01188943325235,4.40671924726425,4.60517018598809,1,1,1,1.0468,3,0.5298,LESS
2,168,150,18,318,150,168,5.12396397940326,5.01063529409626,0.113328685307003,10.1345992734995,5.01063529409626,5.12396397940326,1,1,1,1.4145,2,0.5186,LESS
2,50,40,10,90,40,50,3.91202300542815,3.68887945411394,0.22314355131421,7.60090245954208,3.68887945411394,3.91202300542815,1,1,1,1.1697,4,0.5683,LESS
2,156,150,6,306,156,150,5.04985600724954,5.01063529409626,0.0392207131532816,10.0604913013458,5.04985600724954,5.01063529409626,0,1,0,1.515,2,0.2993,LESS
2,144,150,6,294,150,144,4.969813299576,5.01063529409626,0.0408219945202548,9.98044859367226,5.01063529409626,4.969813299576,1,0,0,1.4747,2,0.6756,LESS
2,100,114,14,214,100,114,4.60517018598809,4.7361984483945,0.131028262406404,9.34136863438259,4.60517018598809,4.7361984483945,0,0,1,1.3515,2,0.6873,LESS
2,120,150,30,270,120,150,4.78749174278205,5.01063529409626,0.22314355131421,9.7981270368783,4.78749174278205,5.01063529409626,0,0,1,1.3581,1,0.639,LESS
2,123,150,27,273,123,150,4.81218435537242,5.01063529409626,0.198450938723838,9.82281964946867,4.81218435537242,5.01063529409626,0,0,1,1.5442,2,0.4636,LESS
2,150,159,9,309,159,150,5.01063529409626,5.06890420222023,0.058268908123976,10.0795394963165,5.06890420222023,5.01063529409626,1,0,0,2.2397,2,0.7889,LESS
2,100,110,10,210,110,100,4.60517018598809,4.70048036579242,0.0953101798043248,9.30565055178051,4.70048036579242,4.60517018598809,1,0,0,1.1783,3,0.4404,LESS
2,106,100,6,206,100,106,4.66343909411207,4.60517018598809,0.0582689081239751,9.26860928010016,4.60517018598809,4.66343909411207,1,1,1,1.7371,2,0.3559,LESS
2,50,45,5,95,45,50,3.91202300542815,3.80666248977032,0.105360515657826,7.71868549519847,3.80666248977032,3.91202300542815,1,1,1,1.2764,4,0.4898,LESS
2,150,138,12,288,138,150,5.01063529409626,4.92725368515721,0.0833816089390504,9.93788897925346,4.92725368515721,5.01063529409626,1,1,1,1.5018,2,0.3985,LESS
2,50,47,3,97,50,47,3.91202300542815,3.85014760171006,0.0618754037180875,7.7621706071382,3.91202300542815,3.85014760171006,0,1,0,2.4607,1,0.3769,LESS
2,150,144,6,294,144,150,5.01063529409626,4.969813299576,0.0408219945202548,9.98044859367226,4.969813299576,5.01063529409626,1,1,1,1.2094,2,0.4178,LESS
2,50,52,2,102,52,50,3.91202300542815,3.95124371858143,0.0392207131532816,7.86326672400957,3.95124371858143,3.91202300542815,1,0,0,1.1696,3,0.9084,LESS
2,100,84,16,184,84,100,4.60517018598809,4.43081679884331,0.174353387144778,9.03598698483141,4.43081679884331,4.60517018598809,1,1,1,1.2818,3,0.7141,LESS
2,135,150,15,285,135,150,4.90527477843843,5.01063529409626,0.105360515657826,9.91591007253469,4.90527477843843,5.01063529409626,0,0,1,1.1938,4,0.668,LESS
2,50,58,8,108,50,58,3.91202300542815,4.06044301054642,0.148420005118273,7.97246601597456,3.91202300542815,4.06044301054642,0,0,1,1.2118,4,0.798,LESS
2,50,51,1,101,51,50,3.91202300542815,3.93182563272433,0.0198026272961798,7.84384863815247,3.93182563272433,3.91202300542815,1,0,0,1.1282,3,0.8246,LESS
2,100,96,4,196,96,100,4.60517018598809,4.56434819146784,0.0408219945202557,9.16951837745593,4.56434819146784,4.60517018598809,1,1,1,1.2013,3,0.4518,LESS
2,150,129,21,279,129,150,5.01063529409626,4.85981240436167,0.150822889734584,9.87044769845793,4.85981240436167,5.01063529409626,1,1,1,1.2509,3,0.5513,LESS
2,98,100,2,198,98,100,4.58496747867057,4.60517018598809,0.0202027073175195,9.19013766465866,4.58496747867057,4.60517018598809,0,0,1,1.9248,2,0.5017,LESS
2,84,100,16,184,84,100,4.43081679884331,4.60517018598809,0.174353387144778,9.03598698483141,4.43081679884331,4.60517018598809,0,0,1,1.5433,2,0.3712,LESS
2,104,100,4,204,100,104,4.64439089914137,4.60517018598809,0.0392207131532807,9.24956108512946,4.60517018598809,4.64439089914137,1,1,1,1.823,2,0.4523,LESS
2,50,54,4,104,54,50,3.91202300542815,3.98898404656427,0.0769610411361286,7.90100705199242,3.98898404656427,3.91202300542815,1,0,0,1.2616,3,0.4178,LESS
2,100,80,20,180,80,100,4.60517018598809,4.38202663467388,0.223143551314211,8.98719682066197,4.38202663467388,4.60517018598809,1,1,1,1.2281,2,0.7688,LESS
2,100,116,16,216,116,100,4.60517018598809,4.75359019110636,0.148420005118273,9.35876037709446,4.75359019110636,4.60517018598809,1,0,0,1.5021,1,0.7298,LESS
2,41,50,9,91,41,50,3.71357206670431,3.91202300542815,0.198450938723838,7.62559507213245,3.71357206670431,3.91202300542815,0,0,1,1.3816,3,1.8696,LESS
2,153,150,3,303,150,153,5.03043792139244,5.01063529409626,0.0198026272961798,10.0410732154887,5.01063529409626,5.03043792139244,1,1,1,1.4451,2,0.5023,LESS
2,100,104,4,204,104,100,4.60517018598809,4.64439089914137,0.0392207131532807,9.24956108512946,4.64439089914137,4.60517018598809,1,0,0,1.5712,2,0.4723,LESS
2,116,100,16,216,100,116,4.75359019110636,4.60517018598809,0.148420005118273,9.35876037709446,4.60517018598809,4.75359019110636,1,1,1,1.322,3,0.9601,LESS
2,150,177,27,327,177,150,5.01063529409626,5.17614973257383,0.165514438477573,10.1867850266701,5.17614973257383,5.01063529409626,1,0,0,1.2283,3,0.3976,LESS
2,150,153,3,303,153,150,5.01063529409626,5.03043792139244,0.0198026272961798,10.0410732154887,5.03043792139244,5.01063529409626,1,0,0,1.8651,2,0.3996,LESS
2,54,50,4,104,50,54,3.98898404656427,3.91202300542815,0.0769610411361286,7.90100705199242,3.91202300542815,3.98898404656427,1,1,1,1.2863,1,0.5028,LESS
2,100,88,12,188,88,100,4.60517018598809,4.47733681447821,0.127833371509885,9.0825070004663,4.47733681447821,4.60517018598809,1,1,1,1.1048,3,0.6034,LESS
2,100,90,10,190,90,100,4.60517018598809,4.49980967033027,0.105360515657827,9.10497985631836,4.49980967033027,4.60517018598809,1,1,1,1.4803,2,0.6355,LESS
2,100,92,8,192,92,100,4.60517018598809,4.52178857704904,0.0833816089390513,9.12695876303713,4.52178857704904,4.60517018598809,1,1,1,1.5764,2,0.389,LESS
2,90,100,10,190,90,100,4.49980967033027,4.60517018598809,0.105360515657827,9.10497985631836,4.49980967033027,4.60517018598809,0,0,1,1.5751,2,1.0307,LESS
2,100,118,18,218,100,118,4.60517018598809,4.77068462446567,0.165514438477573,9.37585481045376,4.60517018598809,4.77068462446567,0,0,1,1.1484,3,1.571,LESS
2,100,106,6,206,100,106,4.60517018598809,4.66343909411207,0.0582689081239751,9.26860928010016,4.60517018598809,4.66343909411207,0,0,1,1.1977,2,0.5593,LESS
2,150,135,15,285,150,135,5.01063529409626,4.90527477843843,0.105360515657826,9.91591007253469,5.01063529409626,4.90527477843843,0,1,0,1.3434,2,1.0874,LESS
2,50,52,2,102,52,50,3.91202300542815,3.95124371858143,0.0392207131532816,7.86326672400957,3.95124371858143,3.91202300542815,1,0,0,2.0309,2,0.3535,LESS
2,58,50,8,108,50,58,4.06044301054642,3.91202300542815,0.148420005118273,7.97246601597456,3.91202300542815,4.06044301054642,1,1,1,1.8191,2,0.6468,LESS
2,88,100,12,188,88,100,4.47733681447821,4.60517018598809,0.127833371509885,9.0825070004663,4.47733681447821,4.60517018598809,0,0,1,1.2606,3,1.946,LESS
2,100,114,14,214,100,114,4.60517018598809,4.7361984483945,0.131028262406404,9.34136863438259,4.60517018598809,4.7361984483945,0,0,1,1.2934,2,0.6471,LESS
2,86,100,14,186,86,100,4.45434729625351,4.60517018598809,0.150822889734584,9.0595174822416,4.45434729625351,4.60517018598809,0,0,1,1.2148,2,0.9357,LESS
2,159,150,9,309,159,150,5.06890420222023,5.01063529409626,0.058268908123976,10.0795394963165,5.06890420222023,5.01063529409626,0,1,0,2.0039,1,0.565,LESS
2,138,150,12,288,150,138,4.92725368515721,5.01063529409626,0.0833816089390504,9.93788897925346,5.01063529409626,4.92725368515721,1,0,0,2.4427,1,0.899,LESS
2,150,135,15,285,135,150,5.01063529409626,4.90527477843843,0.105360515657826,9.91591007253469,4.90527477843843,5.01063529409626,1,1,1,1.2126,3,0.4404,LESS
2,100,112,12,212,100,112,4.60517018598809,4.71849887129509,0.113328685307002,9.32366905728319,4.60517018598809,4.71849887129509,0,0,1,1.3632,2,0.4213,LESS
2,50,43,7,93,43,50,3.91202300542815,3.76120011569356,0.150822889734584,7.67322312112171,3.76120011569356,3.91202300542815,1,1,1,1.1733,3,0.4012,LESS
2,42,50,8,92,42,50,3.73766961828337,3.91202300542815,0.174353387144778,7.64969262371151,3.73766961828337,3.91202300542815,0,0,1,1.6149,2,0.3365,LESS
2,60,50,10,110,50,60,4.0943445622221,3.91202300542815,0.182321556793954,8.00636756765025,3.91202300542815,4.0943445622221,1,1,1,1.306,3,0.5756,LESS
2,60,50,10,110,50,60,4.0943445622221,3.91202300542815,0.182321556793954,8.00636756765025,3.91202300542815,4.0943445622221,1,1,1,1.7654,2,0.3256,LESS
2,100,110,10,210,100,110,4.60517018598809,4.70048036579242,0.0953101798043248,9.30565055178051,4.60517018598809,4.70048036579242,0,0,1,1.2277,3,0.4965,LESS
2,57,50,7,107,50,57,4.04305126783455,3.91202300542815,0.131028262406404,7.9550742732627,3.91202300542815,4.04305126783455,1,1,1,1.8592,2,0.4906,LESS
2,50,58,8,108,50,58,3.91202300542815,4.06044301054642,0.148420005118273,7.97246601597456,3.91202300542815,4.06044301054642,0,0,1,1.5882,1,0.4534,LESS
2,59,50,9,109,50,59,4.07753744390572,3.91202300542815,0.165514438477574,7.98956044933387,3.91202300542815,4.07753744390572,1,1,1,1.3122,4,0.6806,LESS
2,150,132,18,282,132,150,5.01063529409626,4.88280192258637,0.127833371509885,9.89343721668263,4.88280192258637,5.01063529409626,1,1,1,1.4726,2,0.5893,LESS
2,50,57,7,107,57,50,3.91202300542815,4.04305126783455,0.131028262406404,7.9550742732627,4.04305126783455,3.91202300542815,1,0,0,2.0832,2,0.5606,LESS
2,52,50,2,102,50,52,3.95124371858143,3.91202300542815,0.0392207131532816,7.86326672400957,3.91202300542815,3.95124371858143,1,1,1,1.237,3,0.342,LESS
2,90,100,10,190,90,100,4.49980967033027,4.60517018598809,0.105360515657827,9.10497985631836,4.49980967033027,4.60517018598809,0,0,1,1.169,3,0.5251,LESS
2,150,153,3,303,150,153,5.01063529409626,5.03043792139244,0.0198026272961798,10.0410732154887,5.01063529409626,5.03043792139244,0,0,1,1.4842,2,0.6335,LESS
2,150,168,18,318,150,168,5.01063529409626,5.12396397940326,0.113328685307003,10.1345992734995,5.01063529409626,5.12396397940326,0,0,1,2.0502,1,0.7185,LESS
2,165,150,15,315,165,150,5.10594547390058,5.01063529409626,0.0953101798043248,10.1165807679968,5.10594547390058,5.01063529409626,0,1,0,3.2652,2,0.9472,LESS
2,44,50,6,94,44,50,3.78418963391826,3.91202300542815,0.127833371509885,7.69621263934641,3.78418963391826,3.91202300542815,0,0,1,2.0806,1,0.7183,LESS
2,82,100,18,182,82,100,4.40671924726425,4.60517018598809,0.198450938723838,9.01188943325235,4.40671924726425,4.60517018598809,0,0,1,1.2941,4,0.5351,LESS
2,100,88,12,188,88,100,4.60517018598809,4.47733681447821,0.127833371509885,9.0825070004663,4.47733681447821,4.60517018598809,1,1,1,2.2178,2,0.3162,LESS
2,129,150,21,279,129,150,4.85981240436167,5.01063529409626,0.150822889734584,9.87044769845793,4.85981240436167,5.01063529409626,0,0,1,1.2084,4,0.4397,LESS
2,40,50,10,90,40,50,3.68887945411394,3.91202300542815,0.22314355131421,7.60090245954208,3.68887945411394,3.91202300542815,0,0,1,1.205,4,0.5004,LESS
2,50,55,5,105,50,55,3.91202300542815,4.00733318523247,0.0953101798043252,7.91935619066062,3.91202300542815,4.00733318523247,0,0,1,1.4847,3,0.7214,LESS
2,50,60,10,110,50,60,3.91202300542815,4.0943445622221,0.182321556793954,8.00636756765025,3.91202300542815,4.0943445622221,0,0,1,1.3536,3,0.4578,LESS
2,165,150,15,315,165,150,5.10594547390058,5.01063529409626,0.0953101798043248,10.1165807679968,5.10594547390058,5.01063529409626,0,1,0,1.9544,2,0.3557,LESS
2,104,100,4,204,100,104,4.64439089914137,4.60517018598809,0.0392207131532807,9.24956108512946,4.60517018598809,4.64439089914137,1,1,1,2.4673,1,0.865,LESS
2,50,42,8,92,42,50,3.91202300542815,3.73766961828337,0.174353387144778,7.64969262371151,3.73766961828337,3.91202300542815,1,1,1,1.8186,2,0.4847,LESS
2,88,100,12,188,88,100,4.47733681447821,4.60517018598809,0.127833371509885,9.0825070004663,4.47733681447821,4.60517018598809,0,0,1,1.6849,3,0.7156,LESS
2,50,59,9,109,50,59,3.91202300542815,4.07753744390572,0.165514438477574,7.98956044933387,3.91202300542815,4.07753744390572,0,0,1,1.2951,4,0.5183,LESS
3,100,106,6,206,106,100,4.60517018598809,4.66343909411207,0.0582689081239751,9.26860928010016,4.66343909411207,4.60517018598809,1,0,0,1.4367,2,1.2038,LESS
3,88,100,12,188,88,100,4.47733681447821,4.60517018598809,0.127833371509885,9.0825070004663,4.47733681447821,4.60517018598809,0,0,1,1.6318,1,1.3333,LESS
3,56,50,6,106,50,56,4.02535169073515,3.91202300542815,0.113328685307004,7.9373746961633,3.91202300542815,4.02535169073515,1,1,1,1.6434,1,1.1829,LESS
3,60,50,10,110,50,60,4.0943445622221,3.91202300542815,0.182321556793954,8.00636756765025,3.91202300542815,4.0943445622221,1,1,1,1.1502,3,1.8199,LESS
3,171,150,21,321,150,171,5.14166355650266,5.01063529409626,0.131028262406405,10.1522988505989,5.01063529409626,5.14166355650266,1,1,1,1.2435,3,0.9496,LESS
3,41,50,9,91,41,50,3.71357206670431,3.91202300542815,0.198450938723838,7.62559507213245,3.71357206670431,3.91202300542815,0,0,1,1.2561,1,0.7674,LESS
3,40,50,10,90,50,40,3.68887945411394,3.91202300542815,0.22314355131421,7.60090245954208,3.91202300542815,3.68887945411394,1,0,0,1.521,2,0.9829,LESS
3,168,150,18,318,150,168,5.12396397940326,5.01063529409626,0.113328685307003,10.1345992734995,5.01063529409626,5.12396397940326,1,1,1,1.4978,3,1.2508,LESS
3,120,100,20,220,100,120,4.78749174278205,4.60517018598809,0.182321556793954,9.39266192877014,4.60517018598809,4.78749174278205,1,1,1,1.6653,2,1.336,LESS
3,92,100,8,192,100,92,4.52178857704904,4.60517018598809,0.0833816089390513,9.12695876303713,4.60517018598809,4.52178857704904,1,0,0,1.589,1,1.0987,LESS
3,118,100,18,218,100,118,4.77068462446567,4.60517018598809,0.165514438477573,9.37585481045376,4.60517018598809,4.77068462446567,1,1,1,1.3202,2,1.1495,LESS
3,50,48,2,98,50,48,3.91202300542815,3.87120101090789,0.0408219945202548,7.78322401633604,3.91202300542815,3.87120101090789,0,1,0,1.6142,1,0.867,LESS
3,100,106,6,206,100,106,4.60517018598809,4.66343909411207,0.0582689081239751,9.26860928010016,4.60517018598809,4.66343909411207,0,0,1,1.7299,1,1.9835,LESS
3,100,108,8,208,100,108,4.60517018598809,4.68213122712422,0.0769610411361281,9.28730141311231,4.60517018598809,4.68213122712422,0,0,1,1.9305,2,1.1835,LESS
3,43,50,7,93,43,50,3.76120011569356,3.91202300542815,0.150822889734584,7.67322312112171,3.76120011569356,3.91202300542815,0,0,1,1.5324,1,1.0166,LESS
3,150,162,12,312,150,162,5.01063529409626,5.08759633523238,0.0769610411361281,10.0982316293286,5.01063529409626,5.08759633523238,0,0,1,1.6443,1,1.2658,LESS
3,100,84,16,184,84,100,4.60517018598809,4.43081679884331,0.174353387144778,9.03598698483141,4.43081679884331,4.60517018598809,1,1,1,1.2398,3,1.2486,LESS
3,56,50,6,106,50,56,4.02535169073515,3.91202300542815,0.113328685307004,7.9373746961633,3.91202300542815,4.02535169073515,1,1,1,1.5611,3,0.8329,LESS
3,150,129,21,279,129,150,5.01063529409626,4.85981240436167,0.150822889734584,9.87044769845793,4.85981240436167,5.01063529409626,1,1,1,1.3282,2,1.0336,LESS
3,150,144,6,294,144,150,5.01063529409626,4.969813299576,0.0408219945202548,9.98044859367226,4.969813299576,5.01063529409626,1,1,1,1.4852,2,1.2716,LESS
3,50,54,4,104,50,54,3.91202300542815,3.98898404656427,0.0769610411361286,7.90100705199242,3.91202300542815,3.98898404656427,0,0,1,1.3582,3,1.0997,LESS
3,135,150,15,285,135,150,4.90527477843843,5.01063529409626,0.105360515657826,9.91591007253469,4.90527477843843,5.01063529409626,0,0,1,1.3102,2,1.4166,LESS
3,135,150,15,285,150,135,4.90527477843843,5.01063529409626,0.105360515657826,9.91591007253469,5.01063529409626,4.90527477843843,1,0,0,1.5206,2,1.3169,LESS
3,100,92,8,192,92,100,4.60517018598809,4.52178857704904,0.0833816089390513,9.12695876303713,4.52178857704904,4.60517018598809,1,1,1,1.4216,2,1.1002,LESS
3,57,50,7,107,57,50,4.04305126783455,3.91202300542815,0.131028262406404,7.9550742732627,4.04305126783455,3.91202300542815,0,1,0,1.2984,2,1.1327,LESS
3,59,50,9,109,50,59,4.07753744390572,3.91202300542815,0.165514438477574,7.98956044933387,3.91202300542815,4.07753744390572,1,1,1,1.2309,3,0.8815,LESS
3,147,150,3,297,150,147,4.99043258677874,5.01063529409626,0.0202027073175195,10.001067880875,5.01063529409626,4.99043258677874,1,0,0,1.2075,3,0.8721,LESS
3,123,150,27,273,123,150,4.81218435537242,5.01063529409626,0.198450938723838,9.82281964946867,4.81218435537242,5.01063529409626,0,0,1,1.2527,2,0.9829,LESS
3,51,50,1,101,50,51,3.93182563272433,3.91202300542815,0.0198026272961798,7.84384863815247,3.91202300542815,3.93182563272433,1,1,1,0.9935,3,0.9839,LESS
3,50,58,8,108,58,50,3.91202300542815,4.06044301054642,0.148420005118273,7.97246601597456,4.06044301054642,3.91202300542815,1,0,0,2.4356,3,0.8323,LESS
3,150,147,3,297,147,150,5.01063529409626,4.99043258677874,0.0202027073175195,10.001067880875,4.99043258677874,5.01063529409626,1,1,1,1.3761,2,0.9839,LESS
3,100,98,2,198,98,100,4.60517018598809,4.58496747867057,0.0202027073175195,9.19013766465866,4.58496747867057,4.60517018598809,1,1,1,1.6528,1,0.6161,LESS
3,150,174,24,324,150,174,5.01063529409626,5.15905529921453,0.148420005118274,10.1696905933108,5.01063529409626,5.15905529921453,0,0,1,1.3,1,0.8534,LESS
3,180,150,30,330,150,180,5.19295685089021,5.01063529409626,0.182321556793955,10.2035921449865,5.01063529409626,5.19295685089021,1,1,1,1.1192,2,0.7177,LESS
3,55,50,5,105,55,50,4.00733318523247,3.91202300542815,0.0953101798043252,7.91935619066062,4.00733318523247,3.91202300542815,0,1,0,2.1763,1,0.3984,LESS
3,150,159,9,309,159,150,5.01063529409626,5.06890420222023,0.058268908123976,10.0795394963165,5.06890420222023,5.01063529409626,1,0,0,1.2774,1,1.0664,LESS
3,50,42,8,92,42,50,3.91202300542815,3.73766961828337,0.174353387144778,7.64969262371151,3.73766961828337,3.91202300542815,1,1,1,1.2264,3,0.9017,LESS
3,153,150,3,303,150,153,5.03043792139244,5.01063529409626,0.0198026272961798,10.0410732154887,5.01063529409626,5.03043792139244,1,1,1,1.2224,2,0.747,LESS
3,150,168,18,318,150,168,5.01063529409626,5.12396397940326,0.113328685307003,10.1345992734995,5.01063529409626,5.12396397940326,0,0,1,1.4245,1,0.5535,LESS
3,52,50,2,102,50,52,3.95124371858143,3.91202300542815,0.0392207131532816,7.86326672400957,3.91202300542815,3.95124371858143,1,1,1,1.4589,2,1.0515,LESS
3,150,177,27,327,150,177,5.01063529409626,5.17614973257383,0.165514438477573,10.1867850266701,5.01063529409626,5.17614973257383,0,0,1,1.6135,1,0.6,LESS
3,51,50,1,101,50,51,3.93182563272433,3.91202300542815,0.0198026272961798,7.84384863815247,3.91202300542815,3.93182563272433,1,1,1,1.6032,2,1.3499,LESS
3,108,100,8,208,100,108,4.68213122712422,4.60517018598809,0.0769610411361281,9.28730141311231,4.60517018598809,4.68213122712422,1,1,1,0.8789,2,0.7521,LESS
3,54,50,4,104,50,54,3.98898404656427,3.91202300542815,0.0769610411361286,7.90100705199242,3.91202300542815,3.98898404656427,1,1,1,1.0786,3,1.1873,LESS
3,100,118,18,218,100,118,4.60517018598809,4.77068462446567,0.165514438477573,9.37585481045376,4.60517018598809,4.77068462446567,0,0,1,0.806,2,1.8844,LESS
3,50,40,10,90,40,50,3.91202300542815,3.68887945411394,0.22314355131421,7.60090245954208,3.68887945411394,3.91202300542815,1,1,1,1.2475,3,1.0508,LESS
3,177,150,27,327,150,177,5.17614973257383,5.01063529409626,0.165514438477573,10.1867850266701,5.01063529409626,5.17614973257383,1,1,1,1.2854,2,1.166,LESS
3,100,90,10,190,90,100,4.60517018598809,4.49980967033027,0.105360515657827,9.10497985631836,4.49980967033027,4.60517018598809,1,1,1,1.1873,2,1.0662,LESS
3,150,135,15,285,135,150,5.01063529409626,4.90527477843843,0.105360515657826,9.91591007253469,4.90527477843843,5.01063529409626,1,1,1,1.7237,2,0.8638,LESS
3,100,102,2,202,102,100,4.60517018598809,4.62497281328427,0.0198026272961789,9.23014299927236,4.62497281328427,4.60517018598809,1,0,0,1.6544,1,1.2789,LESS
3,100,88,12,188,88,100,4.60517018598809,4.47733681447821,0.127833371509885,9.0825070004663,4.47733681447821,4.60517018598809,1,1,1,2.4398,2,0.9173,LESS
3,42,50,8,92,42,50,3.73766961828337,3.91202300542815,0.174353387144778,7.64969262371151,3.73766961828337,3.91202300542815,0,0,1,1.3971,2,1.2002,LESS
3,150,165,15,315,165,150,5.01063529409626,5.10594547390058,0.0953101798043248,10.1165807679968,5.10594547390058,5.01063529409626,1,0,0,1.5309,2,1.0323,LESS
3,44,50,6,94,44,50,3.78418963391826,3.91202300542815,0.127833371509885,7.69621263934641,3.78418963391826,3.91202300542815,0,0,1,2.3756,1,0.665,LESS
3,150,180,30,330,150,180,5.01063529409626,5.19295685089021,0.182321556793955,10.2035921449865,5.01063529409626,5.19295685089021,0,0,1,1.2494,2,0.8165,LESS
3,48,50,2,98,48,50,3.87120101090789,3.91202300542815,0.0408219945202548,7.78322401633604,3.87120101090789,3.91202300542815,0,0,1,1.1232,3,1.0167,LESS
3,41,50,9,91,41,50,3.71357206670431,3.91202300542815,0.198450938723838,7.62559507213245,3.71357206670431,3.91202300542815,0,0,1,1.2227,3,1.0337,LESS
3,120,150,30,270,120,150,4.78749174278205,5.01063529409626,0.22314355131421,9.7981270368783,4.78749174278205,5.01063529409626,0,0,1,1.1834,2,1.0675,LESS
3,50,56,6,106,50,56,3.91202300542815,4.02535169073515,0.113328685307004,7.9373746961633,3.91202300542815,4.02535169073515,0,0,1,2.0756,1,0.8499,LESS
3,112,100,12,212,100,112,4.71849887129509,4.60517018598809,0.113328685307002,9.32366905728319,4.60517018598809,4.71849887129509,1,1,1,1.2409,2,1.0518,LESS
3,114,100,14,214,100,114,4.7361984483945,4.60517018598809,0.131028262406404,9.34136863438259,4.60517018598809,4.7361984483945,1,1,1,1.1381,2,1.217,LESS
3,100,86,14,186,86,100,4.60517018598809,4.45434729625351,0.150822889734584,9.0595174822416,4.45434729625351,4.60517018598809,1,1,1,1.1962,2,0.8159,LESS
3,150,177,27,327,150,177,5.01063529409626,5.17614973257383,0.165514438477573,10.1867850266701,5.01063529409626,5.17614973257383,0,0,1,1.2577,1,0.7332,LESS
3,40,50,10,90,40,50,3.68887945411394,3.91202300542815,0.22314355131421,7.60090245954208,3.68887945411394,3.91202300542815,0,0,1,0.9389,3,1.0215,LESS
3,50,48,2,98,50,48,3.91202300542815,3.87120101090789,0.0408219945202548,7.78322401633604,3.91202300542815,3.87120101090789,0,1,0,1.4034,2,1.1466,LESS
3,45,50,5,95,45,50,3.80666248977032,3.91202300542815,0.105360515657826,7.71868549519847,3.80666248977032,3.91202300542815,0,0,1,1.1038,3,0.9672,LESS
3,165,150,15,315,150,165,5.10594547390058,5.01063529409626,0.0953101798043248,10.1165807679968,5.01063529409626,5.10594547390058,1,1,1,1.7051,1,0.9663,LESS
3,50,45,5,95,45,50,3.91202300542815,3.80666248977032,0.105360515657826,7.71868549519847,3.80666248977032,3.91202300542815,1,1,1,1.5109,2,0.9162,LESS
3,100,108,8,208,100,108,4.60517018598809,4.68213122712422,0.0769610411361281,9.28730141311231,4.60517018598809,4.68213122712422,0,0,1,0.9782,2,0.8815,LESS
3,102,100,2,202,100,102,4.62497281328427,4.60517018598809,0.0198026272961789,9.23014299927236,4.60517018598809,4.62497281328427,1,1,1,1.3382,2,0.7503,LESS
3,156,150,6,306,150,156,5.04985600724954,5.01063529409626,0.0392207131532816,10.0604913013458,5.01063529409626,5.04985600724954,1,1,1,0.9296,2,1.1339,LESS
3,102,100,2,202,102,100,4.62497281328427,4.60517018598809,0.0198026272961789,9.23014299927236,4.62497281328427,4.60517018598809,0,1,0,1.0678,1,0.7105,LESS
3,150,123,27,273,123,150,5.01063529409626,4.81218435537242,0.198450938723838,9.82281964946867,4.81218435537242,5.01063529409626,1,1,1,1.7902,2,0.8833,LESS
3,150,132,18,282,132,150,5.01063529409626,4.88280192258637,0.127833371509885,9.89343721668263,4.88280192258637,5.01063529409626,1,1,1,1.044,2,0.5489,LESS
3,100,112,12,212,100,112,4.60517018598809,4.71849887129509,0.113328685307002,9.32366905728319,4.60517018598809,4.71849887129509,0,0,1,1.6239,1,0.5488,LESS
3,150,141,9,291,141,150,5.01063529409626,4.94875989037817,0.0618754037180871,9.95939518447442,4.94875989037817,5.01063529409626,1,1,1,1.1375,2,0.7678,LESS
3,90,100,10,190,100,90,4.49980967033027,4.60517018598809,0.105360515657827,9.10497985631836,4.60517018598809,4.49980967033027,1,0,0,1.974,2,0.6815,LESS
3,132,150,18,282,132,150,4.88280192258637,5.01063529409626,0.127833371509885,9.89343721668263,4.88280192258637,5.01063529409626,0,0,1,1.4556,2,1.1666,LESS
3,150,165,15,315,165,150,5.01063529409626,5.10594547390058,0.0953101798043248,10.1165807679968,5.10594547390058,5.01063529409626,1,0,0,1.2364,1,1.2538,LESS
3,150,162,12,312,150,162,5.01063529409626,5.08759633523238,0.0769610411361281,10.0982316293286,5.01063529409626,5.08759633523238,0,0,1,1.4905,1,1.0669,LESS
3,118,100,18,218,100,118,4.77068462446567,4.60517018598809,0.165514438477573,9.37585481045376,4.60517018598809,4.77068462446567,1,1,1,1.0371,2,0.85,LESS
3,50,45,5,95,45,50,3.91202300542815,3.80666248977032,0.105360515657826,7.71868549519847,3.80666248977032,3.91202300542815,1,1,1,1.3272,2,0.8001,LESS
3,116,100,16,216,100,116,4.75359019110636,4.60517018598809,0.148420005118273,9.35876037709446,4.60517018598809,4.75359019110636,1,1,1,1.0864,2,0.9996,LESS
3,100,80,20,180,80,100,4.60517018598809,4.38202663467388,0.223143551314211,8.98719682066197,4.38202663467388,4.60517018598809,1,1,1,0.7758,1,1.4129,LESS
3,150,159,9,309,159,150,5.01063529409626,5.06890420222023,0.058268908123976,10.0795394963165,5.06890420222023,5.01063529409626,1,0,0,1.1991,2,0.6652,LESS
3,100,110,10,210,100,110,4.60517018598809,4.70048036579242,0.0953101798043248,9.30565055178051,4.60517018598809,4.70048036579242,0,0,1,0.9493,2,1.0191,LESS
3,106,100,6,206,100,106,4.66343909411207,4.60517018598809,0.0582689081239751,9.26860928010016,4.60517018598809,4.66343909411207,1,1,1,1.1554,1,1.0679,LESS
3,50,57,7,107,50,57,3.91202300542815,4.04305126783455,0.131028262406404,7.9550742732627,3.91202300542815,4.04305126783455,0,0,1,1.88,1,0.7163,LESS
3,112,100,12,212,100,112,4.71849887129509,4.60517018598809,0.113328685307002,9.32366905728319,4.60517018598809,4.71849887129509,1,1,1,1.0942,3,1.4017,LESS
3,84,100,16,184,84,100,4.43081679884331,4.60517018598809,0.174353387144778,9.03598698483141,4.43081679884331,4.60517018598809,0,0,1,1.0779,3,1.1474,LESS
3,88,100,12,188,88,100,4.47733681447821,4.60517018598809,0.127833371509885,9.0825070004663,4.47733681447821,4.60517018598809,0,0,1,1.3286,2,0.5496,LESS
3,129,150,21,279,129,150,4.85981240436167,5.01063529409626,0.150822889734584,9.87044769845793,4.85981240436167,5.01063529409626,0,0,1,1.314,2,1.101,LESS
3,50,43,7,93,50,43,3.91202300542815,3.76120011569356,0.150822889734584,7.67322312112171,3.91202300542815,3.76120011569356,0,1,0,1.8491,1,0.6494,LESS
3,80,100,20,180,80,100,4.38202663467388,4.60517018598809,0.223143551314211,8.98719682066197,4.38202663467388,4.60517018598809,0,0,1,1.35,2,0.7834,LESS
3,126,150,24,276,126,150,4.83628190695148,5.01063529409626,0.174353387144778,9.84691720104773,4.83628190695148,5.01063529409626,0,0,1,1.7447,1,0.7318,LESS
3,141,150,9,291,150,141,4.94875989037817,5.01063529409626,0.0618754037180871,9.95939518447442,5.01063529409626,4.94875989037817,1,0,0,2.1695,2,0.9028,LESS
3,100,114,14,214,100,114,4.60517018598809,4.7361984483945,0.131028262406404,9.34136863438259,4.60517018598809,4.7361984483945,0,0,1,1.2832,1,1.2352,LESS
3,141,150,9,291,141,150,4.94875989037817,5.01063529409626,0.0618754037180871,9.95939518447442,4.94875989037817,5.01063529409626,0,0,1,1.4084,1,0.7872,LESS
3,106,100,6,206,100,106,4.66343909411207,4.60517018598809,0.0582689081239751,9.26860928010016,4.60517018598809,4.66343909411207,1,1,1,1.2012,1,1.3665,LESS
3,132,150,18,282,150,132,4.88280192258637,5.01063529409626,0.127833371509885,9.89343721668263,5.01063529409626,4.88280192258637,1,0,0,1.5161,1,0.7838,LESS
3,54,50,4,104,54,50,3.98898404656427,3.91202300542815,0.0769610411361286,7.90100705199242,3.98898404656427,3.91202300542815,0,1,0,1.0619,2,1.0672,LESS
3,49,50,1,99,49,50,3.89182029811063,3.91202300542815,0.0202027073175195,7.80384330353877,3.89182029811063,3.91202300542815,0,0,1,1.1495,3,0.7334,LESS
3,120,100,20,220,100,120,4.78749174278205,4.60517018598809,0.182321556793954,9.39266192877014,4.60517018598809,4.78749174278205,1,1,1,1.1122,2,0.9699,LESS
3,150,156,6,306,156,150,5.01063529409626,5.04985600724954,0.0392207131532816,10.0604913013458,5.04985600724954,5.01063529409626,1,0,0,1.6904,1,1.0833,LESS
3,50,42,8,92,42,50,3.91202300542815,3.73766961828337,0.174353387144778,7.64969262371151,3.73766961828337,3.91202300542815,1,1,1,1.2129,3,1.3497,LESS
3,82,100,18,182,82,100,4.40671924726425,4.60517018598809,0.198450938723838,9.01188943325235,4.40671924726425,4.60517018598809,0,0,1,1.3326,2,0.9343,LESS
3,50,52,2,102,50,52,3.91202300542815,3.95124371858143,0.0392207131532816,7.86326672400957,3.91202300542815,3.95124371858143,0,0,1,1.2592,2,1.2166,LESS
3,150,120,30,270,120,150,5.01063529409626,4.78749174278205,0.22314355131421,9.7981270368783,4.78749174278205,5.01063529409626,1,1,1,1.6962,1,1.3661,LESS
3,100,94,6,194,100,94,4.60517018598809,4.54329478227,0.061875403718088,9.1484649682581,4.60517018598809,4.54329478227,0,1,0,1.4087,2,0.9663,LESS
3,162,150,12,312,150,162,5.08759633523238,5.01063529409626,0.0769610411361281,10.0982316293286,5.01063529409626,5.08759633523238,1,1,1,1.792,2,0.8199,LESS
3,100,102,2,202,100,102,4.60517018598809,4.62497281328427,0.0198026272961789,9.23014299927236,4.60517018598809,4.62497281328427,0,0,1,1.8504,1,0.9161,LESS
3,50,53,3,103,50,53,3.91202300542815,3.97029191355212,0.058268908123976,7.88231491898027,3.91202300542815,3.97029191355212,0,0,1,1.2978,2,1.1162,LESS
3,100,86,14,186,86,100,4.60517018598809,4.45434729625351,0.150822889734584,9.0595174822416,4.45434729625351,4.60517018598809,1,1,1,1.1647,3,0.6663,LESS
3,94,100,6,194,100,94,4.54329478227,4.60517018598809,0.061875403718088,9.1484649682581,4.60517018598809,4.54329478227,1,0,0,1.7122,3,0.5523,LESS
3,90,100,10,190,100,90,4.49980967033027,4.60517018598809,0.105360515657827,9.10497985631836,4.60517018598809,4.49980967033027,1,0,0,2.2944,1,0.4838,LESS
3,43,50,7,93,43,50,3.76120011569356,3.91202300542815,0.150822889734584,7.67322312112171,3.76120011569356,3.91202300542815,0,0,1,1.2659,2,0.8669,LESS
3,96,100,4,196,96,100,4.56434819146784,4.60517018598809,0.0408219945202557,9.16951837745593,4.56434819146784,4.60517018598809,0,0,1,1.6632,2,1.2335,LESS
3,58,50,8,108,50,58,4.06044301054642,3.91202300542815,0.148420005118273,7.97246601597456,3.91202300542815,4.06044301054642,1,1,1,1.1461,2,0.8843,LESS
3,53,50,3,103,50,53,3.97029191355212,3.91202300542815,0.058268908123976,7.88231491898027,3.91202300542815,3.97029191355212,1,1,1,1.6329,2,0.6828,LESS
3,171,150,21,321,150,171,5.14166355650266,5.01063529409626,0.131028262406405,10.1522988505989,5.01063529409626,5.14166355650266,1,1,1,1.6034,2,0.7492,LESS
3,108,100,8,208,100,108,4.68213122712422,4.60517018598809,0.0769610411361281,9.28730141311231,4.60517018598809,4.68213122712422,1,1,1,0.9709,1,0.6674,LESS
3,150,171,21,321,171,150,5.01063529409626,5.14166355650266,0.131028262406405,10.1522988505989,5.14166355650266,5.01063529409626,1,0,0,1.2599,1,0.6538,LESS
3,50,53,3,103,50,53,3.91202300542815,3.97029191355212,0.058268908123976,7.88231491898027,3.91202300542815,3.97029191355212,0,0,1,1.5445,1,0.7663,LESS
3,50,47,3,97,50,47,3.91202300542815,3.85014760171006,0.0618754037180875,7.7621706071382,3.91202300542815,3.85014760171006,0,1,0,1.4207,1,0.7158,LESS
3,50,46,4,96,50,46,3.91202300542815,3.8286413964891,0.0833816089390509,7.74066440191724,3.91202300542815,3.8286413964891,0,1,0,1.5891,2,1.0826,LESS
3,50,44,6,94,44,50,3.91202300542815,3.78418963391826,0.127833371509885,7.69621263934641,3.78418963391826,3.91202300542815,1,1,1,1.0511,2,0.7498,LESS
3,50,55,5,105,55,50,3.91202300542815,4.00733318523247,0.0953101798043252,7.91935619066062,4.00733318523247,3.91202300542815,1,0,0,1.1681,3,0.5665,LESS
3,174,150,24,324,150,174,5.15905529921453,5.01063529409626,0.148420005118274,10.1696905933108,5.01063529409626,5.15905529921453,1,1,1,1.3377,1,1.0663,LESS
3,138,150,12,288,138,150,4.92725368515721,5.01063529409626,0.0833816089390504,9.93788897925346,4.92725368515721,5.01063529409626,0,0,1,1.3971,2,0.5846,LESS
3,150,138,12,288,138,150,5.01063529409626,4.92725368515721,0.0833816089390504,9.93788897925346,4.92725368515721,5.01063529409626,1,1,1,1.2724,1,0.7688,LESS
3,100,104,4,204,104,100,4.60517018598809,4.64439089914137,0.0392207131532807,9.24956108512946,4.64439089914137,4.60517018598809,1,0,0,1.3674,2,1.367,LESS
3,50,46,4,96,50,46,3.91202300542815,3.8286413964891,0.0833816089390509,7.74066440191724,3.91202300542815,3.8286413964891,0,1,0,1.3829,2,0.9999,LESS
3,100,94,6,194,94,100,4.60517018598809,4.54329478227,0.061875403718088,9.1484649682581,4.54329478227,4.60517018598809,1,1,1,1.3373,1,1.1962,LESS
3,50,59,9,109,50,59,3.91202300542815,4.07753744390572,0.165514438477574,7.98956044933387,3.91202300542815,4.07753744390572,0,0,1,1.0412,2,1.0001,LESS
3,100,118,18,218,100,118,4.60517018598809,4.77068462446567,0.165514438477573,9.37585481045376,4.60517018598809,4.77068462446567,0,0,1,1.7045,1,1.3355,LESS
3,159,150,9,309,150,159,5.06890420222023,5.01063529409626,0.058268908123976,10.0795394963165,5.01063529409626,5.06890420222023,1,1,1,1.7829,1,0.901,LESS
3,59,50,9,109,59,50,4.07753744390572,3.91202300542815,0.165514438477574,7.98956044933387,4.07753744390572,3.91202300542815,0,1,0,1.8909,2,1.1329,LESS
3,110,100,10,210,100,110,4.70048036579242,4.60517018598809,0.0953101798043248,9.30565055178051,4.60517018598809,4.70048036579242,1,1,1,1.7096,1,1.2006,LESS
3,58,50,8,108,58,50,4.06044301054642,3.91202300542815,0.148420005118273,7.97246601597456,4.06044301054642,3.91202300542815,0,1,0,1.6105,1,0.8837,LESS
3,100,116,16,216,100,116,4.60517018598809,4.75359019110636,0.148420005118273,9.35876037709446,4.60517018598809,4.75359019110636,0,0,1,1.8585,1,0.6171,LESS
3,104,100,4,204,100,104,4.64439089914137,4.60517018598809,0.0392207131532807,9.24956108512946,4.60517018598809,4.64439089914137,1,1,1,1.3324,1,0.6997,LESS
3,50,47,3,97,50,47,3.91202300542815,3.85014760171006,0.0618754037180875,7.7621706071382,3.91202300542815,3.85014760171006,0,1,0,1.4963,1,0.9831,LESS
3,50,59,9,109,50,59,3.91202300542815,4.07753744390572,0.165514438477574,7.98956044933387,3.91202300542815,4.07753744390572,0,0,1,1.1659,3,0.983,LESS
3,177,150,27,327,150,177,5.17614973257383,5.01063529409626,0.165514438477573,10.1867850266701,5.01063529409626,5.17614973257383,1,1,1,1.0896,3,1.172,LESS
3,138,150,12,288,138,150,4.92725368515721,5.01063529409626,0.0833816089390504,9.93788897925346,4.92725368515721,5.01063529409626,0,0,1,2.1142,1,0.7333,LESS
3,159,150,9,309,159,150,5.06890420222023,5.01063529409626,0.058268908123976,10.0795394963165,5.06890420222023,5.01063529409626,0,1,0,1.2435,2,1.2832,LESS
3,52,50,2,102,52,50,3.95124371858143,3.91202300542815,0.0392207131532816,7.86326672400957,3.95124371858143,3.91202300542815,0,1,0,1.8908,1,0.9672,LESS
3,150,147,3,297,150,147,5.01063529409626,4.99043258677874,0.0202027073175195,10.001067880875,5.01063529409626,4.99043258677874,0,1,0,1.4398,2,1.0994,LESS
3,50,49,1,99,50,49,3.91202300542815,3.89182029811063,0.0202027073175195,7.80384330353877,3.91202300542815,3.89182029811063,0,1,0,1.6093,2,0.9697,LESS
3,57,50,7,107,50,57,4.04305126783455,3.91202300542815,0.131028262406404,7.9550742732627,3.91202300542815,4.04305126783455,1,1,1,1.0644,2,0.8336,LESS
3,150,126,24,276,126,150,5.01063529409626,4.83628190695148,0.174353387144778,9.84691720104773,4.83628190695148,5.01063529409626,1,1,1,1.1252,2,0.7374,LESS
3,55,50,5,105,50,55,4.00733318523247,3.91202300542815,0.0953101798043252,7.91935619066062,3.91202300542815,4.00733318523247,1,1,1,1.7253,3,1.9,LESS
3,126,150,24,276,150,126,4.83628190695148,5.01063529409626,0.174353387144778,9.84691720104773,5.01063529409626,4.83628190695148,1,0,0,2.4276,1,0.6998,LESS
3,144,150,6,294,150,144,4.969813299576,5.01063529409626,0.0408219945202548,9.98044859367226,5.01063529409626,4.969813299576,1,0,0,1.4853,1,1.7991,LESS
3,114,100,14,214,100,114,4.7361984483945,4.60517018598809,0.131028262406404,9.34136863438259,4.60517018598809,4.7361984483945,1,1,1,0.9659,2,0.9003,LESS
3,150,153,3,303,153,150,5.01063529409626,5.03043792139244,0.0198026272961798,10.0410732154887,5.03043792139244,5.01063529409626,1,0,0,2.6218,1,0.8171,LESS
3,100,82,18,182,82,100,4.60517018598809,4.40671924726425,0.198450938723838,9.01188943325235,4.40671924726425,4.60517018598809,1,1,1,1.022,3,1.1999,LESS
3,100,110,10,210,110,100,4.60517018598809,4.70048036579242,0.0953101798043248,9.30565055178051,4.70048036579242,4.60517018598809,1,0,0,1.02,1,1.0668,LESS
3,50,57,7,107,57,50,3.91202300542815,4.04305126783455,0.131028262406404,7.9550742732627,4.04305126783455,3.91202300542815,1,0,0,1.5982,3,0.9157,LESS
3,50,55,5,105,55,50,3.91202300542815,4.00733318523247,0.0953101798043252,7.91935619066062,4.00733318523247,3.91202300542815,1,0,0,1.1146,3,0.8695,LESS
3,150,123,27,273,123,150,5.01063529409626,4.81218435537242,0.198450938723838,9.82281964946867,4.81218435537242,5.01063529409626,1,1,1,0.8193,3,0.8662,LESS
3,50,51,1,101,50,51,3.91202300542815,3.93182563272433,0.0198026272961798,7.84384863815247,3.91202300542815,3.93182563272433,0,0,1,0.9772,2,0.9827,LESS
3,150,156,6,306,156,150,5.01063529409626,5.04985600724954,0.0392207131532816,10.0604913013458,5.04985600724954,5.01063529409626,1,0,0,1.1573,2,0.9538,LESS
3,48,50,2,98,48,50,3.87120101090789,3.91202300542815,0.0408219945202548,7.78322401633604,3.87120101090789,3.91202300542815,0,0,1,1.7257,1,0.8332,LESS
3,60,50,10,110,50,60,4.0943445622221,3.91202300542815,0.182321556793954,8.00636756765025,3.91202300542815,4.0943445622221,1,1,1,1.065,1,0.6684,LESS
3,116,100,16,216,100,116,4.75359019110636,4.60517018598809,0.148420005118273,9.35876037709446,4.60517018598809,4.75359019110636,1,1,1,0.8591,2,0.7828,LESS
3,50,52,2,102,50,52,3.91202300542815,3.95124371858143,0.0392207131532816,7.86326672400957,3.91202300542815,3.95124371858143,0,0,1,1.2121,2,0.9866,LESS
3,150,120,30,270,120,150,5.01063529409626,4.78749174278205,0.22314355131421,9.7981270368783,4.78749174278205,5.01063529409626,1,1,1,0.9657,2,1.1344,LESS
3,150,168,18,318,150,168,5.01063529409626,5.12396397940326,0.113328685307003,10.1345992734995,5.01063529409626,5.12396397940326,0,0,1,1.6522,1,0.4997,LESS
3,92,100,8,192,100,92,4.52178857704904,4.60517018598809,0.0833816089390513,9.12695876303713,4.60517018598809,4.52178857704904,1,0,0,1.5868,1,0.8998,LESS
3,150,153,3,303,153,150,5.01063529409626,5.03043792139244,0.0198026272961798,10.0410732154887,5.03043792139244,5.01063529409626,1,0,0,1.5995,1,0.8525,LESS
3,100,114,14,214,100,114,4.60517018598809,4.7361984483945,0.131028262406404,9.34136863438259,4.60517018598809,4.7361984483945,0,0,1,1.6895,2,0.8334,LESS
3,100,82,18,182,82,100,4.60517018598809,4.40671924726425,0.198450938723838,9.01188943325235,4.40671924726425,4.60517018598809,1,1,1,1.332,2,0.8823,LESS
3,100,88,12,188,88,100,4.60517018598809,4.47733681447821,0.127833371509885,9.0825070004663,4.47733681447821,4.60517018598809,1,1,1,1.4797,2,0.8695,LESS
3,104,100,4,204,100,104,4.64439089914137,4.60517018598809,0.0392207131532807,9.24956108512946,4.60517018598809,4.64439089914137,1,1,1,1.3962,2,0.5822,LESS
3,123,150,27,273,123,150,4.81218435537242,5.01063529409626,0.198450938723838,9.82281964946867,4.81218435537242,5.01063529409626,0,0,1,1.7251,1,0.4867,LESS
3,150,132,18,282,132,150,5.01063529409626,4.88280192258637,0.127833371509885,9.89343721668263,4.88280192258637,5.01063529409626,1,1,1,1.7363,1,0.6832,LESS
3,129,150,21,279,129,150,4.85981240436167,5.01063529409626,0.150822889734584,9.87044769845793,4.85981240436167,5.01063529409626,0,0,1,1.4389,1,0.7202,LESS
3,110,100,10,210,100,110,4.70048036579242,4.60517018598809,0.0953101798043248,9.30565055178051,4.60517018598809,4.70048036579242,1,1,1,1.1257,3,0.8188,LESS
3,50,51,1,101,50,51,3.91202300542815,3.93182563272433,0.0198026272961798,7.84384863815247,3.91202300542815,3.93182563272433,0,0,1,1.0981,3,1.3496,LESS
3,153,150,3,303,150,153,5.03043792139244,5.01063529409626,0.0198026272961798,10.0410732154887,5.01063529409626,5.03043792139244,1,1,1,0.7881,3,1.0506,LESS
3,45,50,5,95,50,45,3.80666248977032,3.91202300542815,0.105360515657826,7.71868549519847,3.91202300542815,3.80666248977032,1,0,0,1.5785,1,0.993,LESS
3,96,100,4,196,96,100,4.56434819146784,4.60517018598809,0.0408219945202557,9.16951837745593,4.56434819146784,4.60517018598809,0,0,1,1.8464,2,0.8462,LESS
3,144,150,6,294,144,150,4.969813299576,5.01063529409626,0.0408219945202548,9.98044859367226,4.969813299576,5.01063529409626,0,0,1,1.6042,1,0.527,LESS
3,100,90,10,190,90,100,4.60517018598809,4.49980967033027,0.105360515657827,9.10497985631836,4.49980967033027,4.60517018598809,1,1,1,1.2895,1,0.9493,LESS
3,98,100,2,198,100,98,4.58496747867057,4.60517018598809,0.0202027073175195,9.19013766465866,4.60517018598809,4.58496747867057,1,0,0,1.4768,1,0.6664,LESS
3,46,50,4,96,46,50,3.8286413964891,3.91202300542815,0.0833816089390509,7.74066440191724,3.8286413964891,3.91202300542815,0,0,1,1.7452,2,1.3162,LESS
3,47,50,3,97,47,50,3.85014760171006,3.91202300542815,0.0618754037180875,7.7621706071382,3.85014760171006,3.91202300542815,0,0,1,1.1203,1,0.9019,LESS
3,50,44,6,94,44,50,3.91202300542815,3.78418963391826,0.127833371509885,7.69621263934641,3.78418963391826,3.91202300542815,1,1,1,1.9069,2,0.7992,LESS
3,150,174,24,324,150,174,5.01063529409626,5.15905529921453,0.148420005118274,10.1696905933108,5.01063529409626,5.15905529921453,0,0,1,1.1845,2,0.7823,LESS
3,150,135,15,285,150,135,5.01063529409626,4.90527477843843,0.105360515657826,9.91591007253469,5.01063529409626,4.90527477843843,0,1,0,1.7017,1,0.8167,LESS
3,50,58,8,108,50,58,3.91202300542815,4.06044301054642,0.148420005118273,7.97246601597456,3.91202300542815,4.06044301054642,0,0,1,1.2416,3,1.2835,LESS
3,150,129,21,279,129,150,5.01063529409626,4.85981240436167,0.150822889734584,9.87044769845793,4.85981240436167,5.01063529409626,1,1,1,1.0612,2,1.0843,LESS
3,100,104,4,204,104,100,4.60517018598809,4.64439089914137,0.0392207131532807,9.24956108512946,4.64439089914137,4.60517018598809,1,0,0,1.5019,2,0.9017,LESS
3,50,60,10,110,50,60,3.91202300542815,4.0943445622221,0.182321556793954,8.00636756765025,3.91202300542815,4.0943445622221,0,0,1,1.2958,1,0.9164,LESS
3,44,50,6,94,44,50,3.78418963391826,3.91202300542815,0.127833371509885,7.69621263934641,3.78418963391826,3.91202300542815,0,0,1,1.1355,3,0.8166,LESS
3,46,50,4,96,46,50,3.8286413964891,3.91202300542815,0.0833816089390509,7.74066440191724,3.8286413964891,3.91202300542815,0,0,1,1.0056,3,0.8993,LESS
3,86,100,14,186,86,100,4.45434729625351,4.60517018598809,0.150822889734584,9.0595174822416,4.45434729625351,4.60517018598809,0,0,1,1.3339,3,0.767,LESS
3,50,40,10,90,40,50,3.91202300542815,3.68887945411394,0.22314355131421,7.60090245954208,3.68887945411394,3.91202300542815,1,1,1,0.9339,3,1.2341,LESS
3,150,138,12,288,150,138,5.01063529409626,4.92725368515721,0.0833816089390504,9.93788897925346,5.01063529409626,4.92725368515721,0,1,0,1.209,2,0.968,LESS
3,86,100,14,186,100,86,4.45434729625351,4.60517018598809,0.150822889734584,9.0595174822416,4.60517018598809,4.45434729625351,1,0,0,1.1298,1,0.5163,LESS
3,53,50,3,103,50,53,3.97029191355212,3.91202300542815,0.058268908123976,7.88231491898027,3.91202300542815,3.97029191355212,1,1,1,0.9419,2,0.95,LESS
3,150,171,21,321,150,171,5.01063529409626,5.14166355650266,0.131028262406405,10.1522988505989,5.01063529409626,5.14166355650266,0,0,1,1.0179,2,0.7008,LESS
3,165,150,15,315,150,165,5.10594547390058,5.01063529409626,0.0953101798043248,10.1165807679968,5.01063529409626,5.10594547390058,1,1,1,1.7111,1,1.166,LESS
3,174,150,24,324,150,174,5.15905529921453,5.01063529409626,0.148420005118274,10.1696905933108,5.01063529409626,5.15905529921453,1,1,1,1.0729,2,0.5846,LESS
3,147,150,3,297,150,147,4.99043258677874,5.01063529409626,0.0202027073175195,10.001067880875,5.01063529409626,4.99043258677874,1,0,0,1.8815,1,0.6502,LESS
3,150,144,6,294,144,150,5.01063529409626,4.969813299576,0.0408219945202548,9.98044859367226,4.969813299576,5.01063529409626,1,1,1,1.5122,2,0.7492,LESS
3,50,54,4,104,50,54,3.91202300542815,3.98898404656427,0.0769610411361286,7.90100705199242,3.91202300542815,3.98898404656427,0,0,1,1.5555,1,0.6162,LESS
3,47,50,3,97,47,50,3.85014760171006,3.91202300542815,0.0618754037180875,7.7621706071382,3.85014760171006,3.91202300542815,0,0,1,1.3016,2,1.0664,LESS
3,156,150,6,306,150,156,5.04985600724954,5.01063529409626,0.0392207131532816,10.0604913013458,5.01063529409626,5.04985600724954,1,1,1,1.4547,2,1.1008,LESS
3,100,98,2,198,98,100,4.60517018598809,4.58496747867057,0.0202027073175195,9.19013766465866,4.58496747867057,4.60517018598809,1,1,1,0.971,3,1.2662,LESS
3,150,126,24,276,126,150,5.01063529409626,4.83628190695148,0.174353387144778,9.84691720104773,4.83628190695148,5.01063529409626,1,1,1,0.886,2,2.087,LESS
3,42,50,8,92,42,50,3.73766961828337,3.91202300542815,0.174353387144778,7.64969262371151,3.73766961828337,3.91202300542815,0,0,1,1.1108,3,0.9497,LESS
3,150,141,9,291,141,150,5.01063529409626,4.94875989037817,0.0618754037180871,9.95939518447442,4.94875989037817,5.01063529409626,1,1,1,1.4238,1,1.2001,LESS
3,98,100,2,198,100,98,4.58496747867057,4.60517018598809,0.0202027073175195,9.19013766465866,4.60517018598809,4.58496747867057,1,0,0,1.6222,2,1.0159,LESS
3,100,84,16,184,84,100,4.60517018598809,4.43081679884331,0.174353387144778,9.03598698483141,4.43081679884331,4.60517018598809,1,1,1,1.2605,2,0.9829,LESS
3,50,56,6,106,50,56,3.91202300542815,4.02535169073515,0.113328685307004,7.9373746961633,3.91202300542815,4.02535169073515,0,0,1,1.7786,4,0.9328,LESS
3,150,180,30,330,180,150,5.01063529409626,5.19295685089021,0.182321556793955,10.2035921449865,5.19295685089021,5.01063529409626,1,0,0,2.1419,1,1.0511,LESS
3,100,92,8,192,92,100,4.60517018598809,4.52178857704904,0.0833816089390513,9.12695876303713,4.52178857704904,4.60517018598809,1,1,1,1.6657,1,0.7605,LESS
3,84,100,16,184,84,100,4.43081679884331,4.60517018598809,0.174353387144778,9.03598698483141,4.43081679884331,4.60517018598809,0,0,1,1.0459,1,0.9497,LESS
3,50,60,10,110,50,60,3.91202300542815,4.0943445622221,0.182321556793954,8.00636756765025,3.91202300542815,4.0943445622221,0,0,1,1.2638,3,1.0667,LESS
3,100,96,4,196,96,100,4.60517018598809,4.56434819146784,0.0408219945202557,9.16951837745593,4.56434819146784,4.60517018598809,1,1,1,1.03,3,1.3163,LESS
3,100,120,20,220,100,120,4.60517018598809,4.78749174278205,0.182321556793954,9.39266192877014,4.60517018598809,4.78749174278205,0,0,1,1.2705,2,0.7855,LESS
3,100,120,20,220,120,100,4.60517018598809,4.78749174278205,0.182321556793954,9.39266192877014,4.78749174278205,4.60517018598809,1,0,0,1.2449,1,0.6001,LESS
3,49,50,1,99,50,49,3.89182029811063,3.91202300542815,0.0202027073175195,7.80384330353877,3.91202300542815,3.89182029811063,1,0,0,1.4784,1,0.7831,LESS
3,80,100,20,180,100,80,4.38202663467388,4.60517018598809,0.223143551314211,8.98719682066197,4.60517018598809,4.38202663467388,1,0,0,1.9157,3,0.7496,LESS
3,50,41,9,91,50,41,3.91202300542815,3.71357206670431,0.198450938723838,7.62559507213245,3.91202300542815,3.71357206670431,0,1,0,1.518,2,0.8002,LESS
3,100,112,12,212,100,112,4.60517018598809,4.71849887129509,0.113328685307002,9.32366905728319,4.60517018598809,4.71849887129509,0,0,1,1.6425,1,0.9663,LESS
3,100,80,20,180,80,100,4.60517018598809,4.38202663467388,0.223143551314211,8.98719682066197,4.38202663467388,4.60517018598809,1,1,1,1.2788,3,0.6212,LESS
3,94,100,6,194,100,94,4.54329478227,4.60517018598809,0.061875403718088,9.1484649682581,4.60517018598809,4.54329478227,1,0,0,1.2283,1,1.1337,LESS
3,100,96,4,196,96,100,4.60517018598809,4.56434819146784,0.0408219945202557,9.16951837745593,4.56434819146784,4.60517018598809,1,1,1,1.8005,1,0.8866,LESS
3,82,100,18,182,100,82,4.40671924726425,4.60517018598809,0.198450938723838,9.01188943325235,4.60517018598809,4.40671924726425,1,0,0,1.5626,1,0.5851,LESS
3,100,116,16,216,100,116,4.60517018598809,4.75359019110636,0.148420005118273,9.35876037709446,4.60517018598809,4.75359019110636,0,0,1,1.0818,1,0.7175,LESS
3,168,150,18,318,150,168,5.12396397940326,5.01063529409626,0.113328685307003,10.1345992734995,5.01063529409626,5.12396397940326,1,1,1,1.1124,1,0.8495,LESS
3,50,43,7,93,50,43,3.91202300542815,3.76120011569356,0.150822889734584,7.67322312112171,3.91202300542815,3.76120011569356,0,1,0,1.5429,1,1.0165,LESS
3,50,41,9,91,41,50,3.91202300542815,3.71357206670431,0.198450938723838,7.62559507213245,3.71357206670431,3.91202300542815,1,1,1,0.7897,2,1.2678,LESS
3,162,150,12,312,150,162,5.08759633523238,5.01063529409626,0.0769610411361281,10.0982316293286,5.01063529409626,5.08759633523238,1,1,1,1.6434,1,0.7834,LESS
3,50,49,1,99,49,50,3.91202300542815,3.89182029811063,0.0202027073175195,7.80384330353877,3.89182029811063,3.91202300542815,1,1,1,1.7736,2,1.0159,LESS
3,180,150,30,330,150,180,5.19295685089021,5.01063529409626,0.182321556793955,10.2035921449865,5.01063529409626,5.19295685089021,1,1,1,1.0996,2,1.5176,LESS
3,120,150,30,270,150,120,4.78749174278205,5.01063529409626,0.22314355131421,9.7981270368783,5.01063529409626,4.78749174278205,1,0,0,1.3059,1,0.5499,LESS
4,100,108,8,208,100,108,4.60517018598809,4.68213122712422,0.0769610411361281,9.28730141311231,4.60517018598809,4.68213122712422,0,0,1,0.762,4,1.458,LESS
4,177,150,27,327,177,150,5.17614973257383,5.01063529409626,0.165514438477573,10.1867850266701,5.17614973257383,5.01063529409626,0,1,0,1.258,3,1.885,LESS
4,126,150,24,276,126,150,4.83628190695148,5.01063529409626,0.174353387144778,9.84691720104773,4.83628190695148,5.01063529409626,0,0,1,1.112,3,1.785,LESS
4,90,100,10,190,90,100,4.49980967033027,4.60517018598809,0.105360515657827,9.10497985631836,4.49980967033027,4.60517018598809,0,0,1,1.476,4,1.101,LESS
4,100,94,6,194,100,94,4.60517018598809,4.54329478227,0.061875403718088,9.1484649682581,4.60517018598809,4.54329478227,0,1,0,0.747,2,1.136,LESS
4,50,40,10,90,40,50,3.91202300542815,3.68887945411394,0.22314355131421,7.60090245954208,3.68887945411394,3.91202300542815,1,1,1,1.61,3,1.078,LESS
4,51,50,1,101,51,50,3.93182563272433,3.91202300542815,0.0198026272961798,7.84384863815247,3.93182563272433,3.91202300542815,0,1,0,1.343,4,0.72,LESS
4,150,168,18,318,150,168,5.01063529409626,5.12396397940326,0.113328685307003,10.1345992734995,5.01063529409626,5.12396397940326,0,0,1,1.88,1,0.843,LESS
4,180,150,30,330,150,180,5.19295685089021,5.01063529409626,0.182321556793955,10.2035921449865,5.01063529409626,5.19295685089021,1,1,1,1.637,1,1.312,LESS
4,100,118,18,218,100,118,4.60517018598809,4.77068462446567,0.165514438477573,9.37585481045376,4.60517018598809,4.77068462446567,0,0,1,2.359,3,1.45,LESS
4,100,86,14,186,100,86,4.60517018598809,4.45434729625351,0.150822889734584,9.0595174822416,4.60517018598809,4.45434729625351,0,1,0,1.353,3,1.332,LESS
4,100,92,8,192,100,92,4.60517018598809,4.52178857704904,0.0833816089390513,9.12695876303713,4.60517018598809,4.52178857704904,0,1,0,1.442,3,1.001,LESS
4,104,100,4,204,104,100,4.64439089914137,4.60517018598809,0.0392207131532807,9.24956108512946,4.64439089914137,4.60517018598809,0,1,0,1.348,3,1.3,LESS
4,50,58,8,108,50,58,3.91202300542815,4.06044301054642,0.148420005118273,7.97246601597456,3.91202300542815,4.06044301054642,0,0,1,1.221,4,0.866,LESS
4,116,100,16,216,116,100,4.75359019110636,4.60517018598809,0.148420005118273,9.35876037709446,4.75359019110636,4.60517018598809,0,1,0,1.402,3,1.32,LESS
4,168,150,18,318,168,150,5.12396397940326,5.01063529409626,0.113328685307003,10.1345992734995,5.12396397940326,5.01063529409626,0,1,0,1.525,1,0.911,LESS
4,50,57,7,107,50,57,3.91202300542815,4.04305126783455,0.131028262406404,7.9550742732627,3.91202300542815,4.04305126783455,0,0,1,1.75,3,2.167,LESS
4,42,50,8,92,42,50,3.73766961828337,3.91202300542815,0.174353387144778,7.64969262371151,3.73766961828337,3.91202300542815,0,0,1,1.251,3,1.267,LESS
4,144,150,6,294,144,150,4.969813299576,5.01063529409626,0.0408219945202548,9.98044859367226,4.969813299576,5.01063529409626,0,0,1,1.044,2,2.099,LESS
4,40,50,10,90,40,50,3.68887945411394,3.91202300542815,0.22314355131421,7.60090245954208,3.68887945411394,3.91202300542815,0,0,1,1.309,4,1.211,LESS
4,50,51,1,101,50,51,3.91202300542815,3.93182563272433,0.0198026272961798,7.84384863815247,3.91202300542815,3.93182563272433,0,0,1,1.605,1,0.916,LESS
4,45,50,5,95,45,50,3.80666248977032,3.91202300542815,0.105360515657826,7.71868549519847,3.80666248977032,3.91202300542815,0,0,1,1.23,3,0.859,LESS
4,51,50,1,101,51,50,3.93182563272433,3.91202300542815,0.0198026272961798,7.84384863815247,3.93182563272433,3.91202300542815,0,1,0,1.57,3,1.059,LESS
4,40,50,10,90,40,50,3.68887945411394,3.91202300542815,0.22314355131421,7.60090245954208,3.68887945411394,3.91202300542815,0,0,1,1.096,4,0.984,LESS
4,100,110,10,210,100,110,4.60517018598809,4.70048036579242,0.0953101798043248,9.30565055178051,4.60517018598809,4.70048036579242,0,0,1,1.155,3,0.972,LESS
4,120,150,30,270,120,150,4.78749174278205,5.01063529409626,0.22314355131421,9.7981270368783,4.78749174278205,5.01063529409626,0,0,1,1.068,2,1.134,LESS
4,118,100,18,218,118,100,4.77068462446567,4.60517018598809,0.165514438477573,9.37585481045376,4.77068462446567,4.60517018598809,0,1,0,2.317,1,0.788,LESS
4,50,54,4,104,50,54,3.91202300542815,3.98898404656427,0.0769610411361286,7.90100705199242,3.91202300542815,3.98898404656427,0,0,1,1.953,4,1.423,LESS
4,100,104,4,204,100,104,4.60517018598809,4.64439089914137,0.0392207131532807,9.24956108512946,4.60517018598809,4.64439089914137,0,0,1,1.296,3,0.918,LESS
4,54,50,4,104,54,50,3.98898404656427,3.91202300542815,0.0769610411361286,7.90100705199242,3.98898404656427,3.91202300542815,0,1,0,1.258,3,1.318,LESS
4,86,100,14,186,86,100,4.45434729625351,4.60517018598809,0.150822889734584,9.0595174822416,4.45434729625351,4.60517018598809,0,0,1,1.142,2,1.118,LESS
4,50,54,4,104,50,54,3.91202300542815,3.98898404656427,0.0769610411361286,7.90100705199242,3.91202300542815,3.98898404656427,0,0,1,1.052,3,0.84,LESS
4,54,50,4,104,54,50,3.98898404656427,3.91202300542815,0.0769610411361286,7.90100705199242,3.98898404656427,3.91202300542815,0,1,0,1.209,3,1.121,LESS
4,50,49,1,99,50,49,3.91202300542815,3.89182029811063,0.0202027073175195,7.80384330353877,3.91202300542815,3.89182029811063,0,1,0,1.08,3,1.382,LESS
4,150,159,9,309,150,159,5.01063529409626,5.06890420222023,0.058268908123976,10.0795394963165,5.01063529409626,5.06890420222023,0,0,1,1.284,1,1.18,LESS
4,162,150,12,312,162,150,5.08759633523238,5.01063529409626,0.0769610411361281,10.0982316293286,5.08759633523238,5.01063529409626,0,1,0,2.091,1,0.717,LESS
4,100,116,16,216,116,100,4.60517018598809,4.75359019110636,0.148420005118273,9.35876037709446,4.75359019110636,4.60517018598809,1,0,0,2.947,1,1.652,LESS
4,57,50,7,107,57,50,4.04305126783455,3.91202300542815,0.131028262406404,7.9550742732627,4.04305126783455,3.91202300542815,0,1,0,1.346,2,1.169,LESS
4,150,153,3,303,150,153,5.01063529409626,5.03043792139244,0.0198026272961798,10.0410732154887,5.01063529409626,5.03043792139244,0,0,1,3.313,1,1.4,LESS
4,150,156,6,306,150,156,5.01063529409626,5.04985600724954,0.0392207131532816,10.0604913013458,5.01063529409626,5.04985600724954,0,0,1,1.476,1,0.857,LESS
4,129,150,21,279,129,150,4.85981240436167,5.01063529409626,0.150822889734584,9.87044769845793,4.85981240436167,5.01063529409626,0,0,1,1.523,2,1.372,LESS
4,165,150,15,315,150,165,5.10594547390058,5.01063529409626,0.0953101798043248,10.1165807679968,5.01063529409626,5.10594547390058,1,1,1,1.163,3,1.426,LESS
4,45,50,5,95,45,50,3.80666248977032,3.91202300542815,0.105360515657826,7.71868549519847,3.80666248977032,3.91202300542815,0,0,1,1.246,3,1.583,LESS
4,100,118,18,218,100,118,4.60517018598809,4.77068462446567,0.165514438477573,9.37585481045376,4.60517018598809,4.77068462446567,0,0,1,1.34,3,0.706,LESS
4,132,150,18,282,132,150,4.88280192258637,5.01063529409626,0.127833371509885,9.89343721668263,4.88280192258637,5.01063529409626,0,0,1,1.532,2,1.486,LESS
4,100,102,2,202,100,102,4.60517018598809,4.62497281328427,0.0198026272961789,9.23014299927236,4.60517018598809,4.62497281328427,0,0,1,1.87,1,1.013,LESS
4,150,123,27,273,123,150,5.01063529409626,4.81218435537242,0.198450938723838,9.82281964946867,4.81218435537242,5.01063529409626,1,1,1,1.278,1,2.284,LESS
4,50,48,2,98,50,48,3.91202300542815,3.87120101090789,0.0408219945202548,7.78322401633604,3.91202300542815,3.87120101090789,0,1,0,1.331,4,0.896,LESS
4,44,50,6,94,44,50,3.78418963391826,3.91202300542815,0.127833371509885,7.69621263934641,3.78418963391826,3.91202300542815,0,0,1,1.92,4,0.703,LESS
4,59,50,9,109,59,50,4.07753744390572,3.91202300542815,0.165514438477574,7.98956044933387,4.07753744390572,3.91202300542815,0,1,0,1.868,4,0.858,LESS
4,177,150,27,327,150,177,5.17614973257383,5.01063529409626,0.165514438477573,10.1867850266701,5.01063529409626,5.17614973257383,1,1,1,1.724,1,1.715,LESS
4,100,110,10,210,100,110,4.60517018598809,4.70048036579242,0.0953101798043248,9.30565055178051,4.60517018598809,4.70048036579242,0,0,1,1.875,1,1.67,LESS
4,53,50,3,103,53,50,3.97029191355212,3.91202300542815,0.058268908123976,7.88231491898027,3.97029191355212,3.91202300542815,0,1,0,1.851,4,1.016,LESS
4,100,96,4,196,100,96,4.60517018598809,4.56434819146784,0.0408219945202557,9.16951837745593,4.60517018598809,4.56434819146784,0,1,0,1.119,3,0.892,LESS
4,159,150,9,309,150,159,5.06890420222023,5.01063529409626,0.058268908123976,10.0795394963165,5.01063529409626,5.06890420222023,1,1,1,1.324,2,2.241,LESS
4,50,41,9,91,50,41,3.91202300542815,3.71357206670431,0.198450938723838,7.62559507213245,3.91202300542815,3.71357206670431,0,1,0,1.362,4,1.787,LESS
4,92,100,8,192,92,100,4.52178857704904,4.60517018598809,0.0833816089390513,9.12695876303713,4.52178857704904,4.60517018598809,0,0,1,1.462,2,0.918,LESS
4,174,150,24,324,174,150,5.15905529921453,5.01063529409626,0.148420005118274,10.1696905933108,5.15905529921453,5.01063529409626,0,1,0,5.115,1,0.971,LESS
4,135,150,15,285,135,150,4.90527477843843,5.01063529409626,0.105360515657826,9.91591007253469,4.90527477843843,5.01063529409626,0,0,1,2.929,1,0.847,LESS
4,41,50,9,91,41,50,3.71357206670431,3.91202300542815,0.198450938723838,7.62559507213245,3.71357206670431,3.91202300542815,0,0,1,1.553,4,0.862,LESS
4,153,150,3,303,153,150,5.03043792139244,5.01063529409626,0.0198026272961798,10.0410732154887,5.03043792139244,5.01063529409626,0,1,0,1.111,2,1,LESS
4,50,56,6,106,50,56,3.91202300542815,4.02535169073515,0.113328685307004,7.9373746961633,3.91202300542815,4.02535169073515,0,0,1,1.174,3,0.971,LESS
4,100,88,12,188,100,88,4.60517018598809,4.47733681447821,0.127833371509885,9.0825070004663,4.60517018598809,4.47733681447821,0,1,0,1.32,3,1.038,LESS
4,98,100,2,198,100,98,4.58496747867057,4.60517018598809,0.0202027073175195,9.19013766465866,4.60517018598809,4.58496747867057,1,0,0,1.999,1,2.245,LESS
4,135,150,15,285,135,150,4.90527477843843,5.01063529409626,0.105360515657826,9.91591007253469,4.90527477843843,5.01063529409626,0,0,1,1.858,1,0.49,LESS
4,110,100,10,210,100,110,4.70048036579242,4.60517018598809,0.0953101798043248,9.30565055178051,4.60517018598809,4.70048036579242,1,1,1,2.031,1,0.962,LESS
4,150,171,21,321,150,171,5.01063529409626,5.14166355650266,0.131028262406405,10.1522988505989,5.01063529409626,5.14166355650266,0,0,1,2.326,2,0.517,LESS
4,55,50,5,105,50,55,4.00733318523247,3.91202300542815,0.0953101798043252,7.91935619066062,3.91202300542815,4.00733318523247,1,1,1,1.529,3,1.866,LESS
4,138,150,12,288,138,150,4.92725368515721,5.01063529409626,0.0833816089390504,9.93788897925346,4.92725368515721,5.01063529409626,0,0,1,1.549,2,2.107,LESS
4,96,100,4,196,96,100,4.56434819146784,4.60517018598809,0.0408219945202557,9.16951837745593,4.56434819146784,4.60517018598809,0,0,1,1.376,2,0.978,LESS
4,114,100,14,214,114,100,4.7361984483945,4.60517018598809,0.131028262406404,9.34136863438259,4.7361984483945,4.60517018598809,0,1,0,1.367,2,0.918,LESS
4,150,174,24,324,150,174,5.01063529409626,5.15905529921453,0.148420005118274,10.1696905933108,5.01063529409626,5.15905529921453,0,0,1,1.113,3,0.963,LESS
4,150,120,30,270,150,120,5.01063529409626,4.78749174278205,0.22314355131421,9.7981270368783,5.01063529409626,4.78749174278205,0,1,0,2.294,1,1.9,LESS
4,150,132,18,282,132,150,5.01063529409626,4.88280192258637,0.127833371509885,9.89343721668263,4.88280192258637,5.01063529409626,1,1,1,2.139,1,1.284,LESS
4,150,162,12,312,150,162,5.01063529409626,5.08759633523238,0.0769610411361281,10.0982316293286,5.01063529409626,5.08759633523238,0,0,1,1.192,1,1.069,LESS
4,150,135,15,285,150,135,5.01063529409626,4.90527477843843,0.105360515657826,9.91591007253469,5.01063529409626,4.90527477843843,0,1,0,1.005,1,1.135,LESS
4,52,50,2,102,52,50,3.95124371858143,3.91202300542815,0.0392207131532816,7.86326672400957,3.95124371858143,3.91202300542815,0,1,0,1.709,4,0.919,LESS
4,82,100,18,182,82,100,4.40671924726425,4.60517018598809,0.198450938723838,9.01188943325235,4.40671924726425,4.60517018598809,0,0,1,1.103,4,0.657,LESS
4,150,165,15,315,150,165,5.01063529409626,5.10594547390058,0.0953101798043248,10.1165807679968,5.01063529409626,5.10594547390058,0,0,1,2.312,2,1.083,LESS
4,100,80,20,180,80,100,4.60517018598809,4.38202663467388,0.223143551314211,8.98719682066197,4.38202663467388,4.60517018598809,1,1,1,2.18,1,1.178,LESS
4,42,50,8,92,42,50,3.73766961828337,3.91202300542815,0.174353387144778,7.64969262371151,3.73766961828337,3.91202300542815,0,0,1,0.865,4,1.475,LESS
4,174,150,24,324,150,174,5.15905529921453,5.01063529409626,0.148420005118274,10.1696905933108,5.01063529409626,5.15905529921453,1,1,1,1.988,1,1.099,LESS
4,159,150,9,309,150,159,5.06890420222023,5.01063529409626,0.058268908123976,10.0795394963165,5.01063529409626,5.06890420222023,1,1,1,2.102,1,0.875,LESS
4,150,138,12,288,150,138,5.01063529409626,4.92725368515721,0.0833816089390504,9.93788897925346,5.01063529409626,4.92725368515721,0,1,0,2.707,1,0.992,LESS
4,50,41,9,91,50,41,3.91202300542815,3.71357206670431,0.198450938723838,7.62559507213245,3.91202300542815,3.71357206670431,0,1,0,1.941,3,1.332,LESS
4,144,150,6,294,144,150,4.969813299576,5.01063529409626,0.0408219945202548,9.98044859367226,4.969813299576,5.01063529409626,0,0,1,1.295,2,0.884,LESS
4,100,82,18,182,100,82,4.60517018598809,4.40671924726425,0.198450938723838,9.01188943325235,4.60517018598809,4.40671924726425,0,1,0,3.421,1,0.869,LESS
4,50,43,7,93,50,43,3.91202300542815,3.76120011569356,0.150822889734584,7.67322312112171,3.91202300542815,3.76120011569356,0,1,0,1.456,3,1.567,LESS
4,150,126,24,276,150,126,5.01063529409626,4.83628190695148,0.174353387144778,9.84691720104773,5.01063529409626,4.83628190695148,0,1,0,1.554,2,1.241,LESS
4,116,100,16,216,116,100,4.75359019110636,4.60517018598809,0.148420005118273,9.35876037709446,4.75359019110636,4.60517018598809,0,1,0,1.265,2,0.781,LESS
4,100,96,4,196,100,96,4.60517018598809,4.56434819146784,0.0408219945202557,9.16951837745593,4.60517018598809,4.56434819146784,0,1,0,1.14,3,0.879,LESS
4,80,100,20,180,80,100,4.38202663467388,4.60517018598809,0.223143551314211,8.98719682066197,4.38202663467388,4.60517018598809,0,0,1,1.021,3,1.29,LESS
4,50,46,4,96,50,46,3.91202300542815,3.8286413964891,0.0833816089390509,7.74066440191724,3.91202300542815,3.8286413964891,0,1,0,1.034,4,0.868,LESS
4,58,50,8,108,58,50,4.06044301054642,3.91202300542815,0.148420005118273,7.97246601597456,4.06044301054642,3.91202300542815,0,1,0,1.137,4,0.741,LESS
4,100,106,6,206,100,106,4.60517018598809,4.66343909411207,0.0582689081239751,9.26860928010016,4.60517018598809,4.66343909411207,0,0,1,0.981,3,0.751,LESS
4,50,58,8,108,50,58,3.91202300542815,4.06044301054642,0.148420005118273,7.97246601597456,3.91202300542815,4.06044301054642,0,0,1,1.371,3,0.866,LESS
4,171,150,21,321,150,171,5.14166355650266,5.01063529409626,0.131028262406405,10.1522988505989,5.01063529409626,5.14166355650266,1,1,1,1.996,2,1.349,LESS
4,100,112,12,212,100,112,4.60517018598809,4.71849887129509,0.113328685307002,9.32366905728319,4.60517018598809,4.71849887129509,0,0,1,2.046,1,1.197,LESS
4,114,100,14,214,100,114,4.7361984483945,4.60517018598809,0.131028262406404,9.34136863438259,4.60517018598809,4.7361984483945,1,1,1,1.754,1,1.882,LESS
4,94,100,6,194,94,100,4.54329478227,4.60517018598809,0.061875403718088,9.1484649682581,4.54329478227,4.60517018598809,0,0,1,1.714,1,1.151,LESS
4,46,50,4,96,46,50,3.8286413964891,3.91202300542815,0.0833816089390509,7.74066440191724,3.8286413964891,3.91202300542815,0,0,1,1.195,4,0.997,LESS
4,150,180,30,330,150,180,5.01063529409626,5.19295685089021,0.182321556793955,10.2035921449865,5.01063529409626,5.19295685089021,0,0,1,1.086,4,0.706,LESS
4,100,116,16,216,100,116,4.60517018598809,4.75359019110636,0.148420005118273,9.35876037709446,4.60517018598809,4.75359019110636,0,0,1,2.22,2,1.701,LESS
4,48,50,2,98,48,50,3.87120101090789,3.91202300542815,0.0408219945202548,7.78322401633604,3.87120101090789,3.91202300542815,0,0,1,1.15,4,0.805,LESS
4,84,100,16,184,84,100,4.43081679884331,4.60517018598809,0.174353387144778,9.03598698483141,4.43081679884331,4.60517018598809,0,0,1,1.225,3,0.735,LESS
4,126,150,24,276,126,150,4.83628190695148,5.01063529409626,0.174353387144778,9.84691720104773,4.83628190695148,5.01063529409626,0,0,1,1.171,2,0.833,LESS
4,52,50,2,102,52,50,3.95124371858143,3.91202300542815,0.0392207131532816,7.86326672400957,3.95124371858143,3.91202300542815,0,1,0,1.131,4,0.785,LESS
4,100,120,20,220,100,120,4.60517018598809,4.78749174278205,0.182321556793954,9.39266192877014,4.60517018598809,4.78749174278205,0,0,1,1.525,1,2.163,LESS
4,120,100,20,220,120,100,4.78749174278205,4.60517018598809,0.182321556793954,9.39266192877014,4.78749174278205,4.60517018598809,0,1,0,1.711,1,0.784,LESS
4,100,86,14,186,86,100,4.60517018598809,4.45434729625351,0.150822889734584,9.0595174822416,4.45434729625351,4.60517018598809,1,1,1,4.75,1,0.35,LESS
4,153,150,3,303,153,150,5.03043792139244,5.01063529409626,0.0198026272961798,10.0410732154887,5.03043792139244,5.01063529409626,0,1,0,1.675,1,0.501,LESS
4,50,59,9,109,50,59,3.91202300542815,4.07753744390572,0.165514438477574,7.98956044933387,3.91202300542815,4.07753744390572,0,0,1,1.225,3,0.869,LESS
4,171,150,21,321,171,150,5.14166355650266,5.01063529409626,0.131028262406405,10.1522988505989,5.14166355650266,5.01063529409626,0,1,0,4.421,1,0.873,LESS
4,150,180,30,330,150,180,5.01063529409626,5.19295685089021,0.182321556793955,10.2035921449865,5.01063529409626,5.19295685089021,0,0,1,1.433,2,0.931,LESS
4,100,120,20,220,100,120,4.60517018598809,4.78749174278205,0.182321556793954,9.39266192877014,4.60517018598809,4.78749174278205,0,0,1,1.096,3,0.939,LESS
4,50,57,7,107,50,57,3.91202300542815,4.04305126783455,0.131028262406404,7.9550742732627,3.91202300542815,4.04305126783455,0,0,1,1.102,3,0.615,LESS
4,53,50,3,103,53,50,3.97029191355212,3.91202300542815,0.058268908123976,7.88231491898027,3.97029191355212,3.91202300542815,0,1,0,1.265,3,1.187,LESS
4,100,102,2,202,100,102,4.60517018598809,4.62497281328427,0.0198026272961789,9.23014299927236,4.60517018598809,4.62497281328427,0,0,1,4.045,1,1.455,LESS
4,48,50,2,98,48,50,3.87120101090789,3.91202300542815,0.0408219945202548,7.78322401633604,3.87120101090789,3.91202300542815,0,0,1,1.149,4,0.691,LESS
4,59,50,9,109,59,50,4.07753744390572,3.91202300542815,0.165514438477574,7.98956044933387,4.07753744390572,3.91202300542815,0,1,0,1.663,2,2.184,LESS
4,100,90,10,190,100,90,4.60517018598809,4.49980967033027,0.105360515657827,9.10497985631836,4.60517018598809,4.49980967033027,0,1,0,1.164,2,4.093,LESS
4,43,50,7,93,43,50,3.76120011569356,3.91202300542815,0.150822889734584,7.67322312112171,3.76120011569356,3.91202300542815,0,0,1,1.098,4,0.913,LESS
4,112,100,12,212,100,112,4.71849887129509,4.60517018598809,0.113328685307002,9.32366905728319,4.60517018598809,4.71849887129509,1,1,1,1.346,1,1.688,LESS
4,100,94,6,194,94,100,4.60517018598809,4.54329478227,0.061875403718088,9.1484649682581,4.54329478227,4.60517018598809,1,1,1,2.231,1,0.735,LESS
4,82,100,18,182,82,100,4.40671924726425,4.60517018598809,0.198450938723838,9.01188943325235,4.40671924726425,4.60517018598809,0,0,1,1.531,2,0.967,LESS
4,129,150,21,279,129,150,4.85981240436167,5.01063529409626,0.150822889734584,9.87044769845793,4.85981240436167,5.01063529409626,0,0,1,1.588,1,1.229,LESS
4,150,144,6,294,150,144,5.01063529409626,4.969813299576,0.0408219945202548,9.98044859367226,5.01063529409626,4.969813299576,0,1,0,2.769,1,0.756,LESS
4,50,43,7,93,50,43,3.91202300542815,3.76120011569356,0.150822889734584,7.67322312112171,3.91202300542815,3.76120011569356,0,1,0,1.658,3,1.414,LESS
4,84,100,16,184,84,100,4.43081679884331,4.60517018598809,0.174353387144778,9.03598698483141,4.43081679884331,4.60517018598809,0,0,1,1.104,3,0.915,LESS
4,50,49,1,99,50,49,3.91202300542815,3.89182029811063,0.0202027073175195,7.80384330353877,3.91202300542815,3.89182029811063,0,1,0,1.167,4,0.666,LESS
4,100,104,4,204,100,104,4.60517018598809,4.64439089914137,0.0392207131532807,9.24956108512946,4.60517018598809,4.64439089914137,0,0,1,1.293,1,1.114,LESS
4,150,129,21,279,129,150,5.01063529409626,4.85981240436167,0.150822889734584,9.87044769845793,4.85981240436167,5.01063529409626,1,1,1,1.366,2,1.001,LESS
4,50,55,5,105,50,55,3.91202300542815,4.00733318523247,0.0953101798043252,7.91935619066062,3.91202300542815,4.00733318523247,0,0,1,1.496,3,0.921,LESS
4,100,106,6,206,100,106,4.60517018598809,4.66343909411207,0.0582689081239751,9.26860928010016,4.60517018598809,4.66343909411207,0,0,1,2.44,1,1.207,LESS
4,108,100,8,208,100,108,4.68213122712422,4.60517018598809,0.0769610411361281,9.28730141311231,4.60517018598809,4.68213122712422,1,1,1,1.319,2,1.36,LESS
4,141,150,9,291,150,141,4.94875989037817,5.01063529409626,0.0618754037180871,9.95939518447442,5.01063529409626,4.94875989037817,1,0,0,2.87,1,0.828,LESS
4,150,165,15,315,150,165,5.01063529409626,5.10594547390058,0.0953101798043248,10.1165807679968,5.01063529409626,5.10594547390058,0,0,1,1.9,1,0.891,LESS
4,150,159,9,309,150,159,5.01063529409626,5.06890420222023,0.058268908123976,10.0795394963165,5.01063529409626,5.06890420222023,0,0,1,2.292,1,0.576,LESS
4,50,45,5,95,50,45,3.91202300542815,3.80666248977032,0.105360515657826,7.71868549519847,3.91202300542815,3.80666248977032,0,1,0,1.361,4,1.056,LESS
4,50,46,4,96,50,46,3.91202300542815,3.8286413964891,0.0833816089390509,7.74066440191724,3.91202300542815,3.8286413964891,0,1,0,1.638,4,1.063,LESS
4,168,150,18,318,150,168,5.12396397940326,5.01063529409626,0.113328685307003,10.1345992734995,5.01063529409626,5.12396397940326,1,1,1,2.278,1,0.751,LESS
4,104,100,4,204,104,100,4.64439089914137,4.60517018598809,0.0392207131532807,9.24956108512946,4.64439089914137,4.60517018598809,0,1,0,1.535,2,0.899,LESS
4,150,162,12,312,150,162,5.01063529409626,5.08759633523238,0.0769610411361281,10.0982316293286,5.01063529409626,5.08759633523238,0,0,1,1.238,2,0.58,LESS
4,44,50,6,94,44,50,3.78418963391826,3.91202300542815,0.127833371509885,7.69621263934641,3.78418963391826,3.91202300542815,0,0,1,1.199,4,0.901,LESS
4,100,112,12,212,100,112,4.60517018598809,4.71849887129509,0.113328685307002,9.32366905728319,4.60517018598809,4.71849887129509,0,0,1,1.625,1,0.932,LESS
4,50,60,10,110,50,60,3.91202300542815,4.0943445622221,0.182321556793954,8.00636756765025,3.91202300542815,4.0943445622221,0,0,1,1.065,4,0.731,LESS
4,102,100,2,202,100,102,4.62497281328427,4.60517018598809,0.0198026272961789,9.23014299927236,4.60517018598809,4.62497281328427,1,1,1,1.418,2,1.766,LESS
4,120,100,20,220,100,120,4.78749174278205,4.60517018598809,0.182321556793954,9.39266192877014,4.60517018598809,4.78749174278205,1,1,1,2.2,1,0.878,LESS
4,180,150,30,330,150,180,5.19295685089021,5.01063529409626,0.182321556793955,10.2035921449865,5.01063529409626,5.19295685089021,1,1,1,1.409,1,0.801,LESS
4,112,100,12,212,100,112,4.71849887129509,4.60517018598809,0.113328685307002,9.32366905728319,4.60517018598809,4.71849887129509,1,1,1,2.137,1,0.502,LESS
4,50,47,3,97,47,50,3.91202300542815,3.85014760171006,0.0618754037180875,7.7621706071382,3.85014760171006,3.91202300542815,1,1,1,1.53,2,0.767,LESS
4,50,47,3,97,50,47,3.91202300542815,3.85014760171006,0.0618754037180875,7.7621706071382,3.91202300542815,3.85014760171006,0,1,0,1.213,3,2.182,LESS
4,141,150,9,291,141,150,4.94875989037817,5.01063529409626,0.0618754037180871,9.95939518447442,4.94875989037817,5.01063529409626,0,0,1,1.534,2,1.517,LESS
4,90,100,10,190,90,100,4.49980967033027,4.60517018598809,0.105360515657827,9.10497985631836,4.49980967033027,4.60517018598809,0,0,1,2.319,1,0.756,LESS
4,156,150,6,306,150,156,5.04985600724954,5.01063529409626,0.0392207131532816,10.0604913013458,5.01063529409626,5.04985600724954,1,1,1,1.136,2,0.926,LESS
4,60,50,10,110,60,50,4.0943445622221,3.91202300542815,0.182321556793954,8.00636756765025,4.0943445622221,3.91202300542815,0,1,0,1.36,2,1.049,LESS
4,102,100,2,202,102,100,4.62497281328427,4.60517018598809,0.0198026272961789,9.23014299927236,4.62497281328427,4.60517018598809,0,1,0,1.647,1,0.855,LESS
4,106,100,6,206,106,100,4.66343909411207,4.60517018598809,0.0582689081239751,9.26860928010016,4.66343909411207,4.60517018598809,0,1,0,1.14,2,1.479,LESS
4,50,53,3,103,50,53,3.91202300542815,3.97029191355212,0.058268908123976,7.88231491898027,3.91202300542815,3.97029191355212,0,0,1,1.079,4,0.811,LESS
4,150,156,6,306,150,156,5.01063529409626,5.04985600724954,0.0392207131532816,10.0604913013458,5.01063529409626,5.04985600724954,0,0,1,4.235,1,1.392,LESS
4,50,60,10,110,50,60,3.91202300542815,4.0943445622221,0.182321556793954,8.00636756765025,3.91202300542815,4.0943445622221,0,0,1,0.747,4,0.899,LESS
4,41,50,9,91,41,50,3.71357206670431,3.91202300542815,0.198450938723838,7.62559507213245,3.71357206670431,3.91202300542815,0,0,1,1.668,4,0.412,LESS
4,50,44,6,94,50,44,3.91202300542815,3.78418963391826,0.127833371509885,7.69621263934641,3.91202300542815,3.78418963391826,0,1,0,1.581,3,1.032,LESS
4,56,50,6,106,50,56,4.02535169073515,3.91202300542815,0.113328685307004,7.9373746961633,3.91202300542815,4.02535169073515,1,1,1,1.711,2,0.767,LESS
4,150,168,18,318,168,150,5.01063529409626,5.12396397940326,0.113328685307003,10.1345992734995,5.12396397940326,5.01063529409626,1,0,0,2.803,1,0.455,LESS
4,50,56,6,106,50,56,3.91202300542815,4.02535169073515,0.113328685307004,7.9373746961633,3.91202300542815,4.02535169073515,0,0,1,1.571,4,1.034,LESS
4,150,147,3,297,147,150,5.01063529409626,4.99043258677874,0.0202027073175195,10.001067880875,4.99043258677874,5.01063529409626,1,1,1,2.123,1,1.068,LESS
4,94,100,6,194,100,94,4.54329478227,4.60517018598809,0.061875403718088,9.1484649682581,4.60517018598809,4.54329478227,1,0,0,2.648,1,0.75,LESS
4,150,177,27,327,150,177,5.01063529409626,5.17614973257383,0.165514438477573,10.1867850266701,5.01063529409626,5.17614973257383,0,0,1,1.666,2,1.815,LESS
4,50,53,3,103,50,53,3.91202300542815,3.97029191355212,0.058268908123976,7.88231491898027,3.91202300542815,3.97029191355212,0,0,1,1.478,4,0.982,LESS
4,100,98,2,198,98,100,4.60517018598809,4.58496747867057,0.0202027073175195,9.19013766465866,4.58496747867057,4.60517018598809,1,1,1,2.112,2,0.96,LESS
4,108,100,8,208,100,108,4.68213122712422,4.60517018598809,0.0769610411361281,9.28730141311231,4.60517018598809,4.68213122712422,1,1,1,1.826,1,0.969,LESS
4,147,150,3,297,147,150,4.99043258677874,5.01063529409626,0.0202027073175195,10.001067880875,4.99043258677874,5.01063529409626,0,0,1,1.203,1,0.677,LESS
4,150,144,6,294,144,150,5.01063529409626,4.969813299576,0.0408219945202548,9.98044859367226,4.969813299576,5.01063529409626,1,1,1,1.132,1,0.566,LESS
4,47,50,3,97,47,50,3.85014760171006,3.91202300542815,0.0618754037180875,7.7621706071382,3.85014760171006,3.91202300542815,0,0,1,1.399,4,0.783,LESS
4,92,100,8,192,100,92,4.52178857704904,4.60517018598809,0.0833816089390513,9.12695876303713,4.60517018598809,4.52178857704904,1,0,0,4.149,1,0.808,LESS
4,150,141,9,291,141,150,5.01063529409626,4.94875989037817,0.0618754037180871,9.95939518447442,4.94875989037817,5.01063529409626,1,1,1,2.251,2,1.604,LESS
4,50,55,5,105,50,55,3.91202300542815,4.00733318523247,0.0953101798043252,7.91935619066062,3.91202300542815,4.00733318523247,0,0,1,1.254,4,1.054,LESS
4,150,141,9,291,141,150,5.01063529409626,4.94875989037817,0.0618754037180871,9.95939518447442,4.94875989037817,5.01063529409626,1,1,1,1.596,1,1.35,LESS
4,58,50,8,108,50,58,4.06044301054642,3.91202300542815,0.148420005118273,7.97246601597456,3.91202300542815,4.06044301054642,1,1,1,2.977,1,1.084,LESS
4,50,52,2,102,50,52,3.91202300542815,3.95124371858143,0.0392207131532816,7.86326672400957,3.91202300542815,3.95124371858143,0,0,1,1.058,4,0.933,LESS
4,150,177,27,327,150,177,5.01063529409626,5.17614973257383,0.165514438477573,10.1867850266701,5.01063529409626,5.17614973257383,0,0,1,2.611,1,1.209,LESS
4,150,132,18,282,132,150,5.01063529409626,4.88280192258637,0.127833371509885,9.89343721668263,4.88280192258637,5.01063529409626,1,1,1,1.311,2,1.516,LESS
4,57,50,7,107,57,50,4.04305126783455,3.91202300542815,0.131028262406404,7.9550742732627,4.04305126783455,3.91202300542815,0,1,0,1.261,3,0.646,LESS
4,100,108,8,208,100,108,4.60517018598809,4.68213122712422,0.0769610411361281,9.28730141311231,4.60517018598809,4.68213122712422,0,0,1,1.747,2,1.194,LESS
4,50,51,1,101,50,51,3.91202300542815,3.93182563272433,0.0198026272961798,7.84384863815247,3.91202300542815,3.93182563272433,0,0,1,1.18,3,0.867,LESS
4,150,126,24,276,126,150,5.01063529409626,4.83628190695148,0.174353387144778,9.84691720104773,4.83628190695148,5.01063529409626,1,1,1,1.111,3,1.923,LESS
4,50,48,2,98,50,48,3.91202300542815,3.87120101090789,0.0408219945202548,7.78322401633604,3.91202300542815,3.87120101090789,0,1,0,1.239,4,0.744,LESS
4,150,123,27,273,123,150,5.01063529409626,4.81218435537242,0.198450938723838,9.82281964946867,4.81218435537242,5.01063529409626,1,1,1,1.145,2,1.678,LESS
4,100,84,16,184,84,100,4.60517018598809,4.43081679884331,0.174353387144778,9.03598698483141,4.43081679884331,4.60517018598809,1,1,1,1.433,2,0.914,LESS
4,123,150,27,273,123,150,4.81218435537242,5.01063529409626,0.198450938723838,9.82281964946867,4.81218435537242,5.01063529409626,0,0,1,1.242,3,0.632,LESS
4,50,42,8,92,42,50,3.91202300542815,3.73766961828337,0.174353387144778,7.64969262371151,3.73766961828337,3.91202300542815,1,1,1,1.648,2,1.036,LESS
4,100,114,14,214,100,114,4.60517018598809,4.7361984483945,0.131028262406404,9.34136863438259,4.60517018598809,4.7361984483945,0,0,1,1.678,4,0.682,LESS
4,50,52,2,102,50,52,3.91202300542815,3.95124371858143,0.0392207131532816,7.86326672400957,3.91202300542815,3.95124371858143,0,0,1,1.143,4,0.773,LESS
4,100,80,20,180,100,80,4.60517018598809,4.38202663467388,0.223143551314211,8.98719682066197,4.60517018598809,4.38202663467388,0,1,0,1.683,2,0.917,LESS
4,80,100,20,180,80,100,4.38202663467388,4.60517018598809,0.223143551314211,8.98719682066197,4.38202663467388,4.60517018598809,0,0,1,1.135,3,0.985,LESS
4,96,100,4,196,96,100,4.56434819146784,4.60517018598809,0.0408219945202557,9.16951837745593,4.56434819146784,4.60517018598809,0,0,1,3.39,2,1.396,LESS
4,50,44,6,94,50,44,3.91202300542815,3.78418963391826,0.127833371509885,7.69621263934641,3.91202300542815,3.78418963391826,0,1,0,1.239,4,0.81,LESS
4,88,100,12,188,88,100,4.47733681447821,4.60517018598809,0.127833371509885,9.0825070004663,4.47733681447821,4.60517018598809,0,0,1,1.744,1,0.904,LESS
4,150,153,3,303,150,153,5.01063529409626,5.03043792139244,0.0198026272961798,10.0410732154887,5.01063529409626,5.03043792139244,0,0,1,2.223,1,0.58,LESS
4,100,90,10,190,100,90,4.60517018598809,4.49980967033027,0.105360515657827,9.10497985631836,4.60517018598809,4.49980967033027,0,1,0,0.952,2,3.806,LESS
4,150,129,21,279,129,150,5.01063529409626,4.85981240436167,0.150822889734584,9.87044769845793,4.85981240436167,5.01063529409626,1,1,1,4.556,1,0.841,LESS
4,156,150,6,306,150,156,5.04985600724954,5.01063529409626,0.0392207131532816,10.0604913013458,5.01063529409626,5.04985600724954,1,1,1,1.869,2,0.869,LESS
4,100,92,8,192,100,92,4.60517018598809,4.52178857704904,0.0833816089390513,9.12695876303713,4.60517018598809,4.52178857704904,0,1,0,1.256,3,1.133,LESS
4,118,100,18,218,100,118,4.77068462446567,4.60517018598809,0.165514438477573,9.37585481045376,4.60517018598809,4.77068462446567,1,1,1,1.243,2,0.887,LESS
4,49,50,1,99,49,50,3.89182029811063,3.91202300542815,0.0202027073175195,7.80384330353877,3.89182029811063,3.91202300542815,0,0,1,1.614,4,0.78,LESS
4,47,50,3,97,50,47,3.85014760171006,3.91202300542815,0.0618754037180875,7.7621706071382,3.91202300542815,3.85014760171006,1,0,0,1.444,1,2.123,LESS
4,150,138,12,288,138,150,5.01063529409626,4.92725368515721,0.0833816089390504,9.93788897925346,4.92725368515721,5.01063529409626,1,1,1,1.455,1,0.757,LESS
4,138,150,12,288,150,138,4.92725368515721,5.01063529409626,0.0833816089390504,9.93788897925346,5.01063529409626,4.92725368515721,1,0,0,1.187,1,0.952,LESS
4,100,98,2,198,100,98,4.60517018598809,4.58496747867057,0.0202027073175195,9.19013766465866,4.60517018598809,4.58496747867057,0,1,0,1.383,1,1.31,LESS
4,55,50,5,105,55,50,4.00733318523247,3.91202300542815,0.0953101798043252,7.91935619066062,4.00733318523247,3.91202300542815,0,1,0,1.172,4,0.641,LESS
4,50,42,8,92,50,42,3.91202300542815,3.73766961828337,0.174353387144778,7.64969262371151,3.91202300542815,3.73766961828337,0,1,0,1.413,1,1.167,LESS
4,46,50,4,96,46,50,3.8286413964891,3.91202300542815,0.0833816089390509,7.74066440191724,3.8286413964891,3.91202300542815,0,0,1,1.437,4,0.753,LESS
4,150,135,15,285,135,150,5.01063529409626,4.90527477843843,0.105360515657826,9.91591007253469,4.90527477843843,5.01063529409626,1,1,1,1.583,1,0.818,LESS
4,150,174,24,324,150,174,5.01063529409626,5.15905529921453,0.148420005118274,10.1696905933108,5.01063529409626,5.15905529921453,0,0,1,1.894,1,0.932,LESS
4,86,100,14,186,86,100,4.45434729625351,4.60517018598809,0.150822889734584,9.0595174822416,4.45434729625351,4.60517018598809,0,0,1,1.841,3,0.615,LESS
4,50,40,10,90,50,40,3.91202300542815,3.68887945411394,0.22314355131421,7.60090245954208,3.91202300542815,3.68887945411394,0,1,0,1.332,2,0.606,LESS
4,120,150,30,270,120,150,4.78749174278205,5.01063529409626,0.22314355131421,9.7981270368783,4.78749174278205,5.01063529409626,0,0,1,1.067,2,0.616,LESS
4,123,150,27,273,123,150,4.81218435537242,5.01063529409626,0.198450938723838,9.82281964946867,4.81218435537242,5.01063529409626,0,0,1,1.038,2,0.504,LESS
4,132,150,18,282,132,150,4.88280192258637,5.01063529409626,0.127833371509885,9.89343721668263,4.88280192258637,5.01063529409626,0,0,1,1.519,1,0.604,LESS
4,150,171,21,321,150,171,5.01063529409626,5.14166355650266,0.131028262406405,10.1522988505989,5.01063529409626,5.14166355650266,0,0,1,1.389,1,0.619,LESS
4,50,59,9,109,50,59,3.91202300542815,4.07753744390572,0.165514438477574,7.98956044933387,3.91202300542815,4.07753744390572,0,0,1,1.314,4,0.724,LESS
4,49,50,1,99,49,50,3.89182029811063,3.91202300542815,0.0202027073175195,7.80384330353877,3.89182029811063,3.91202300542815,0,0,1,1.702,2,0.666,LESS
4,100,84,16,184,100,84,4.60517018598809,4.43081679884331,0.174353387144778,9.03598698483141,4.60517018598809,4.43081679884331,0,1,0,1.155,2,0.585,LESS
4,150,147,3,297,150,147,5.01063529409626,4.99043258677874,0.0202027073175195,10.001067880875,5.01063529409626,4.99043258677874,0,1,0,1.992,1,0.588,LESS
4,43,50,7,93,43,50,3.76120011569356,3.91202300542815,0.150822889734584,7.67322312112171,3.76120011569356,3.91202300542815,0,0,1,1.418,3,0.532,LESS
4,106,100,6,206,106,100,4.66343909411207,4.60517018598809,0.0582689081239751,9.26860928010016,4.66343909411207,4.60517018598809,0,1,0,1.402,1,1.364,LESS
4,100,114,14,214,100,114,4.60517018598809,4.7361984483945,0.131028262406404,9.34136863438259,4.60517018598809,4.7361984483945,0,0,1,2.673,1,0.557,LESS
4,88,100,12,188,88,100,4.47733681447821,4.60517018598809,0.127833371509885,9.0825070004663,4.47733681447821,4.60517018598809,0,0,1,1.298,1,0.619,LESS
4,147,150,3,297,147,150,4.99043258677874,5.01063529409626,0.0202027073175195,10.001067880875,4.99043258677874,5.01063529409626,0,0,1,1.047,1,0.441,LESS
4,162,150,12,312,150,162,5.08759633523238,5.01063529409626,0.0769610411361281,10.0982316293286,5.01063529409626,5.08759633523238,1,1,1,1.748,2,1.06,LESS
4,100,82,18,182,82,100,4.60517018598809,4.40671924726425,0.198450938723838,9.01188943325235,4.40671924726425,4.60517018598809,1,1,1,1.765,2,0.649,LESS
4,60,50,10,110,60,50,4.0943445622221,3.91202300542815,0.182321556793954,8.00636756765025,4.0943445622221,3.91202300542815,0,1,0,1.513,3,1.036,LESS
4,150,120,30,270,120,150,5.01063529409626,4.78749174278205,0.22314355131421,9.7981270368783,4.78749174278205,5.01063529409626,1,1,1,1.461,3,1.453,LESS
4,56,50,6,106,50,56,4.02535169073515,3.91202300542815,0.113328685307004,7.9373746961633,3.91202300542815,4.02535169073515,1,1,1,2.487,1,2.189,LESS
4,165,150,15,315,150,165,5.10594547390058,5.01063529409626,0.0953101798043248,10.1165807679968,5.01063529409626,5.10594547390058,1,1,1,1.234,2,1.222,LESS
4,110,100,10,210,110,100,4.70048036579242,4.60517018598809,0.0953101798043248,9.30565055178051,4.70048036579242,4.60517018598809,0,1,0,1.635,2,0.828,LESS
4,100,88,12,188,100,88,4.60517018598809,4.47733681447821,0.127833371509885,9.0825070004663,4.60517018598809,4.47733681447821,0,1,0,2.868,1,0.659,LESS
4,98,100,2,198,98,100,4.58496747867057,4.60517018598809,0.0202027073175195,9.19013766465866,4.58496747867057,4.60517018598809,0,0,1,1.899,1,0.786,LESS
4,50,45,5,95,50,45,3.91202300542815,3.80666248977032,0.105360515657826,7.71868549519847,3.91202300542815,3.80666248977032,0,1,0,1.52,3,0.853,LESS
5,50,41,9,91,50,41,3.91202300542815,3.71357206670431,0.198450938723838,7.62559507213245,3.91202300542815,3.71357206670431,0,1,0,0.8698,1,1.7848,LESS
5,50,44,6,94,44,50,3.91202300542815,3.78418963391826,0.127833371509885,7.69621263934641,3.78418963391826,3.91202300542815,1,1,1,1.1951,1,1.7075,LESS
5,147,150,3,297,147,150,4.99043258677874,5.01063529409626,0.0202027073175195,10.001067880875,4.99043258677874,5.01063529409626,0,0,1,1.1874,2,1.2089,LESS
5,168,150,18,318,150,168,5.12396397940326,5.01063529409626,0.113328685307003,10.1345992734995,5.01063529409626,5.12396397940326,1,1,1,1.3401,1,1.1844,LESS
5,150,135,15,285,135,150,5.01063529409626,4.90527477843843,0.105360515657826,9.91591007253469,4.90527477843843,5.01063529409626,1,1,1,1.2973,1,1.4181,LESS
5,50,57,7,107,50,57,3.91202300542815,4.04305126783455,0.131028262406404,7.9550742732627,3.91202300542815,4.04305126783455,0,0,1,1.358,4,1.7516,LESS
5,100,88,12,188,100,88,4.60517018598809,4.47733681447821,0.127833371509885,9.0825070004663,4.60517018598809,4.47733681447821,0,1,0,1.6861,1,1.4042,LESS
5,60,50,10,110,50,60,4.0943445622221,3.91202300542815,0.182321556793954,8.00636756765025,3.91202300542815,4.0943445622221,1,1,1,1.5663,3,2.4522,LESS
5,106,100,6,206,100,106,4.66343909411207,4.60517018598809,0.0582689081239751,9.26860928010016,4.60517018598809,4.66343909411207,1,1,1,1.0867,1,1.5181,LESS
5,132,150,18,282,132,150,4.88280192258637,5.01063529409626,0.127833371509885,9.89343721668263,4.88280192258637,5.01063529409626,0,0,1,1.0826,3,1.6015,LESS
5,150,156,6,306,150,156,5.01063529409626,5.04985600724954,0.0392207131532816,10.0604913013458,5.01063529409626,5.04985600724954,0,0,1,1.4218,1,1.0909,LESS
5,150,165,15,315,150,165,5.01063529409626,5.10594547390058,0.0953101798043248,10.1165807679968,5.01063529409626,5.10594547390058,0,0,1,1.0971,1,1.2013,LESS
5,52,50,2,102,52,50,3.95124371858143,3.91202300542815,0.0392207131532816,7.86326672400957,3.95124371858143,3.91202300542815,0,1,0,1.3969,2,1.1209,LESS
5,50,40,10,90,40,50,3.91202300542815,3.68887945411394,0.22314355131421,7.60090245954208,3.68887945411394,3.91202300542815,1,1,1,1.0018,3,1.652,LESS
5,150,147,3,297,150,147,5.01063529409626,4.99043258677874,0.0202027073175195,10.001067880875,5.01063529409626,4.99043258677874,0,1,0,1.4089,1,1.7372,LESS
5,47,50,3,97,47,50,3.85014760171006,3.91202300542815,0.0618754037180875,7.7621706071382,3.85014760171006,3.91202300542815,0,0,1,1.141,4,1.7882,LESS
5,123,150,27,273,123,150,4.81218435537242,5.01063529409626,0.198450938723838,9.82281964946867,4.81218435537242,5.01063529409626,0,0,1,1.1521,1,1.169,LESS
5,45,50,5,95,45,50,3.80666248977032,3.91202300542815,0.105360515657826,7.71868549519847,3.80666248977032,3.91202300542815,0,0,1,0.8293,4,1.775,LESS
5,50,52,2,102,50,52,3.91202300542815,3.95124371858143,0.0392207131532816,7.86326672400957,3.91202300542815,3.95124371858143,0,0,1,0.978,3,1.5183,LESS
5,150,126,24,276,126,150,5.01063529409626,4.83628190695148,0.174353387144778,9.84691720104773,4.83628190695148,5.01063529409626,1,1,1,1.5346,1,1.5016,LESS
5,40,50,10,90,40,50,3.68887945411394,3.91202300542815,0.22314355131421,7.60090245954208,3.68887945411394,3.91202300542815,0,0,1,0.974,3,1.4847,LESS
5,47,50,3,97,47,50,3.85014760171006,3.91202300542815,0.0618754037180875,7.7621706071382,3.85014760171006,3.91202300542815,0,0,1,1.8287,4,1.8764,LESS
5,150,174,24,324,150,174,5.01063529409626,5.15905529921453,0.148420005118274,10.1696905933108,5.01063529409626,5.15905529921453,0,0,1,0.9367,4,1.5354,LESS
5,50,54,4,104,50,54,3.91202300542815,3.98898404656427,0.0769610411361286,7.90100705199242,3.91202300542815,3.98898404656427,0,0,1,0.9646,3,1.5681,LESS
5,174,150,24,324,174,150,5.15905529921453,5.01063529409626,0.148420005118274,10.1696905933108,5.15905529921453,5.01063529409626,0,1,0,1.1216,3,1.2261,LESS
5,50,49,1,99,50,49,3.91202300542815,3.89182029811063,0.0202027073175195,7.80384330353877,3.91202300542815,3.89182029811063,0,1,0,0.9374,4,1.3349,LESS
5,52,50,2,102,52,50,3.95124371858143,3.91202300542815,0.0392207131532816,7.86326672400957,3.95124371858143,3.91202300542815,0,1,0,0.8321,4,1.2355,LESS
5,150,162,12,312,150,162,5.01063529409626,5.08759633523238,0.0769610411361281,10.0982316293286,5.01063529409626,5.08759633523238,0,0,1,1.0686,3,1.4045,LESS
5,100,94,6,194,100,94,4.60517018598809,4.54329478227,0.061875403718088,9.1484649682581,4.60517018598809,4.54329478227,0,1,0,0.9177,1,1.5184,LESS
5,59,50,9,109,59,50,4.07753744390572,3.91202300542815,0.165514438477574,7.98956044933387,4.07753744390572,3.91202300542815,0,1,0,1.1722,2,1.5681,LESS
5,108,100,8,208,100,108,4.68213122712422,4.60517018598809,0.0769610411361281,9.28730141311231,4.60517018598809,4.68213122712422,1,1,1,1.9283,1,1.1696,LESS
5,180,150,30,330,180,150,5.19295685089021,5.01063529409626,0.182321556793955,10.2035921449865,5.19295685089021,5.01063529409626,0,1,0,0.9289,1,1.7846,LESS
5,86,100,14,186,86,100,4.45434729625351,4.60517018598809,0.150822889734584,9.0595174822416,4.45434729625351,4.60517018598809,0,0,1,0.9029,3,1.5542,LESS
5,50,53,3,103,50,53,3.91202300542815,3.97029191355212,0.058268908123976,7.88231491898027,3.91202300542815,3.97029191355212,0,0,1,1.0053,4,1.3516,LESS
5,86,100,14,186,86,100,4.45434729625351,4.60517018598809,0.150822889734584,9.0595174822416,4.45434729625351,4.60517018598809,0,0,1,1.7374,1,1.4203,LESS
5,165,150,15,315,165,150,5.10594547390058,5.01063529409626,0.0953101798043248,10.1165807679968,5.10594547390058,5.01063529409626,0,1,0,1.1681,1,1.3686,LESS
5,50,44,6,94,50,44,3.91202300542815,3.78418963391826,0.127833371509885,7.69621263934641,3.91202300542815,3.78418963391826,0,1,0,2.2204,2,1.2509,LESS
5,129,150,21,279,129,150,4.85981240436167,5.01063529409626,0.150822889734584,9.87044769845793,4.85981240436167,5.01063529409626,0,0,1,1.2804,1,1.268,LESS
5,50,52,2,102,50,52,3.91202300542815,3.95124371858143,0.0392207131532816,7.86326672400957,3.91202300542815,3.95124371858143,0,0,1,1.0814,4,1.4016,LESS
5,150,162,12,312,150,162,5.01063529409626,5.08759633523238,0.0769610411361281,10.0982316293286,5.01063529409626,5.08759633523238,0,0,1,1.2364,4,1.3848,LESS
5,135,150,15,285,135,150,4.90527477843843,5.01063529409626,0.105360515657826,9.91591007253469,4.90527477843843,5.01063529409626,0,0,1,2.5397,1,1.3197,LESS
5,110,100,10,210,110,100,4.70048036579242,4.60517018598809,0.0953101798043248,9.30565055178051,4.70048036579242,4.60517018598809,0,1,0,1.2814,3,1.152,LESS
5,98,100,2,198,98,100,4.58496747867057,4.60517018598809,0.0202027073175195,9.19013766465866,4.58496747867057,4.60517018598809,0,0,1,1.5139,1,1.1847,LESS
5,100,108,8,208,100,108,4.60517018598809,4.68213122712422,0.0769610411361281,9.28730141311231,4.60517018598809,4.68213122712422,0,0,1,2.619,2,1.1084,LESS
5,100,106,6,206,100,106,4.60517018598809,4.66343909411207,0.0582689081239751,9.26860928010016,4.60517018598809,4.66343909411207,0,0,1,1.7938,1,1.1517,LESS
5,100,118,18,218,100,118,4.60517018598809,4.77068462446567,0.165514438477573,9.37585481045376,4.60517018598809,4.77068462446567,0,0,1,2.241,1,1.1681,LESS
5,150,129,21,279,129,150,5.01063529409626,4.85981240436167,0.150822889734584,9.87044769845793,4.85981240436167,5.01063529409626,1,1,1,1.1907,2,1.3686,LESS
5,150,126,24,276,126,150,5.01063529409626,4.83628190695148,0.174353387144778,9.84691720104773,4.83628190695148,5.01063529409626,1,1,1,1.2978,2,1.352,LESS
5,96,100,4,196,96,100,4.56434819146784,4.60517018598809,0.0408219945202557,9.16951837745593,4.56434819146784,4.60517018598809,0,0,1,1.203,1,2.0701,LESS
5,112,100,12,212,112,100,4.71849887129509,4.60517018598809,0.113328685307002,9.32366905728319,4.71849887129509,4.60517018598809,0,1,0,2.0377,3,1.6722,LESS
5,50,47,3,97,50,47,3.91202300542815,3.85014760171006,0.0618754037180875,7.7621706071382,3.91202300542815,3.85014760171006,0,1,0,1.6062,4,1.3056,LESS
5,126,150,24,276,126,150,4.83628190695148,5.01063529409626,0.174353387144778,9.84691720104773,4.83628190695148,5.01063529409626,0,0,1,1.0914,1,1.2251,LESS
5,150,129,21,279,150,129,5.01063529409626,4.85981240436167,0.150822889734584,9.87044769845793,5.01063529409626,4.85981240436167,0,1,0,1.2857,1,1.0352,LESS
5,57,50,7,107,57,50,4.04305126783455,3.91202300542815,0.131028262406404,7.9550742732627,4.04305126783455,3.91202300542815,0,1,0,1.6537,4,1.2354,LESS
5,150,177,27,327,150,177,5.01063529409626,5.17614973257383,0.165514438477573,10.1867850266701,5.01063529409626,5.17614973257383,0,0,1,1.0427,1,1.2678,LESS
5,150,141,9,291,150,141,5.01063529409626,4.94875989037817,0.0618754037180871,9.95939518447442,5.01063529409626,4.94875989037817,0,1,0,1.8748,2,1.1016,LESS
5,126,150,24,276,126,150,4.83628190695148,5.01063529409626,0.174353387144778,9.84691720104773,4.83628190695148,5.01063529409626,0,0,1,1.06,2,1.1514,LESS
5,54,50,4,104,54,50,3.98898404656427,3.91202300542815,0.0769610411361286,7.90100705199242,3.98898404656427,3.91202300542815,0,1,0,1.1787,4,1.2351,LESS
5,100,94,6,194,100,94,4.60517018598809,4.54329478227,0.061875403718088,9.1484649682581,4.60517018598809,4.54329478227,0,1,0,1.2867,3,1.1844,LESS
5,132,150,18,282,132,150,4.88280192258637,5.01063529409626,0.127833371509885,9.89343721668263,4.88280192258637,5.01063529409626,0,0,1,1.0803,4,1.2513,LESS
5,44,50,6,94,44,50,3.78418963391826,3.91202300542815,0.127833371509885,7.69621263934641,3.78418963391826,3.91202300542815,0,0,1,1.3425,4,1.1692,LESS
5,100,116,16,216,100,116,4.60517018598809,4.75359019110636,0.148420005118273,9.35876037709446,4.60517018598809,4.75359019110636,0,0,1,1.0578,4,1.1014,LESS
5,94,100,6,194,94,100,4.54329478227,4.60517018598809,0.061875403718088,9.1484649682581,4.54329478227,4.60517018598809,0,0,1,1.0983,3,1.0345,LESS
5,50,49,1,99,50,49,3.91202300542815,3.89182029811063,0.0202027073175195,7.80384330353877,3.91202300542815,3.89182029811063,0,1,0,1.306,4,1.118,LESS
5,100,88,12,188,100,88,4.60517018598809,4.47733681447821,0.127833371509885,9.0825070004663,4.60517018598809,4.47733681447821,0,1,0,1.6327,2,1.3208,LESS
5,104,100,4,204,100,104,4.64439089914137,4.60517018598809,0.0392207131532807,9.24956108512946,4.60517018598809,4.64439089914137,1,1,1,1.2699,2,1.9853,LESS
5,46,50,4,96,46,50,3.8286413964891,3.91202300542815,0.0833816089390509,7.74066440191724,3.8286413964891,3.91202300542815,0,0,1,1.8084,2,1.1249,LESS
5,43,50,7,93,43,50,3.76120011569356,3.91202300542815,0.150822889734584,7.67322312112171,3.76120011569356,3.91202300542815,0,0,1,1.2275,4,1.1246,LESS
5,171,150,21,321,150,171,5.14166355650266,5.01063529409626,0.131028262406405,10.1522988505989,5.01063529409626,5.14166355650266,1,1,1,1.3434,3,1.3534,LESS
5,100,92,8,192,100,92,4.60517018598809,4.52178857704904,0.0833816089390513,9.12695876303713,4.60517018598809,4.52178857704904,0,1,0,0.8396,1,1.3189,LESS
5,82,100,18,182,82,100,4.40671924726425,4.60517018598809,0.198450938723838,9.01188943325235,4.40671924726425,4.60517018598809,0,0,1,0.9697,2,1.3189,LESS
5,80,100,20,180,80,100,4.38202663467388,4.60517018598809,0.223143551314211,8.98719682066197,4.38202663467388,4.60517018598809,0,0,1,0.9577,1,1.2852,LESS
5,51,50,1,101,51,50,3.93182563272433,3.91202300542815,0.0198026272961798,7.84384863815247,3.93182563272433,3.91202300542815,0,1,0,1.2997,2,1.3855,LESS
5,55,50,5,105,55,50,4.00733318523247,3.91202300542815,0.0953101798043252,7.91935619066062,4.00733318523247,3.91202300542815,0,1,0,1.2048,3,1.1519,LESS
5,100,92,8,192,92,100,4.60517018598809,4.52178857704904,0.0833816089390513,9.12695876303713,4.52178857704904,4.60517018598809,1,1,1,1.7043,1,1.318,LESS
5,129,150,21,279,129,150,4.85981240436167,5.01063529409626,0.150822889734584,9.87044769845793,4.85981240436167,5.01063529409626,0,0,1,1.0399,2,1.0685,LESS
5,138,150,12,288,150,138,4.92725368515721,5.01063529409626,0.0833816089390504,9.93788897925346,5.01063529409626,4.92725368515721,1,0,0,1.1993,1,1.2083,LESS
5,50,40,10,90,50,40,3.91202300542815,3.68887945411394,0.22314355131421,7.60090245954208,3.91202300542815,3.68887945411394,0,1,0,2.708,1,1.2179,LESS
5,42,50,8,92,42,50,3.73766961828337,3.91202300542815,0.174353387144778,7.64969262371151,3.73766961828337,3.91202300542815,0,0,1,1.0925,4,1.1686,LESS
5,50,60,10,110,50,60,3.91202300542815,4.0943445622221,0.182321556793954,8.00636756765025,3.91202300542815,4.0943445622221,0,0,1,1.1833,3,1.3679,LESS
5,100,80,20,180,100,80,4.60517018598809,4.38202663467388,0.223143551314211,8.98719682066197,4.60517018598809,4.38202663467388,0,1,0,1.7666,2,1.2351,LESS
5,49,50,1,99,49,50,3.89182029811063,3.91202300542815,0.0202027073175195,7.80384330353877,3.89182029811063,3.91202300542815,0,0,1,0.9011,4,1.5014,LESS
5,147,150,3,297,147,150,4.99043258677874,5.01063529409626,0.0202027073175195,10.001067880875,4.99043258677874,5.01063529409626,0,0,1,1.1119,3,1.2012,LESS
5,54,50,4,104,54,50,3.98898404656427,3.91202300542815,0.0769610411361286,7.90100705199242,3.98898404656427,3.91202300542815,0,1,0,1.0024,4,1.2678,LESS
5,51,50,1,101,51,50,3.93182563272433,3.91202300542815,0.0198026272961798,7.84384863815247,3.93182563272433,3.91202300542815,0,1,0,1.0489,3,1.0861,LESS
5,100,96,4,196,100,96,4.60517018598809,4.56434819146784,0.0408219945202557,9.16951837745593,4.60517018598809,4.56434819146784,0,1,0,1.0566,2,1.0848,LESS
5,108,100,8,208,108,100,4.68213122712422,4.60517018598809,0.0769610411361281,9.28730141311231,4.68213122712422,4.60517018598809,0,1,0,0.9322,1,1.1848,LESS
5,159,150,9,309,150,159,5.06890420222023,5.01063529409626,0.058268908123976,10.0795394963165,5.01063529409626,5.06890420222023,1,1,1,2.3485,1,1.7253,LESS
5,150,138,12,288,150,138,5.01063529409626,4.92725368515721,0.0833816089390504,9.93788897925346,5.01063529409626,4.92725368515721,0,1,0,1.4083,1,1.1703,LESS
5,120,150,30,270,150,120,4.78749174278205,5.01063529409626,0.22314355131421,9.7981270368783,5.01063529409626,4.78749174278205,1,0,0,1.3368,1,1.2011,LESS
5,84,100,16,184,84,100,4.43081679884331,4.60517018598809,0.174353387144778,9.03598698483141,4.43081679884331,4.60517018598809,0,0,1,0.8596,4,1.318,LESS
5,100,116,16,216,116,100,4.60517018598809,4.75359019110636,0.148420005118273,9.35876037709446,4.75359019110636,4.60517018598809,1,0,0,1.1169,3,1.155,LESS
5,48,50,2,98,50,48,3.87120101090789,3.91202300542815,0.0408219945202548,7.78322401633604,3.91202300542815,3.87120101090789,1,0,0,2.207,2,1.4197,LESS
5,50,57,7,107,50,57,3.91202300542815,4.04305126783455,0.131028262406404,7.9550742732627,3.91202300542815,4.04305126783455,0,0,1,1.0276,4,1.2681,LESS
5,50,54,4,104,50,54,3.91202300542815,3.98898404656427,0.0769610411361286,7.90100705199242,3.91202300542815,3.98898404656427,0,0,1,1.34,2,1.2374,LESS
5,50,51,1,101,50,51,3.91202300542815,3.93182563272433,0.0198026272961798,7.84384863815247,3.91202300542815,3.93182563272433,0,0,1,1.0619,3,1.1845,LESS
5,100,84,16,184,84,100,4.60517018598809,4.43081679884331,0.174353387144778,9.03598698483141,4.43081679884331,4.60517018598809,1,1,1,0.9361,3,1.418,LESS
5,150,168,18,318,150,168,5.01063529409626,5.12396397940326,0.113328685307003,10.1345992734995,5.01063529409626,5.12396397940326,0,0,1,0.99,3,1.3352,LESS
5,92,100,8,192,92,100,4.52178857704904,4.60517018598809,0.0833816089390513,9.12695876303713,4.52178857704904,4.60517018598809,0,0,1,0.9373,4,1.6682,LESS
5,45,50,5,95,50,45,3.80666248977032,3.91202300542815,0.105360515657826,7.71868549519847,3.91202300542815,3.80666248977032,1,0,0,2.2011,1,1.1526,LESS
5,92,100,8,192,92,100,4.52178857704904,4.60517018598809,0.0833816089390513,9.12695876303713,4.52178857704904,4.60517018598809,0,0,1,0.9112,2,1.2049,LESS
5,150,174,24,324,150,174,5.01063529409626,5.15905529921453,0.148420005118274,10.1696905933108,5.01063529409626,5.15905529921453,0,0,1,1.1768,3,1.6019,LESS
5,88,100,12,188,88,100,4.47733681447821,4.60517018598809,0.127833371509885,9.0825070004663,4.47733681447821,4.60517018598809,0,0,1,0.8294,4,1.1327,LESS
5,141,150,9,291,150,141,4.94875989037817,5.01063529409626,0.0618754037180871,9.95939518447442,5.01063529409626,4.94875989037817,1,0,0,1.2132,2,1.4031,LESS
5,50,60,10,110,50,60,3.91202300542815,4.0943445622221,0.182321556793954,8.00636756765025,3.91202300542815,4.0943445622221,0,0,1,0.9123,4,1.0845,LESS
5,100,86,14,186,86,100,4.60517018598809,4.45434729625351,0.150822889734584,9.0595174822416,4.45434729625351,4.60517018598809,1,1,1,0.9577,4,1.1871,LESS
5,41,50,9,91,41,50,3.71357206670431,3.91202300542815,0.198450938723838,7.62559507213245,3.71357206670431,3.91202300542815,0,0,1,0.9133,4,1.3844,LESS
5,100,114,14,214,114,100,4.60517018598809,4.7361984483945,0.131028262406404,9.34136863438259,4.7361984483945,4.60517018598809,1,0,0,1.3738,2,1.6182,LESS
5,55,50,5,105,50,55,4.00733318523247,3.91202300542815,0.0953101798043252,7.91935619066062,3.91202300542815,4.00733318523247,1,1,1,1.2031,3,1.2012,LESS
5,150,123,27,273,123,150,5.01063529409626,4.81218435537242,0.198450938723838,9.82281964946867,4.81218435537242,5.01063529409626,1,1,1,0.8657,4,1.7346,LESS
5,150,120,30,270,120,150,5.01063529409626,4.78749174278205,0.22314355131421,9.7981270368783,4.78749174278205,5.01063529409626,1,1,1,3.0392,1,1.5512,LESS
5,50,53,3,103,53,50,3.91202300542815,3.97029191355212,0.058268908123976,7.88231491898027,3.97029191355212,3.91202300542815,1,0,0,1.5542,1,1.3029,LESS
5,82,100,18,182,82,100,4.40671924726425,4.60517018598809,0.198450938723838,9.01188943325235,4.40671924726425,4.60517018598809,0,0,1,1.1692,2,1.1679,LESS
5,150,168,18,318,168,150,5.01063529409626,5.12396397940326,0.113328685307003,10.1345992734995,5.12396397940326,5.01063529409626,1,0,0,2.3082,1,1.3005,LESS
5,150,165,15,315,165,150,5.01063529409626,5.10594547390058,0.0953101798043248,10.1165807679968,5.10594547390058,5.01063529409626,1,0,0,0.8684,1,1.3353,LESS
5,138,150,12,288,138,150,4.92725368515721,5.01063529409626,0.0833816089390504,9.93788897925346,4.92725368515721,5.01063529409626,0,0,1,1.1913,3,1.2862,LESS
5,100,90,10,190,100,90,4.60517018598809,4.49980967033027,0.105360515657827,9.10497985631836,4.60517018598809,4.49980967033027,0,1,0,1.2794,1,1.5348,LESS
5,110,100,10,210,100,110,4.70048036579242,4.60517018598809,0.0953101798043248,9.30565055178051,4.60517018598809,4.70048036579242,1,1,1,1.0475,2,1.2181,LESS
5,90,100,10,190,90,100,4.49980967033027,4.60517018598809,0.105360515657827,9.10497985631836,4.49980967033027,4.60517018598809,0,0,1,1.4673,2,1.2024,LESS
5,162,150,12,312,150,162,5.08759633523238,5.01063529409626,0.0769610411361281,10.0982316293286,5.01063529409626,5.08759633523238,1,1,1,3.9021,2,1.4525,LESS
5,80,100,20,180,80,100,4.38202663467388,4.60517018598809,0.223143551314211,8.98719682066197,4.38202663467388,4.60517018598809,0,0,1,0.9321,3,1.9352,LESS
5,98,100,2,198,98,100,4.58496747867057,4.60517018598809,0.0202027073175195,9.19013766465866,4.58496747867057,4.60517018598809,0,0,1,1.3782,2,1.5863,LESS
5,50,45,5,95,45,50,3.91202300542815,3.80666248977032,0.105360515657826,7.71868549519847,3.80666248977032,3.91202300542815,1,1,1,2.4049,2,1.2601,LESS
5,120,100,20,220,100,120,4.78749174278205,4.60517018598809,0.182321556793954,9.39266192877014,4.60517018598809,4.78749174278205,1,1,1,0.9693,4,1.2347,LESS
5,100,96,4,196,96,100,4.60517018598809,4.56434819146784,0.0408219945202557,9.16951837745593,4.56434819146784,4.60517018598809,1,1,1,1.2069,3,1.292,LESS
5,50,46,4,96,46,50,3.91202300542815,3.8286413964891,0.0833816089390509,7.74066440191724,3.8286413964891,3.91202300542815,1,1,1,3.7597,1,1.2182,LESS
5,100,108,8,208,100,108,4.60517018598809,4.68213122712422,0.0769610411361281,9.28730141311231,4.60517018598809,4.68213122712422,0,0,1,0.9911,3,1.1748,LESS
5,56,50,6,106,50,56,4.02535169073515,3.91202300542815,0.113328685307004,7.9373746961633,3.91202300542815,4.02535169073515,1,1,1,1.1928,4,1.2017,LESS
5,102,100,2,202,100,102,4.62497281328427,4.60517018598809,0.0198026272961789,9.23014299927236,4.60517018598809,4.62497281328427,1,1,1,1.1014,3,1.221,LESS
5,100,110,10,210,100,110,4.60517018598809,4.70048036579242,0.0953101798043248,9.30565055178051,4.60517018598809,4.70048036579242,0,0,1,0.9499,3,1.168,LESS
5,100,104,4,204,100,104,4.60517018598809,4.64439089914137,0.0392207131532807,9.24956108512946,4.60517018598809,4.64439089914137,0,0,1,1.7426,1,1.0846,LESS
5,153,150,3,303,153,150,5.03043792139244,5.01063529409626,0.0198026272961798,10.0410732154887,5.03043792139244,5.01063529409626,0,1,0,1.2566,1,1.1181,LESS
5,49,50,1,99,49,50,3.89182029811063,3.91202300542815,0.0202027073175195,7.80384330353877,3.89182029811063,3.91202300542815,0,0,1,2.6195,1,1.0514,LESS
5,40,50,10,90,40,50,3.68887945411394,3.91202300542815,0.22314355131421,7.60090245954208,3.68887945411394,3.91202300542815,0,0,1,0.9653,4,1.001,LESS
5,100,102,2,202,102,100,4.60517018598809,4.62497281328427,0.0198026272961789,9.23014299927236,4.62497281328427,4.60517018598809,1,0,0,1.0183,2,1.2515,LESS
5,57,50,7,107,57,50,4.04305126783455,3.91202300542815,0.131028262406404,7.9550742732627,4.04305126783455,3.91202300542815,0,1,0,1.0751,3,1.1518,LESS
5,150,153,3,303,153,150,5.01063529409626,5.03043792139244,0.0198026272961798,10.0410732154887,5.03043792139244,5.01063529409626,1,0,0,1.4154,1,1.2085,LESS
5,150,141,9,291,141,150,5.01063529409626,4.94875989037817,0.0618754037180871,9.95939518447442,4.94875989037817,5.01063529409626,1,1,1,1.0385,1,1.2158,LESS
5,50,56,6,106,50,56,3.91202300542815,4.02535169073515,0.113328685307004,7.9373746961633,3.91202300542815,4.02535169073515,0,0,1,2.1555,2,0.9852,LESS
5,50,55,5,105,50,55,3.91202300542815,4.00733318523247,0.0953101798043252,7.91935619066062,3.91202300542815,4.00733318523247,0,0,1,1.1576,3,1.1863,LESS
5,171,150,21,321,171,150,5.14166355650266,5.01063529409626,0.131028262406405,10.1522988505989,5.14166355650266,5.01063529409626,0,1,0,1.4318,1,1.6013,LESS
5,114,100,14,214,114,100,4.7361984483945,4.60517018598809,0.131028262406404,9.34136863438259,4.7361984483945,4.60517018598809,0,1,0,1.4819,1,1.1012,LESS
5,118,100,18,218,100,118,4.77068462446567,4.60517018598809,0.165514438477573,9.37585481045376,4.60517018598809,4.77068462446567,1,1,1,2.2821,3,1.6347,LESS
5,56,50,6,106,50,56,4.02535169073515,3.91202300542815,0.113328685307004,7.9373746961633,3.91202300542815,4.02535169073515,1,1,1,3.4167,1,1.2179,LESS
5,150,156,6,306,150,156,5.01063529409626,5.04985600724954,0.0392207131532816,10.0604913013458,5.01063529409626,5.04985600724954,0,0,1,1.1184,1,1.1357,LESS
5,150,138,12,288,150,138,5.01063529409626,4.92725368515721,0.0833816089390504,9.93788897925346,5.01063529409626,4.92725368515721,0,1,0,1.4025,1,1.1018,LESS
5,156,150,6,306,156,150,5.04985600724954,5.01063529409626,0.0392207131532816,10.0604913013458,5.04985600724954,5.01063529409626,0,1,0,1.4186,1,1.2364,LESS
5,123,150,27,273,123,150,4.81218435537242,5.01063529409626,0.198450938723838,9.82281964946867,4.81218435537242,5.01063529409626,0,0,1,1.1984,1,0.968,LESS
5,53,50,3,103,53,50,3.97029191355212,3.91202300542815,0.058268908123976,7.88231491898027,3.97029191355212,3.91202300542815,0,1,0,3.1303,1,1.218,LESS
5,50,56,6,106,50,56,3.91202300542815,4.02535169073515,0.113328685307004,7.9373746961633,3.91202300542815,4.02535169073515,0,0,1,2.7388,1,1.1174,LESS
5,180,150,30,330,150,180,5.19295685089021,5.01063529409626,0.182321556793955,10.2035921449865,5.01063529409626,5.19295685089021,1,1,1,0.9276,3,1.2012,LESS
5,135,150,15,285,150,135,4.90527477843843,5.01063529409626,0.105360515657826,9.91591007253469,5.01063529409626,4.90527477843843,1,0,0,2.947,1,1.6513,LESS
5,60,50,10,110,50,60,4.0943445622221,3.91202300542815,0.182321556793954,8.00636756765025,3.91202300542815,4.0943445622221,1,1,1,5.2488,2,1.4179,LESS
5,43,50,7,93,43,50,3.76120011569356,3.91202300542815,0.150822889734584,7.67322312112171,3.76120011569356,3.91202300542815,0,0,1,1.1068,4,1.4742,LESS
5,150,171,21,321,171,150,5.01063529409626,5.14166355650266,0.131028262406405,10.1522988505989,5.14166355650266,5.01063529409626,1,0,0,2.0689,1,1.1346,LESS
5,177,150,27,327,150,177,5.17614973257383,5.01063529409626,0.165514438477573,10.1867850266701,5.01063529409626,5.17614973257383,1,1,1,0.857,2,1.1687,LESS
5,50,48,2,98,50,48,3.91202300542815,3.87120101090789,0.0408219945202548,7.78322401633604,3.91202300542815,3.87120101090789,0,1,0,3.1694,1,1.1183,LESS
5,100,112,12,212,112,100,4.60517018598809,4.71849887129509,0.113328685307002,9.32366905728319,4.71849887129509,4.60517018598809,1,0,0,1.8843,2,1.2012,LESS
5,42,50,8,92,42,50,3.73766961828337,3.91202300542815,0.174353387144778,7.64969262371151,3.73766961828337,3.91202300542815,0,0,1,0.9857,3,1.4008,LESS
5,106,100,6,206,106,100,4.66343909411207,4.60517018598809,0.0582689081239751,9.26860928010016,4.66343909411207,4.60517018598809,0,1,0,2.2145,1,1.1593,LESS
5,100,82,18,182,82,100,4.60517018598809,4.40671924726425,0.198450938723838,9.01188943325235,4.40671924726425,4.60517018598809,1,1,1,1.0173,4,1.4362,LESS
5,120,100,20,220,100,120,4.78749174278205,4.60517018598809,0.182321556793954,9.39266192877014,4.60517018598809,4.78749174278205,1,1,1,0.9421,3,1.092,LESS
5,141,150,9,291,141,150,4.94875989037817,5.01063529409626,0.0618754037180871,9.95939518447442,4.94875989037817,5.01063529409626,0,0,1,2.2841,1,1.0673,LESS
5,100,120,20,220,100,120,4.60517018598809,4.78749174278205,0.182321556793954,9.39266192877014,4.60517018598809,4.78749174278205,0,0,1,1.2622,1,1.3052,LESS
5,100,80,20,180,80,100,4.60517018598809,4.38202663467388,0.223143551314211,8.98719682066197,4.38202663467388,4.60517018598809,1,1,1,1.8672,2,1.0394,LESS
5,150,135,15,285,135,150,5.01063529409626,4.90527477843843,0.105360515657826,9.91591007253469,4.90527477843843,5.01063529409626,1,1,1,1.5978,1,1.3423,LESS
5,150,123,27,273,123,150,5.01063529409626,4.81218435537242,0.198450938723838,9.82281964946867,4.81218435537242,5.01063529409626,1,1,1,0.9131,2,1.1681,LESS
5,46,50,4,96,46,50,3.8286413964891,3.91202300542815,0.0833816089390509,7.74066440191724,3.8286413964891,3.91202300542815,0,0,1,1.1836,3,1.4017,LESS
5,114,100,14,214,100,114,4.7361984483945,4.60517018598809,0.131028262406404,9.34136863438259,4.60517018598809,4.7361984483945,1,1,1,0.8822,4,1.3179,LESS
5,48,50,2,98,50,48,3.87120101090789,3.91202300542815,0.0408219945202548,7.78322401633604,3.91202300542815,3.87120101090789,1,0,0,1.8039,3,1.2513,LESS
5,50,45,5,95,45,50,3.91202300542815,3.80666248977032,0.105360515657826,7.71868549519847,3.80666248977032,3.91202300542815,1,1,1,1.2929,4,1.1343,LESS
5,168,150,18,318,150,168,5.12396397940326,5.01063529409626,0.113328685307003,10.1345992734995,5.01063529409626,5.12396397940326,1,1,1,1.7228,1,1.4352,LESS
5,59,50,9,109,50,59,4.07753744390572,3.91202300542815,0.165514438477574,7.98956044933387,3.91202300542815,4.07753744390572,1,1,1,1.1709,4,1.1017,LESS
5,100,84,16,184,84,100,4.60517018598809,4.43081679884331,0.174353387144778,9.03598698483141,4.43081679884331,4.60517018598809,1,1,1,0.8574,4,1.604,LESS
5,50,55,5,105,50,55,3.91202300542815,4.00733318523247,0.0953101798043252,7.91935619066062,3.91202300542815,4.00733318523247,0,0,1,0.9065,1,1.1184,LESS
5,150,144,6,294,150,144,5.01063529409626,4.969813299576,0.0408219945202548,9.98044859367226,5.01063529409626,4.969813299576,0,1,0,1.3107,1,1.3683,LESS
5,50,46,4,96,46,50,3.91202300542815,3.8286413964891,0.0833816089390509,7.74066440191724,3.8286413964891,3.91202300542815,1,1,1,1.6294,3,1.4345,LESS
5,177,150,27,327,150,177,5.17614973257383,5.01063529409626,0.165514438477573,10.1867850266701,5.01063529409626,5.17614973257383,1,1,1,1.2127,1,1.1209,LESS
5,88,100,12,188,88,100,4.47733681447821,4.60517018598809,0.127833371509885,9.0825070004663,4.47733681447821,4.60517018598809,0,0,1,0.8642,1,1.0678,LESS
5,120,150,30,270,120,150,4.78749174278205,5.01063529409626,0.22314355131421,9.7981270368783,4.78749174278205,5.01063529409626,0,0,1,1.0788,3,0.9678,LESS
5,100,98,2,198,100,98,4.60517018598809,4.58496747867057,0.0202027073175195,9.19013766465866,4.60517018598809,4.58496747867057,0,1,0,1.0528,2,1.0177,LESS
5,156,150,6,306,150,156,5.04985600724954,5.01063529409626,0.0392207131532816,10.0604913013458,5.01063529409626,5.04985600724954,1,1,1,0.9419,1,1.1005,LESS
5,50,51,1,101,50,51,3.91202300542815,3.93182563272433,0.0198026272961798,7.84384863815247,3.91202300542815,3.93182563272433,0,0,1,1.1188,4,1.1846,LESS
5,100,98,2,198,98,100,4.60517018598809,4.58496747867057,0.0202027073175195,9.19013766465866,4.58496747867057,4.60517018598809,1,1,1,1.1486,1,1.1011,LESS
5,150,132,18,282,132,150,5.01063529409626,4.88280192258637,0.127833371509885,9.89343721668263,4.88280192258637,5.01063529409626,1,1,1,1.0764,1,1.0177,LESS
5,100,86,14,186,86,100,4.60517018598809,4.45434729625351,0.150822889734584,9.0595174822416,4.45434729625351,4.60517018598809,1,1,1,1.4565,1,0.9772,LESS
5,159,150,9,309,150,159,5.06890420222023,5.01063529409626,0.058268908123976,10.0795394963165,5.01063529409626,5.06890420222023,1,1,1,0.9117,1,1.018,LESS
5,100,120,20,220,100,120,4.60517018598809,4.78749174278205,0.182321556793954,9.39266192877014,4.60517018598809,4.78749174278205,0,0,1,0.9916,1,0.9739,LESS
5,100,90,10,190,90,100,4.60517018598809,4.49980967033027,0.105360515657827,9.10497985631836,4.49980967033027,4.60517018598809,1,1,1,0.8644,2,1.0189,LESS
5,150,144,6,294,150,144,5.01063529409626,4.969813299576,0.0408219945202548,9.98044859367226,5.01063529409626,4.969813299576,0,1,0,1.1354,1,1.0346,LESS
5,50,58,8,108,50,58,3.91202300542815,4.06044301054642,0.148420005118273,7.97246601597456,3.91202300542815,4.06044301054642,0,0,1,0.9199,3,1.3347,LESS
5,100,114,14,214,100,114,4.60517018598809,4.7361984483945,0.131028262406404,9.34136863438259,4.60517018598809,4.7361984483945,0,0,1,0.9183,1,1.4181,LESS
5,41,50,9,91,41,50,3.71357206670431,3.91202300542815,0.198450938723838,7.62559507213245,3.71357206670431,3.91202300542815,0,0,1,1.2916,2,1.285,LESS
5,150,132,18,282,132,150,5.01063529409626,4.88280192258637,0.127833371509885,9.89343721668263,4.88280192258637,5.01063529409626,1,1,1,0.8654,4,1.3685,LESS
5,102,100,2,202,100,102,4.62497281328427,4.60517018598809,0.0198026272961789,9.23014299927236,4.60517018598809,4.62497281328427,1,1,1,1.1195,3,1.2387,LESS
5,50,42,8,92,42,50,3.91202300542815,3.73766961828337,0.174353387144778,7.64969262371151,3.73766961828337,3.91202300542815,1,1,1,1.9118,2,1.3013,LESS
5,90,100,10,190,100,90,4.49980967033027,4.60517018598809,0.105360515657827,9.10497985631836,4.60517018598809,4.49980967033027,1,0,0,1.7089,2,1.0679,LESS
5,150,147,3,297,147,150,5.01063529409626,4.99043258677874,0.0202027073175195,10.001067880875,4.99043258677874,5.01063529409626,1,1,1,0.9086,1,1.7094,LESS
5,150,171,21,321,171,150,5.01063529409626,5.14166355650266,0.131028262406405,10.1522988505989,5.14166355650266,5.01063529409626,1,0,0,0.9299,1,1.139,LESS
5,50,43,7,93,43,50,3.91202300542815,3.76120011569356,0.150822889734584,7.67322312112171,3.76120011569356,3.91202300542815,1,1,1,1.3521,4,1.1371,LESS
5,150,177,27,327,150,177,5.01063529409626,5.17614973257383,0.165514438477573,10.1867850266701,5.01063529409626,5.17614973257383,0,0,1,0.9547,2,1.0349,LESS
5,96,100,4,196,96,100,4.56434819146784,4.60517018598809,0.0408219945202557,9.16951837745593,4.56434819146784,4.60517018598809,0,0,1,2.2586,3,2.1355,LESS
5,144,150,6,294,150,144,4.969813299576,5.01063529409626,0.0408219945202548,9.98044859367226,5.01063529409626,4.969813299576,1,0,0,1.2802,1,1.2685,LESS
5,100,118,18,218,100,118,4.60517018598809,4.77068462446567,0.165514438477573,9.37585481045376,4.60517018598809,4.77068462446567,0,0,1,0.8514,4,1.1186,LESS
5,100,110,10,210,100,110,4.60517018598809,4.70048036579242,0.0953101798043248,9.30565055178051,4.60517018598809,4.70048036579242,0,0,1,0.8625,4,1.118,LESS
5,50,42,8,92,42,50,3.91202300542815,3.73766961828337,0.174353387144778,7.64969262371151,3.73766961828337,3.91202300542815,1,1,1,1.759,3,1.2188,LESS
5,174,150,24,324,150,174,5.15905529921453,5.01063529409626,0.148420005118274,10.1696905933108,5.01063529409626,5.15905529921453,1,1,1,0.9473,3,1.3512,LESS
5,150,120,30,270,120,150,5.01063529409626,4.78749174278205,0.22314355131421,9.7981270368783,4.78749174278205,5.01063529409626,1,1,1,1.8637,4,0.9177,LESS
5,150,180,30,330,150,180,5.01063529409626,5.19295685089021,0.182321556793955,10.2035921449865,5.01063529409626,5.19295685089021,0,0,1,1.0212,1,1.2195,LESS
5,118,100,18,218,100,118,4.77068462446567,4.60517018598809,0.165514438477573,9.37585481045376,4.60517018598809,4.77068462446567,1,1,1,0.9579,2,1.007,LESS
5,84,100,16,184,84,100,4.43081679884331,4.60517018598809,0.174353387144778,9.03598698483141,4.43081679884331,4.60517018598809,0,0,1,1.1726,2,1.0586,LESS
5,58,50,8,108,50,58,4.06044301054642,3.91202300542815,0.148420005118273,7.97246601597456,3.91202300542815,4.06044301054642,1,1,1,2.3363,3,1.2005,LESS
5,58,50,8,108,58,50,4.06044301054642,3.91202300542815,0.148420005118273,7.97246601597456,4.06044301054642,3.91202300542815,0,1,0,1.4212,2,1.1351,LESS
5,116,100,16,216,100,116,4.75359019110636,4.60517018598809,0.148420005118273,9.35876037709446,4.60517018598809,4.75359019110636,1,1,1,1.0967,3,1.1846,LESS
5,104,100,4,204,100,104,4.64439089914137,4.60517018598809,0.0392207131532807,9.24956108512946,4.60517018598809,4.64439089914137,1,1,1,1.0474,4,1.1909,LESS
5,144,150,6,294,144,150,4.969813299576,5.01063529409626,0.0408219945202548,9.98044859367226,4.969813299576,5.01063529409626,0,0,1,1.1797,2,1.1196,LESS
5,150,180,30,330,150,180,5.01063529409626,5.19295685089021,0.182321556793955,10.2035921449865,5.01063529409626,5.19295685089021,0,0,1,0.9764,3,1.2179,LESS
5,116,100,16,216,100,116,4.75359019110636,4.60517018598809,0.148420005118273,9.35876037709446,4.60517018598809,4.75359019110636,1,1,1,0.8693,4,1.1924,LESS
5,150,153,3,303,153,150,5.01063529409626,5.03043792139244,0.0198026272961798,10.0410732154887,5.03043792139244,5.01063529409626,1,0,0,2.3871,1,1.1351,LESS
5,153,150,3,303,153,150,5.03043792139244,5.01063529409626,0.0198026272961798,10.0410732154887,5.03043792139244,5.01063529409626,0,1,0,1.3319,2,1.1352,LESS
5,162,150,12,312,150,162,5.08759633523238,5.01063529409626,0.0769610411361281,10.0982316293286,5.01063529409626,5.08759633523238,1,1,1,0.8354,3,1.1539,LESS
5,50,41,9,91,41,50,3.91202300542815,3.71357206670431,0.198450938723838,7.62559507213245,3.71357206670431,3.91202300542815,1,1,1,2.1141,4,1.2685,LESS
5,100,82,18,182,100,82,4.60517018598809,4.40671924726425,0.198450938723838,9.01188943325235,4.60517018598809,4.40671924726425,0,1,0,0.9623,4,1.1347,LESS
5,50,47,3,97,50,47,3.91202300542815,3.85014760171006,0.0618754037180875,7.7621706071382,3.91202300542815,3.85014760171006,0,1,0,1.0512,4,1.4913,LESS
5,50,48,2,98,50,48,3.91202300542815,3.87120101090789,0.0408219945202548,7.78322401633604,3.91202300542815,3.87120101090789,0,1,0,1.1297,4,1.2853,LESS
5,100,104,4,204,100,104,4.60517018598809,4.64439089914137,0.0392207131532807,9.24956108512946,4.60517018598809,4.64439089914137,0,0,1,1.039,3,1.0742,LESS
5,150,159,9,309,159,150,5.01063529409626,5.06890420222023,0.058268908123976,10.0795394963165,5.06890420222023,5.01063529409626,1,0,0,1.2694,2,1.0685,LESS
5,44,50,6,94,44,50,3.78418963391826,3.91202300542815,0.127833371509885,7.69621263934641,3.78418963391826,3.91202300542815,0,0,1,0.9852,3,1.2424,LESS
5,50,58,8,108,50,58,3.91202300542815,4.06044301054642,0.148420005118273,7.97246601597456,3.91202300542815,4.06044301054642,0,0,1,1.2533,3,1.5861,LESS
5,100,102,2,202,102,100,4.60517018598809,4.62497281328427,0.0198026272961789,9.23014299927236,4.62497281328427,4.60517018598809,1,0,0,1.0988,2,1.0681,LESS
5,100,112,12,212,100,112,4.60517018598809,4.71849887129509,0.113328685307002,9.32366905728319,4.60517018598809,4.71849887129509,0,0,1,1.4337,1,1.1677,LESS
5,94,100,6,194,100,94,4.54329478227,4.60517018598809,0.061875403718088,9.1484649682581,4.60517018598809,4.54329478227,1,0,0,1.1954,1,1.1695,LESS
5,50,59,9,109,50,59,3.91202300542815,4.07753744390572,0.165514438477574,7.98956044933387,3.91202300542815,4.07753744390572,0,0,1,0.9397,3,1.1327,LESS
5,50,59,9,109,50,59,3.91202300542815,4.07753744390572,0.165514438477574,7.98956044933387,3.91202300542815,4.07753744390572,0,0,1,2.2217,3,1.6687,LESS
5,53,50,3,103,53,50,3.97029191355212,3.91202300542815,0.058268908123976,7.88231491898027,3.97029191355212,3.91202300542815,0,1,0,0.9288,3,1.118,LESS
5,150,159,9,309,150,159,5.01063529409626,5.06890420222023,0.058268908123976,10.0795394963165,5.01063529409626,5.06890420222023,0,0,1,0.9078,2,1.0035,LESS
5,100,106,6,206,106,100,4.60517018598809,4.66343909411207,0.0582689081239751,9.26860928010016,4.66343909411207,4.60517018598809,1,0,0,1.0529,1,1.2678,LESS
5,112,100,12,212,100,112,4.71849887129509,4.60517018598809,0.113328685307002,9.32366905728319,4.60517018598809,4.71849887129509,1,1,1,0.8967,2,1.035,LESS
5,165,150,15,315,150,165,5.10594547390058,5.01063529409626,0.0953101798043248,10.1165807679968,5.01063529409626,5.10594547390058,1,1,1,0.8936,2,1.1345,LESS
5,50,43,7,93,43,50,3.91202300542815,3.76120011569356,0.150822889734584,7.67322312112171,3.76120011569356,3.91202300542815,1,1,1,1.3131,3,1.0513,LESS
6,120,100,20,220,100,120,4.78749174278205,4.60517018598809,0.182321556793954,9.39266192877014,4.60517018598809,4.78749174278205,1,1,1,1.3341,3,2.2166,LESS
6,44,50,6,94,50,44,3.78418963391826,3.91202300542815,0.127833371509885,7.69621263934641,3.91202300542815,3.78418963391826,1,0,0,1.8836,2,0.7181,LESS
6,162,150,12,312,150,162,5.08759633523238,5.01063529409626,0.0769610411361281,10.0982316293286,5.01063529409626,5.08759633523238,1,1,1,1.6253,2,0.7885,LESS
6,53,50,3,103,53,50,3.97029191355212,3.91202300542815,0.058268908123976,7.88231491898027,3.97029191355212,3.91202300542815,0,1,0,1.9996,1,2.2859,LESS
6,162,150,12,312,150,162,5.08759633523238,5.01063529409626,0.0769610411361281,10.0982316293286,5.01063529409626,5.08759633523238,1,1,1,1.1031,4,0.913,LESS
6,86,100,14,186,86,100,4.45434729625351,4.60517018598809,0.150822889734584,9.0595174822416,4.45434729625351,4.60517018598809,0,0,1,1.0511,3,1.3672,LESS
6,60,50,10,110,50,60,4.0943445622221,3.91202300542815,0.182321556793954,8.00636756765025,3.91202300542815,4.0943445622221,1,1,1,1.1354,4,0.6717,LESS
6,104,100,4,204,100,104,4.64439089914137,4.60517018598809,0.0392207131532807,9.24956108512946,4.60517018598809,4.64439089914137,1,1,1,1.9762,2,0.7386,LESS
6,90,100,10,190,90,100,4.49980967033027,4.60517018598809,0.105360515657827,9.10497985631836,4.49980967033027,4.60517018598809,0,0,1,1.4886,3,1.0991,LESS
6,147,150,3,297,147,150,4.99043258677874,5.01063529409626,0.0202027073175195,10.001067880875,4.99043258677874,5.01063529409626,0,0,1,1.6498,1,0.9011,LESS
6,50,60,10,110,50,60,3.91202300542815,4.0943445622221,0.182321556793954,8.00636756765025,3.91202300542815,4.0943445622221,0,0,1,2.101,4,0.406,LESS
6,108,100,8,208,108,100,4.68213122712422,4.60517018598809,0.0769610411361281,9.28730141311231,4.68213122712422,4.60517018598809,0,1,0,1.3492,2,0.7029,LESS
6,50,59,9,109,50,59,3.91202300542815,4.07753744390572,0.165514438477574,7.98956044933387,3.91202300542815,4.07753744390572,0,0,1,1.6019,1,0.952,LESS
6,100,108,8,208,100,108,4.60517018598809,4.68213122712422,0.0769610411361281,9.28730141311231,4.60517018598809,4.68213122712422,0,0,1,1.5611,1,0.9297,LESS
6,50,43,7,93,43,50,3.91202300542815,3.76120011569356,0.150822889734584,7.67322312112171,3.76120011569356,3.91202300542815,1,1,1,1.1514,4,0.633,LESS
6,177,150,27,327,150,177,5.17614973257383,5.01063529409626,0.165514438477573,10.1867850266701,5.01063529409626,5.17614973257383,1,1,1,1.1719,3,1.232,LESS
6,150,144,6,294,144,150,5.01063529409626,4.969813299576,0.0408219945202548,9.98044859367226,4.969813299576,5.01063529409626,1,1,1,1.2624,2,0.7469,LESS
6,150,147,3,297,150,147,5.01063529409626,4.99043258677874,0.0202027073175195,10.001067880875,5.01063529409626,4.99043258677874,0,1,0,2.3555,1,0.8749,LESS
6,114,100,14,214,100,114,4.7361984483945,4.60517018598809,0.131028262406404,9.34136863438259,4.60517018598809,4.7361984483945,1,1,1,1.7614,1,1.4021,LESS
6,100,98,2,198,98,100,4.60517018598809,4.58496747867057,0.0202027073175195,9.19013766465866,4.58496747867057,4.60517018598809,1,1,1,1.6736,2,0.9006,LESS
6,88,100,12,188,88,100,4.47733681447821,4.60517018598809,0.127833371509885,9.0825070004663,4.47733681447821,4.60517018598809,0,0,1,1.3946,4,0.6462,LESS
6,50,49,1,99,49,50,3.91202300542815,3.89182029811063,0.0202027073175195,7.80384330353877,3.89182029811063,3.91202300542815,1,1,1,1.6751,2,0.7837,LESS
6,129,150,21,279,129,150,4.85981240436167,5.01063529409626,0.150822889734584,9.87044769845793,4.85981240436167,5.01063529409626,0,0,1,1.1866,3,0.9812,LESS
6,47,50,3,97,50,47,3.85014760171006,3.91202300542815,0.0618754037180875,7.7621706071382,3.91202300542815,3.85014760171006,1,0,0,1.8112,3,1.2237,LESS
6,150,165,15,315,150,165,5.01063529409626,5.10594547390058,0.0953101798043248,10.1165807679968,5.01063529409626,5.10594547390058,0,0,1,1.3243,2,0.9892,LESS
6,153,150,3,303,150,153,5.03043792139244,5.01063529409626,0.0198026272961798,10.0410732154887,5.01063529409626,5.03043792139244,1,1,1,2.1064,2,0.817,LESS
6,150,156,6,306,150,156,5.01063529409626,5.04985600724954,0.0392207131532816,10.0604913013458,5.01063529409626,5.04985600724954,0,0,1,1.6524,1,0.8587,LESS
6,50,44,6,94,50,44,3.91202300542815,3.78418963391826,0.127833371509885,7.69621263934641,3.91202300542815,3.78418963391826,0,1,0,1.5358,2,0.8852,LESS
6,150,138,12,288,138,150,5.01063529409626,4.92725368515721,0.0833816089390504,9.93788897925346,4.92725368515721,5.01063529409626,1,1,1,1.1865,3,1.3662,LESS
6,100,94,6,194,100,94,4.60517018598809,4.54329478227,0.061875403718088,9.1484649682581,4.60517018598809,4.54329478227,0,1,0,1.804,4,0.9675,LESS
6,165,150,15,315,150,165,5.10594547390058,5.01063529409626,0.0953101798043248,10.1165807679968,5.01063529409626,5.10594547390058,1,1,1,1.4264,4,0.5999,LESS
6,120,150,30,270,120,150,4.78749174278205,5.01063529409626,0.22314355131421,9.7981270368783,4.78749174278205,5.01063529409626,0,0,1,1.5567,4,0.5553,LESS
6,100,114,14,214,114,100,4.60517018598809,4.7361984483945,0.131028262406404,9.34136863438259,4.7361984483945,4.60517018598809,1,0,0,1.8182,2,0.5817,LESS
6,123,150,27,273,123,150,4.81218435537242,5.01063529409626,0.198450938723838,9.82281964946867,4.81218435537242,5.01063529409626,0,0,1,1.3882,4,0.5163,LESS
6,49,50,1,99,50,49,3.89182029811063,3.91202300542815,0.0202027073175195,7.80384330353877,3.91202300542815,3.89182029811063,1,0,0,1.3506,2,0.8063,LESS
6,50,59,9,109,59,50,3.91202300542815,4.07753744390572,0.165514438477574,7.98956044933387,4.07753744390572,3.91202300542815,1,0,0,1.2265,2,1.4643,LESS
6,50,58,8,108,50,58,3.91202300542815,4.06044301054642,0.148420005118273,7.97246601597456,3.91202300542815,4.06044301054642,0,0,1,1.3258,4,0.6348,LESS
6,100,98,2,198,100,98,4.60517018598809,4.58496747867057,0.0202027073175195,9.19013766465866,4.60517018598809,4.58496747867057,0,1,0,1.6603,2,0.6408,LESS
6,150,135,15,285,135,150,5.01063529409626,4.90527477843843,0.105360515657826,9.91591007253469,4.90527477843843,5.01063529409626,1,1,1,1.3245,3,0.6672,LESS
6,168,150,18,318,150,168,5.12396397940326,5.01063529409626,0.113328685307003,10.1345992734995,5.01063529409626,5.12396397940326,1,1,1,1.5749,1,0.6503,LESS
6,42,50,8,92,42,50,3.73766961828337,3.91202300542815,0.174353387144778,7.64969262371151,3.73766961828337,3.91202300542815,0,0,1,1.0594,4,0.6363,LESS
6,45,50,5,95,45,50,3.80666248977032,3.91202300542815,0.105360515657826,7.71868549519847,3.80666248977032,3.91202300542815,0,0,1,1.094,1,0.6164,LESS
6,150,171,21,321,150,171,5.01063529409626,5.14166355650266,0.131028262406405,10.1522988505989,5.01063529409626,5.14166355650266,0,0,1,1.1843,3,1.3679,LESS
6,100,112,12,212,112,100,4.60517018598809,4.71849887129509,0.113328685307002,9.32366905728319,4.71849887129509,4.60517018598809,1,0,0,1.1336,3,0.7636,LESS
6,150,120,30,270,120,150,5.01063529409626,4.78749174278205,0.22314355131421,9.7981270368783,4.78749174278205,5.01063529409626,1,1,1,0.9941,4,0.6331,LESS
6,116,100,16,216,100,116,4.75359019110636,4.60517018598809,0.148420005118273,9.35876037709446,4.60517018598809,4.75359019110636,1,1,1,1.2057,2,0.6508,LESS
6,100,112,12,212,112,100,4.60517018598809,4.71849887129509,0.113328685307002,9.32366905728319,4.71849887129509,4.60517018598809,1,0,0,1.4428,1,0.8173,LESS
6,150,129,21,279,129,150,5.01063529409626,4.85981240436167,0.150822889734584,9.87044769845793,4.85981240436167,5.01063529409626,1,1,1,1.0979,2,0.7707,LESS
6,48,50,2,98,48,50,3.87120101090789,3.91202300542815,0.0408219945202548,7.78322401633604,3.87120101090789,3.91202300542815,0,0,1,1.3531,3,0.8522,LESS
6,100,94,6,194,94,100,4.60517018598809,4.54329478227,0.061875403718088,9.1484649682581,4.54329478227,4.60517018598809,1,1,1,1.1529,3,0.7049,LESS
6,40,50,10,90,40,50,3.68887945411394,3.91202300542815,0.22314355131421,7.60090245954208,3.68887945411394,3.91202300542815,0,0,1,1.2231,4,0.841,LESS
6,82,100,18,182,82,100,4.40671924726425,4.60517018598809,0.198450938723838,9.01188943325235,4.40671924726425,4.60517018598809,0,0,1,1.2344,4,0.931,LESS
6,126,150,24,276,126,150,4.83628190695148,5.01063529409626,0.174353387144778,9.84691720104773,4.83628190695148,5.01063529409626,0,0,1,1.0034,4,0.6485,LESS
6,150,141,9,291,141,150,5.01063529409626,4.94875989037817,0.0618754037180871,9.95939518447442,4.94875989037817,5.01063529409626,1,1,1,1.1137,3,0.6338,LESS
6,153,150,3,303,153,150,5.03043792139244,5.01063529409626,0.0198026272961798,10.0410732154887,5.03043792139244,5.01063529409626,0,1,0,1.1899,2,0.875,LESS
6,150,123,27,273,123,150,5.01063529409626,4.81218435537242,0.198450938723838,9.82281964946867,4.81218435537242,5.01063529409626,1,1,1,1.0081,4,0.4493,LESS
6,100,96,4,196,96,100,4.60517018598809,4.56434819146784,0.0408219945202557,9.16951837745593,4.56434819146784,4.60517018598809,1,1,1,1.1805,3,0.6143,LESS
6,42,50,8,92,42,50,3.73766961828337,3.91202300542815,0.174353387144778,7.64969262371151,3.73766961828337,3.91202300542815,0,0,1,1.336,1,0.7496,LESS
6,100,120,20,220,100,120,4.60517018598809,4.78749174278205,0.182321556793954,9.39266192877014,4.60517018598809,4.78749174278205,0,0,1,1.1477,4,0.8007,LESS
6,104,100,4,204,104,100,4.64439089914137,4.60517018598809,0.0392207131532807,9.24956108512946,4.64439089914137,4.60517018598809,0,1,0,1.2394,4,1.8847,LESS
6,100,80,20,180,80,100,4.60517018598809,4.38202663467388,0.223143551314211,8.98719682066197,4.38202663467388,4.60517018598809,1,1,1,1.5075,4,0.4229,LESS
6,100,82,18,182,82,100,4.60517018598809,4.40671924726425,0.198450938723838,9.01188943325235,4.40671924726425,4.60517018598809,1,1,1,1.0576,3,0.5209,LESS
6,120,100,20,220,120,100,4.78749174278205,4.60517018598809,0.182321556793954,9.39266192877014,4.78749174278205,4.60517018598809,0,1,0,1.7199,1,1.0505,LESS
6,100,90,10,190,90,100,4.60517018598809,4.49980967033027,0.105360515657827,9.10497985631836,4.49980967033027,4.60517018598809,1,1,1,1.3968,2,0.9001,LESS
6,150,147,3,297,150,147,5.01063529409626,4.99043258677874,0.0202027073175195,10.001067880875,5.01063529409626,4.99043258677874,0,1,0,1.6242,2,0.7844,LESS
6,50,48,2,98,50,48,3.91202300542815,3.87120101090789,0.0408219945202548,7.78322401633604,3.91202300542815,3.87120101090789,0,1,0,1.4549,2,0.9511,LESS
6,150,180,30,330,150,180,5.01063529409626,5.19295685089021,0.182321556793955,10.2035921449865,5.01063529409626,5.19295685089021,0,0,1,1.1868,4,0.9826,LESS
6,50,42,8,92,42,50,3.91202300542815,3.73766961828337,0.174353387144778,7.64969262371151,3.73766961828337,3.91202300542815,1,1,1,1.3391,3,0.5665,LESS
6,47,50,3,97,47,50,3.85014760171006,3.91202300542815,0.0618754037180875,7.7621706071382,3.85014760171006,3.91202300542815,0,0,1,1.2959,4,0.6662,LESS
6,50,57,7,107,50,57,3.91202300542815,4.04305126783455,0.131028262406404,7.9550742732627,3.91202300542815,4.04305126783455,0,0,1,1.6467,3,0.9,LESS
6,88,100,12,188,88,100,4.47733681447821,4.60517018598809,0.127833371509885,9.0825070004663,4.47733681447821,4.60517018598809,0,0,1,1.7397,4,0.4006,LESS
6,110,100,10,210,100,110,4.70048036579242,4.60517018598809,0.0953101798043248,9.30565055178051,4.60517018598809,4.70048036579242,1,1,1,1.0807,4,0.4841,LESS
6,50,56,6,106,50,56,3.91202300542815,4.02535169073515,0.113328685307004,7.9373746961633,3.91202300542815,4.02535169073515,0,0,1,1.0961,4,0.5188,LESS
6,135,150,15,285,135,150,4.90527477843843,5.01063529409626,0.105360515657826,9.91591007253469,4.90527477843843,5.01063529409626,0,0,1,1.3264,3,0.5508,LESS
6,135,150,15,285,135,150,4.90527477843843,5.01063529409626,0.105360515657826,9.91591007253469,4.90527477843843,5.01063529409626,0,0,1,1.1072,4,0.7833,LESS
6,150,120,30,270,120,150,5.01063529409626,4.78749174278205,0.22314355131421,9.7981270368783,4.78749174278205,5.01063529409626,1,1,1,1.1322,3,0.5504,LESS
6,100,110,10,210,100,110,4.60517018598809,4.70048036579242,0.0953101798043248,9.30565055178051,4.60517018598809,4.70048036579242,0,0,1,1.0772,3,1.1298,LESS
6,138,150,12,288,138,150,4.92725368515721,5.01063529409626,0.0833816089390504,9.93788897925346,4.92725368515721,5.01063529409626,0,0,1,1.5874,2,0.5506,LESS
6,141,150,9,291,141,150,4.94875989037817,5.01063529409626,0.0618754037180871,9.95939518447442,4.94875989037817,5.01063529409626,0,0,1,1.4459,3,0.7811,LESS
6,96,100,4,196,96,100,4.56434819146784,4.60517018598809,0.0408219945202557,9.16951837745593,4.56434819146784,4.60517018598809,0,0,1,1.0353,3,0.786,LESS
6,159,150,9,309,150,159,5.06890420222023,5.01063529409626,0.058268908123976,10.0795394963165,5.01063529409626,5.06890420222023,1,1,1,1.1669,1,0.9121,LESS
6,86,100,14,186,86,100,4.45434729625351,4.60517018598809,0.150822889734584,9.0595174822416,4.45434729625351,4.60517018598809,0,0,1,1.0423,2,0.822,LESS
6,150,180,30,330,150,180,5.01063529409626,5.19295685089021,0.182321556793955,10.2035921449865,5.01063529409626,5.19295685089021,0,0,1,1.3605,2,0.7836,LESS
6,144,150,6,294,144,150,4.969813299576,5.01063529409626,0.0408219945202548,9.98044859367226,4.969813299576,5.01063529409626,0,0,1,1.5257,2,0.6976,LESS
6,123,150,27,273,123,150,4.81218435537242,5.01063529409626,0.198450938723838,9.82281964946867,4.81218435537242,5.01063529409626,0,0,1,1.1289,3,1.2187,LESS
6,171,150,21,321,150,171,5.14166355650266,5.01063529409626,0.131028262406405,10.1522988505989,5.01063529409626,5.14166355650266,1,1,1,1.806,1,1.1378,LESS
6,94,100,6,194,100,94,4.54329478227,4.60517018598809,0.061875403718088,9.1484649682581,4.60517018598809,4.54329478227,1,0,0,1.4332,2,0.8509,LESS
6,90,100,10,190,90,100,4.49980967033027,4.60517018598809,0.105360515657827,9.10497985631836,4.49980967033027,4.60517018598809,0,0,1,1.2956,3,1.2726,LESS
6,50,45,5,95,45,50,3.91202300542815,3.80666248977032,0.105360515657826,7.71868549519847,3.80666248977032,3.91202300542815,1,1,1,1.3208,3,0.7026,LESS
6,100,92,8,192,100,92,4.60517018598809,4.52178857704904,0.0833816089390513,9.12695876303713,4.60517018598809,4.52178857704904,0,1,0,1.2203,4,0.7469,LESS
6,58,50,8,108,50,58,4.06044301054642,3.91202300542815,0.148420005118273,7.97246601597456,3.91202300542815,4.06044301054642,1,1,1,1.3397,3,0.9667,LESS
6,150,162,12,312,150,162,5.01063529409626,5.08759633523238,0.0769610411361281,10.0982316293286,5.01063529409626,5.08759633523238,0,0,1,1.1437,3,1.1166,LESS
6,177,150,27,327,150,177,5.17614973257383,5.01063529409626,0.165514438477573,10.1867850266701,5.01063529409626,5.17614973257383,1,1,1,0.9565,4,0.4952,LESS
6,144,150,6,294,150,144,4.969813299576,5.01063529409626,0.0408219945202548,9.98044859367226,5.01063529409626,4.969813299576,1,0,0,1.3475,2,0.8552,LESS
6,55,50,5,105,55,50,4.00733318523247,3.91202300542815,0.0953101798043252,7.91935619066062,4.00733318523247,3.91202300542815,0,1,0,1.3234,3,1.1404,LESS
6,150,129,21,279,129,150,5.01063529409626,4.85981240436167,0.150822889734584,9.87044769845793,4.85981240436167,5.01063529409626,1,1,1,1.0616,4,0.6489,LESS
6,141,150,9,291,150,141,4.94875989037817,5.01063529409626,0.0618754037180871,9.95939518447442,5.01063529409626,4.94875989037817,1,0,0,1.4046,2,1.0201,LESS
6,150,177,27,327,177,150,5.01063529409626,5.17614973257383,0.165514438477573,10.1867850266701,5.17614973257383,5.01063529409626,1,0,0,1.553,1,0.7506,LESS
6,50,44,6,94,44,50,3.91202300542815,3.78418963391826,0.127833371509885,7.69621263934641,3.78418963391826,3.91202300542815,1,1,1,1.3517,3,0.9345,LESS
6,114,100,14,214,100,114,4.7361984483945,4.60517018598809,0.131028262406404,9.34136863438259,4.60517018598809,4.7361984483945,1,1,1,1.1972,3,0.8839,LESS
6,50,60,10,110,50,60,3.91202300542815,4.0943445622221,0.182321556793954,8.00636756765025,3.91202300542815,4.0943445622221,0,0,1,1.3166,4,0.8896,LESS
6,150,165,15,315,150,165,5.01063529409626,5.10594547390058,0.0953101798043248,10.1165807679968,5.01063529409626,5.10594547390058,0,0,1,1.2321,4,0.566,LESS
6,41,50,9,91,41,50,3.71357206670431,3.91202300542815,0.198450938723838,7.62559507213245,3.71357206670431,3.91202300542815,0,0,1,1.014,4,0.834,LESS
6,156,150,6,306,150,156,5.04985600724954,5.01063529409626,0.0392207131532816,10.0604913013458,5.01063529409626,5.04985600724954,1,1,1,1.1857,3,0.5694,LESS
6,53,50,3,103,53,50,3.97029191355212,3.91202300542815,0.058268908123976,7.88231491898027,3.97029191355212,3.91202300542815,0,1,0,2.2521,1,0.7842,LESS
6,50,57,7,107,50,57,3.91202300542815,4.04305126783455,0.131028262406404,7.9550742732627,3.91202300542815,4.04305126783455,0,0,1,2.4428,2,0.7167,LESS
6,100,86,14,186,86,100,4.60517018598809,4.45434729625351,0.150822889734584,9.0595174822416,4.45434729625351,4.60517018598809,1,1,1,1.0161,4,0.6659,LESS
6,46,50,4,96,46,50,3.8286413964891,3.91202300542815,0.0833816089390509,7.74066440191724,3.8286413964891,3.91202300542815,0,0,1,1.1424,4,0.7502,LESS
6,40,50,10,90,40,50,3.68887945411394,3.91202300542815,0.22314355131421,7.60090245954208,3.68887945411394,3.91202300542815,0,0,1,1.2042,3,1.6204,LESS
6,41,50,9,91,41,50,3.71357206670431,3.91202300542815,0.198450938723838,7.62559507213245,3.71357206670431,3.91202300542815,0,0,1,1.4506,4,0.6662,LESS
6,138,150,12,288,150,138,4.92725368515721,5.01063529409626,0.0833816089390504,9.93788897925346,5.01063529409626,4.92725368515721,1,0,0,2.0165,1,0.8003,LESS
6,58,50,8,108,58,50,4.06044301054642,3.91202300542815,0.148420005118273,7.97246601597456,4.06044301054642,3.91202300542815,0,1,0,1.5549,2,0.7869,LESS
6,100,102,2,202,100,102,4.60517018598809,4.62497281328427,0.0198026272961789,9.23014299927236,4.60517018598809,4.62497281328427,0,0,1,1.5073,4,0.9035,LESS
6,50,46,4,96,46,50,3.91202300542815,3.8286413964891,0.0833816089390509,7.74066440191724,3.8286413964891,3.91202300542815,1,1,1,3.8176,1,0.8175,LESS
6,50,49,1,99,50,49,3.91202300542815,3.89182029811063,0.0202027073175195,7.80384330353877,3.91202300542815,3.89182029811063,0,1,0,1.1424,3,0.7317,LESS
6,100,88,12,188,88,100,4.60517018598809,4.47733681447821,0.127833371509885,9.0825070004663,4.47733681447821,4.60517018598809,1,1,1,1.4142,1,0.984,LESS
6,150,174,24,324,150,174,5.01063529409626,5.15905529921453,0.148420005118274,10.1696905933108,5.01063529409626,5.15905529921453,0,0,1,1.1449,4,0.8043,LESS
6,150,123,27,273,123,150,5.01063529409626,4.81218435537242,0.198450938723838,9.82281964946867,4.81218435537242,5.01063529409626,1,1,1,0.9879,4,0.4979,LESS
6,165,150,15,315,150,165,5.10594547390058,5.01063529409626,0.0953101798043248,10.1165807679968,5.01063529409626,5.10594547390058,1,1,1,1.4349,3,0.6721,LESS
6,150,156,6,306,150,156,5.01063529409626,5.04985600724954,0.0392207131532816,10.0604913013458,5.01063529409626,5.04985600724954,0,0,1,1.1051,2,1.4682,LESS
6,159,150,9,309,159,150,5.06890420222023,5.01063529409626,0.058268908123976,10.0795394963165,5.06890420222023,5.01063529409626,0,1,0,1.1199,4,1.3975,LESS
6,45,50,5,95,45,50,3.80666248977032,3.91202300542815,0.105360515657826,7.71868549519847,3.80666248977032,3.91202300542815,0,0,1,1.1183,3,0.7222,LESS
6,50,52,2,102,50,52,3.91202300542815,3.95124371858143,0.0392207131532816,7.86326672400957,3.91202300542815,3.95124371858143,0,0,1,1.1796,3,1.4494,LESS
6,80,100,20,180,80,100,4.38202663467388,4.60517018598809,0.223143551314211,8.98719682066197,4.38202663467388,4.60517018598809,0,0,1,0.9999,3,0.9454,LESS
6,100,114,14,214,100,114,4.60517018598809,4.7361984483945,0.131028262406404,9.34136863438259,4.60517018598809,4.7361984483945,0,0,1,1.7383,2,0.6848,LESS
6,84,100,16,184,84,100,4.43081679884331,4.60517018598809,0.174353387144778,9.03598698483141,4.43081679884331,4.60517018598809,0,0,1,1.0499,4,0.8185,LESS
6,50,54,4,104,50,54,3.91202300542815,3.98898404656427,0.0769610411361286,7.90100705199242,3.91202300542815,3.98898404656427,0,0,1,1.2391,3,0.8872,LESS
6,46,50,4,96,46,50,3.8286413964891,3.91202300542815,0.0833816089390509,7.74066440191724,3.8286413964891,3.91202300542815,0,0,1,1.2893,3,0.9,LESS
6,126,150,24,276,126,150,4.83628190695148,5.01063529409626,0.174353387144778,9.84691720104773,4.83628190695148,5.01063529409626,0,0,1,1.19,4,0.7803,LESS
6,112,100,12,212,100,112,4.71849887129509,4.60517018598809,0.113328685307002,9.32366905728319,4.60517018598809,4.71849887129509,1,1,1,1.5755,1,0.6507,LESS
6,100,116,16,216,100,116,4.60517018598809,4.75359019110636,0.148420005118273,9.35876037709446,4.60517018598809,4.75359019110636,0,0,1,1.1011,4,0.7499,LESS
6,174,150,24,324,150,174,5.15905529921453,5.01063529409626,0.148420005118274,10.1696905933108,5.01063529409626,5.15905529921453,1,1,1,1.8043,1,0.586,LESS
6,102,100,2,202,100,102,4.62497281328427,4.60517018598809,0.0198026272961789,9.23014299927236,4.60517018598809,4.62497281328427,1,1,1,1.377,2,0.7052,LESS
6,50,42,8,92,42,50,3.91202300542815,3.73766961828337,0.174353387144778,7.64969262371151,3.73766961828337,3.91202300542815,1,1,1,1.5914,1,0.6166,LESS
6,150,162,12,312,150,162,5.01063529409626,5.08759633523238,0.0769610411361281,10.0982316293286,5.01063529409626,5.08759633523238,0,0,1,1.0064,3,0.6648,LESS
6,150,174,24,324,150,174,5.01063529409626,5.15905529921453,0.148420005118274,10.1696905933108,5.01063529409626,5.15905529921453,0,0,1,2.2975,1,0.4671,LESS
6,100,92,8,192,92,100,4.60517018598809,4.52178857704904,0.0833816089390513,9.12695876303713,4.52178857704904,4.60517018598809,1,1,1,1.5878,2,1.3143,LESS
6,51,50,1,101,50,51,3.93182563272433,3.91202300542815,0.0198026272961798,7.84384863815247,3.91202300542815,3.93182563272433,1,1,1,1.3148,1,0.788,LESS
6,112,100,12,212,100,112,4.71849887129509,4.60517018598809,0.113328685307002,9.32366905728319,4.60517018598809,4.71849887129509,1,1,1,1.1454,4,0.5196,LESS
6,106,100,6,206,106,100,4.66343909411207,4.60517018598809,0.0582689081239751,9.26860928010016,4.66343909411207,4.60517018598809,0,1,0,1.1294,2,0.9,LESS
6,116,100,16,216,100,116,4.75359019110636,4.60517018598809,0.148420005118273,9.35876037709446,4.60517018598809,4.75359019110636,1,1,1,1.0861,4,0.4656,LESS
6,50,56,6,106,50,56,3.91202300542815,4.02535169073515,0.113328685307004,7.9373746961633,3.91202300542815,4.02535169073515,0,0,1,1.7066,2,0.551,LESS
6,50,54,4,104,50,54,3.91202300542815,3.98898404656427,0.0769610411361286,7.90100705199242,3.91202300542815,3.98898404656427,0,0,1,1.2836,3,1.0114,LESS
6,52,50,2,102,52,50,3.95124371858143,3.91202300542815,0.0392207131532816,7.86326672400957,3.95124371858143,3.91202300542815,0,1,0,1.2564,3,0.8563,LESS
6,100,118,18,218,100,118,4.60517018598809,4.77068462446567,0.165514438477573,9.37585481045376,4.60517018598809,4.77068462446567,0,0,1,1.212,4,0.4729,LESS
6,100,80,20,180,80,100,4.60517018598809,4.38202663467388,0.223143551314211,8.98719682066197,4.38202663467388,4.60517018598809,1,1,1,0.9237,4,0.4032,LESS
6,100,106,6,206,100,106,4.60517018598809,4.66343909411207,0.0582689081239751,9.26860928010016,4.60517018598809,4.66343909411207,0,0,1,1.241,1,0.6339,LESS
6,56,50,6,106,50,56,4.02535169073515,3.91202300542815,0.113328685307004,7.9373746961633,3.91202300542815,4.02535169073515,1,1,1,1.2607,3,0.584,LESS
6,106,100,6,206,100,106,4.66343909411207,4.60517018598809,0.0582689081239751,9.26860928010016,4.60517018598809,4.66343909411207,1,1,1,1.0762,3,0.6003,LESS
6,50,41,9,91,50,41,3.91202300542815,3.71357206670431,0.198450938723838,7.62559507213245,3.91202300542815,3.71357206670431,0,1,0,2.453,1,0.3344,LESS
6,50,41,9,91,41,50,3.91202300542815,3.71357206670431,0.198450938723838,7.62559507213245,3.71357206670431,3.91202300542815,1,1,1,0.8792,4,0.6665,LESS
6,100,118,18,218,100,118,4.60517018598809,4.77068462446567,0.165514438477573,9.37585481045376,4.60517018598809,4.77068462446567,0,0,1,1.6775,2,0.4362,LESS
6,55,50,5,105,50,55,4.00733318523247,3.91202300542815,0.0953101798043252,7.91935619066062,3.91202300542815,4.00733318523247,1,1,1,1.3879,3,0.4841,LESS
6,150,153,3,303,150,153,5.01063529409626,5.03043792139244,0.0198026272961798,10.0410732154887,5.01063529409626,5.03043792139244,0,0,1,1.2252,2,0.4458,LESS
6,180,150,30,330,150,180,5.19295685089021,5.01063529409626,0.182321556793955,10.2035921449865,5.01063529409626,5.19295685089021,1,1,1,1.1048,4,0.5292,LESS
6,48,50,2,98,48,50,3.87120101090789,3.91202300542815,0.0408219945202548,7.78322401633604,3.87120101090789,3.91202300542815,0,0,1,1.4042,1,0.4666,LESS
6,50,40,10,90,40,50,3.91202300542815,3.68887945411394,0.22314355131421,7.60090245954208,3.68887945411394,3.91202300542815,1,1,1,1.3259,3,0.5517,LESS
6,60,50,10,110,50,60,4.0943445622221,3.91202300542815,0.182321556793954,8.00636756765025,3.91202300542815,4.0943445622221,1,1,1,1.2606,3,0.5049,LESS
6,96,100,4,196,96,100,4.56434819146784,4.60517018598809,0.0408219945202557,9.16951837745593,4.56434819146784,4.60517018598809,0,0,1,1.0665,4,0.7181,LESS
6,100,116,16,216,100,116,4.60517018598809,4.75359019110636,0.148420005118273,9.35876037709446,4.60517018598809,4.75359019110636,0,0,1,1.1627,2,0.7834,LESS
6,50,40,10,90,40,50,3.91202300542815,3.68887945411394,0.22314355131421,7.60090245954208,3.68887945411394,3.91202300542815,1,1,1,1.0525,3,1.0688,LESS
6,50,53,3,103,50,53,3.91202300542815,3.97029191355212,0.058268908123976,7.88231491898027,3.91202300542815,3.97029191355212,0,0,1,0.9563,4,1.1475,LESS
6,100,96,4,196,100,96,4.60517018598809,4.56434819146784,0.0408219945202557,9.16951837745593,4.60517018598809,4.56434819146784,0,1,0,1.0352,3,0.9521,LESS
6,168,150,18,318,168,150,5.12396397940326,5.01063529409626,0.113328685307003,10.1345992734995,5.12396397940326,5.01063529409626,0,1,0,1.2679,2,0.4322,LESS
6,150,144,6,294,150,144,5.01063529409626,4.969813299576,0.0408219945202548,9.98044859367226,5.01063529409626,4.969813299576,0,1,0,1.0246,2,0.4014,LESS
6,100,108,8,208,100,108,4.60517018598809,4.68213122712422,0.0769610411361281,9.28730141311231,4.60517018598809,4.68213122712422,0,0,1,1.6214,1,0.7733,LESS
6,100,82,18,182,82,100,4.60517018598809,4.40671924726425,0.198450938723838,9.01188943325235,4.40671924726425,4.60517018598809,1,1,1,1.036,4,0.4001,LESS
6,51,50,1,101,51,50,3.93182563272433,3.91202300542815,0.0198026272961798,7.84384863815247,3.93182563272433,3.91202300542815,0,1,0,1.2554,1,0.5175,LESS
6,43,50,7,93,43,50,3.76120011569356,3.91202300542815,0.150822889734584,7.67322312112171,3.76120011569356,3.91202300542815,0,0,1,1.9614,2,0.45,LESS
6,98,100,2,198,100,98,4.58496747867057,4.60517018598809,0.0202027073175195,9.19013766465866,4.60517018598809,4.58496747867057,1,0,0,0.9977,4,0.4223,LESS
6,52,50,2,102,52,50,3.95124371858143,3.91202300542815,0.0392207131532816,7.86326672400957,3.95124371858143,3.91202300542815,0,1,0,1.2203,4,0.5681,LESS
6,50,47,3,97,50,47,3.91202300542815,3.85014760171006,0.0618754037180875,7.7621706071382,3.91202300542815,3.85014760171006,0,1,0,1.7575,2,0.6181,LESS
6,174,150,24,324,150,174,5.15905529921453,5.01063529409626,0.148420005118274,10.1696905933108,5.01063529409626,5.15905529921453,1,1,1,1.0307,4,0.3999,LESS
6,150,132,18,282,132,150,5.01063529409626,4.88280192258637,0.127833371509885,9.89343721668263,4.88280192258637,5.01063529409626,1,1,1,0.9777,4,0.3981,LESS
6,129,150,21,279,129,150,4.85981240436167,5.01063529409626,0.150822889734584,9.87044769845793,4.85981240436167,5.01063529409626,0,0,1,0.9606,4,0.496,LESS
6,80,100,20,180,80,100,4.38202663467388,4.60517018598809,0.223143551314211,8.98719682066197,4.38202663467388,4.60517018598809,0,0,1,1.1293,2,0.7865,LESS
6,57,50,7,107,50,57,4.04305126783455,3.91202300542815,0.131028262406404,7.9550742732627,3.91202300542815,4.04305126783455,1,1,1,1.0956,3,1.1178,LESS
6,44,50,6,94,44,50,3.78418963391826,3.91202300542815,0.127833371509885,7.69621263934641,3.78418963391826,3.91202300542815,0,0,1,1.3283,4,0.4285,LESS
6,50,55,5,105,55,50,3.91202300542815,4.00733318523247,0.0953101798043252,7.91935619066062,4.00733318523247,3.91202300542815,1,0,0,1.1728,3,0.746,LESS
6,100,106,6,206,100,106,4.60517018598809,4.66343909411207,0.0582689081239751,9.26860928010016,4.60517018598809,4.66343909411207,0,0,1,1.4102,4,0.5535,LESS
6,54,50,4,104,54,50,3.98898404656427,3.91202300542815,0.0769610411361286,7.90100705199242,3.98898404656427,3.91202300542815,0,1,0,1.2025,2,0.4504,LESS
6,150,177,27,327,150,177,5.01063529409626,5.17614973257383,0.165514438477573,10.1867850266701,5.01063529409626,5.17614973257383,0,0,1,1.5989,1,0.3994,LESS
6,50,51,1,101,50,51,3.91202300542815,3.93182563272433,0.0198026272961798,7.84384863815247,3.91202300542815,3.93182563272433,0,0,1,1.5684,1,0.4181,LESS
6,92,100,8,192,92,100,4.52178857704904,4.60517018598809,0.0833816089390513,9.12695876303713,4.52178857704904,4.60517018598809,0,0,1,1.1637,2,0.8136,LESS
6,59,50,9,109,50,59,4.07753744390572,3.91202300542815,0.165514438477574,7.98956044933387,3.91202300542815,4.07753744390572,1,1,1,0.9916,4,0.4054,LESS
6,100,102,2,202,102,100,4.60517018598809,4.62497281328427,0.0198026272961789,9.23014299927236,4.62497281328427,4.60517018598809,1,0,0,2.1812,1,0.517,LESS
6,100,84,16,184,84,100,4.60517018598809,4.43081679884331,0.174353387144778,9.03598698483141,4.43081679884331,4.60517018598809,1,1,1,0.8067,4,0.3791,LESS
6,94,100,6,194,94,100,4.54329478227,4.60517018598809,0.061875403718088,9.1484649682581,4.54329478227,4.60517018598809,0,0,1,1.1909,2,0.484,LESS
6,50,51,1,101,51,50,3.91202300542815,3.93182563272433,0.0198026272961798,7.84384863815247,3.93182563272433,3.91202300542815,1,0,0,1.0302,3,0.6337,LESS
6,50,48,2,98,48,50,3.91202300542815,3.87120101090789,0.0408219945202548,7.78322401633604,3.87120101090789,3.91202300542815,1,1,1,1.4997,2,0.9497,LESS
6,150,168,18,318,150,168,5.01063529409626,5.12396397940326,0.113328685307003,10.1345992734995,5.01063529409626,5.12396397940326,0,0,1,1.0982,2,0.5305,LESS
6,57,50,7,107,50,57,4.04305126783455,3.91202300542815,0.131028262406404,7.9550742732627,3.91202300542815,4.04305126783455,1,1,1,1.1796,3,1.0175,LESS
6,100,90,10,190,90,100,4.60517018598809,4.49980967033027,0.105360515657827,9.10497985631836,4.49980967033027,4.60517018598809,1,1,1,0.8843,4,0.3465,LESS
6,50,47,3,97,47,50,3.91202300542815,3.85014760171006,0.0618754037180875,7.7621706071382,3.85014760171006,3.91202300542815,1,1,1,1.0572,2,0.5472,LESS
6,50,43,7,93,43,50,3.91202300542815,3.76120011569356,0.150822889734584,7.67322312112171,3.76120011569356,3.91202300542815,1,1,1,1.1479,2,0.7666,LESS
6,132,150,18,282,132,150,4.88280192258637,5.01063529409626,0.127833371509885,9.89343721668263,4.88280192258637,5.01063529409626,0,0,1,1.0378,2,0.4156,LESS
6,100,104,4,204,100,104,4.60517018598809,4.64439089914137,0.0392207131532807,9.24956108512946,4.60517018598809,4.64439089914137,0,0,1,1.3531,4,0.5997,LESS
6,150,159,9,309,150,159,5.01063529409626,5.06890420222023,0.058268908123976,10.0795394963165,5.01063529409626,5.06890420222023,0,0,1,1.1458,3,0.7681,LESS
6,180,150,30,330,150,180,5.19295685089021,5.01063529409626,0.182321556793955,10.2035921449865,5.01063529409626,5.19295685089021,1,1,1,1.555,4,0.581,LESS
6,82,100,18,182,82,100,4.40671924726425,4.60517018598809,0.198450938723838,9.01188943325235,4.40671924726425,4.60517018598809,0,0,1,1.5026,4,0.7515,LESS
6,98,100,2,198,98,100,4.58496747867057,4.60517018598809,0.0202027073175195,9.19013766465866,4.58496747867057,4.60517018598809,0,0,1,1.2116,4,0.333,LESS
6,50,45,5,95,50,45,3.91202300542815,3.80666248977032,0.105360515657826,7.71868549519847,3.91202300542815,3.80666248977032,0,1,0,1.1775,2,0.4334,LESS
6,50,52,2,102,50,52,3.91202300542815,3.95124371858143,0.0392207131532816,7.86326672400957,3.91202300542815,3.95124371858143,0,0,1,1.0739,3,0.7515,LESS
6,84,100,16,184,84,100,4.43081679884331,4.60517018598809,0.174353387144778,9.03598698483141,4.43081679884331,4.60517018598809,0,0,1,2.6274,4,0.4003,LESS
6,150,141,9,291,141,150,5.01063529409626,4.94875989037817,0.0618754037180871,9.95939518447442,4.94875989037817,5.01063529409626,1,1,1,1.0825,4,0.2831,LESS
6,100,104,4,204,100,104,4.60517018598809,4.64439089914137,0.0392207131532807,9.24956108512946,4.60517018598809,4.64439089914137,0,0,1,1.3547,4,0.3154,LESS
6,92,100,8,192,92,100,4.52178857704904,4.60517018598809,0.0833816089390513,9.12695876303713,4.52178857704904,4.60517018598809,0,0,1,1.0902,3,0.8124,LESS
6,118,100,18,218,100,118,4.77068462446567,4.60517018598809,0.165514438477573,9.37585481045376,4.60517018598809,4.77068462446567,1,1,1,1.9303,1,0.4069,LESS
6,150,126,24,276,126,150,5.01063529409626,4.83628190695148,0.174353387144778,9.84691720104773,4.83628190695148,5.01063529409626,1,1,1,1.1217,4,0.2992,LESS
6,150,159,9,309,150,159,5.01063529409626,5.06890420222023,0.058268908123976,10.0795394963165,5.01063529409626,5.06890420222023,0,0,1,0.9196,3,1.9215,LESS
6,150,126,24,276,126,150,5.01063529409626,4.83628190695148,0.174353387144778,9.84691720104773,4.83628190695148,5.01063529409626,1,1,1,0.9564,4,0.3311,LESS
6,49,50,1,99,49,50,3.89182029811063,3.91202300542815,0.0202027073175195,7.80384330353877,3.89182029811063,3.91202300542815,0,0,1,1.6052,1,0.2837,LESS
6,100,110,10,210,100,110,4.60517018598809,4.70048036579242,0.0953101798043248,9.30565055178051,4.60517018598809,4.70048036579242,0,0,1,1.0884,3,1.4974,LESS
6,50,55,5,105,50,55,3.91202300542815,4.00733318523247,0.0953101798043252,7.91935619066062,3.91202300542815,4.00733318523247,0,0,1,1.3206,4,0.2166,LESS
6,132,150,18,282,132,150,4.88280192258637,5.01063529409626,0.127833371509885,9.89343721668263,4.88280192258637,5.01063529409626,0,0,1,1.2379,3,0.8838,LESS
6,171,150,21,321,150,171,5.14166355650266,5.01063529409626,0.131028262406405,10.1522988505989,5.01063529409626,5.14166355650266,1,1,1,1.1533,3,0.5454,LESS
6,50,46,4,96,46,50,3.91202300542815,3.8286413964891,0.0833816089390509,7.74066440191724,3.8286413964891,3.91202300542815,1,1,1,2.0697,1,0.4509,LESS
6,59,50,9,109,50,59,4.07753744390572,3.91202300542815,0.165514438477574,7.98956044933387,3.91202300542815,4.07753744390572,1,1,1,1.1085,3,0.9358,LESS
6,100,88,12,188,88,100,4.60517018598809,4.47733681447821,0.127833371509885,9.0825070004663,4.47733681447821,4.60517018598809,1,1,1,1.4869,1,0.684,LESS
6,50,53,3,103,50,53,3.91202300542815,3.97029191355212,0.058268908123976,7.88231491898027,3.91202300542815,3.97029191355212,0,0,1,1.1361,4,0.4653,LESS
6,102,100,2,202,102,100,4.62497281328427,4.60517018598809,0.0198026272961789,9.23014299927236,4.62497281328427,4.60517018598809,0,1,0,1.4649,2,0.6031,LESS
6,118,100,18,218,100,118,4.77068462446567,4.60517018598809,0.165514438477573,9.37585481045376,4.60517018598809,4.77068462446567,1,1,1,0.9936,3,0.5464,LESS
6,43,50,7,93,43,50,3.76120011569356,3.91202300542815,0.150822889734584,7.67322312112171,3.76120011569356,3.91202300542815,0,0,1,1.3218,3,0.6496,LESS
6,150,153,3,303,153,150,5.01063529409626,5.03043792139244,0.0198026272961798,10.0410732154887,5.03043792139244,5.01063529409626,1,0,0,1.3399,1,0.7854,LESS
6,54,50,4,104,54,50,3.98898404656427,3.91202300542815,0.0769610411361286,7.90100705199242,3.98898404656427,3.91202300542815,0,1,0,1.1701,4,0.5507,LESS
6,150,138,12,288,138,150,5.01063529409626,4.92725368515721,0.0833816089390504,9.93788897925346,4.92725368515721,5.01063529409626,1,1,1,0.9343,4,0.2872,LESS
6,150,132,18,282,132,150,5.01063529409626,4.88280192258637,0.127833371509885,9.89343721668263,4.88280192258637,5.01063529409626,1,1,1,2.324,1,0.7842,LESS
6,108,100,8,208,100,108,4.68213122712422,4.60517018598809,0.0769610411361281,9.28730141311231,4.60517018598809,4.68213122712422,1,1,1,1.9626,2,0.6338,LESS
6,100,84,16,184,84,100,4.60517018598809,4.43081679884331,0.174353387144778,9.03598698483141,4.43081679884331,4.60517018598809,1,1,1,1.1989,4,0.4032,LESS
6,120,150,30,270,120,150,4.78749174278205,5.01063529409626,0.22314355131421,9.7981270368783,4.78749174278205,5.01063529409626,0,0,1,1.1315,1,0.4556,LESS
6,100,120,20,220,100,120,4.60517018598809,4.78749174278205,0.182321556793954,9.39266192877014,4.60517018598809,4.78749174278205,0,0,1,2.5095,1,2.1689,LESS
6,147,150,3,297,147,150,4.99043258677874,5.01063529409626,0.0202027073175195,10.001067880875,4.99043258677874,5.01063529409626,0,0,1,1.4814,2,0.6002,LESS
6,156,150,6,306,150,156,5.04985600724954,5.01063529409626,0.0392207131532816,10.0604913013458,5.01063529409626,5.04985600724954,1,1,1,1.2777,2,0.801,LESS
6,150,171,21,321,150,171,5.01063529409626,5.14166355650266,0.131028262406405,10.1522988505989,5.01063529409626,5.14166355650266,0,0,1,1.2011,2,0.5915,LESS
6,110,100,10,210,100,110,4.70048036579242,4.60517018598809,0.0953101798043248,9.30565055178051,4.60517018598809,4.70048036579242,1,1,1,1.2046,3,0.77,LESS
6,100,86,14,186,86,100,4.60517018598809,4.45434729625351,0.150822889734584,9.0595174822416,4.45434729625351,4.60517018598809,1,1,1,0.9922,3,0.8852,LESS
6,56,50,6,106,50,56,4.02535169073515,3.91202300542815,0.113328685307004,7.9373746961633,3.91202300542815,4.02535169073515,1,1,1,1.2722,3,0.7943,LESS
6,150,135,15,285,135,150,5.01063529409626,4.90527477843843,0.105360515657826,9.91591007253469,4.90527477843843,5.01063529409626,1,1,1,1.0474,3,1.1209,LESS
6,150,168,18,318,150,168,5.01063529409626,5.12396397940326,0.113328685307003,10.1345992734995,5.01063529409626,5.12396397940326,0,0,1,1.7868,4,0.2993,LESS
6,50,58,8,108,50,58,3.91202300542815,4.06044301054642,0.148420005118273,7.97246601597456,3.91202300542815,4.06044301054642,0,0,1,1.0967,4,0.3003,LESS
7,50,42,8,92,42,50,3.91202300542815,3.73766961828337,0.174353387144778,7.64969262371151,3.73766961828337,3.91202300542815,1,1,1,0.9102,4,1.1473,LESS
7,94,100,6,194,94,100,4.54329478227,4.60517018598809,0.061875403718088,9.1484649682581,4.54329478227,4.60517018598809,0,0,1,1.575,2,1.6936,LESS
7,50,45,5,95,45,50,3.91202300542815,3.80666248977032,0.105360515657826,7.71868549519847,3.80666248977032,3.91202300542815,1,1,1,1.2089,3,1.5873,LESS
7,100,90,10,190,90,100,4.60517018598809,4.49980967033027,0.105360515657827,9.10497985631836,4.49980967033027,4.60517018598809,1,1,1,1.155,2,1.2726,LESS
7,59,50,9,109,50,59,4.07753744390572,3.91202300542815,0.165514438477574,7.98956044933387,3.91202300542815,4.07753744390572,1,1,1,0.9004,4,1.0556,LESS
7,150,156,6,306,150,156,5.01063529409626,5.04985600724954,0.0392207131532816,10.0604913013458,5.01063529409626,5.04985600724954,0,0,1,1.99,1,0.6794,LESS
7,150,132,18,282,132,150,5.01063529409626,4.88280192258637,0.127833371509885,9.89343721668263,4.88280192258637,5.01063529409626,1,1,1,1.1265,2,1.4331,LESS
7,51,50,1,101,50,51,3.93182563272433,3.91202300542815,0.0198026272961798,7.84384863815247,3.91202300542815,3.93182563272433,1,1,1,1.0797,4,1.0682,LESS
7,90,100,10,190,100,90,4.49980967033027,4.60517018598809,0.105360515657827,9.10497985631836,4.60517018598809,4.49980967033027,1,0,0,2.3904,2,0.9576,LESS
7,50,40,10,90,40,50,3.91202300542815,3.68887945411394,0.22314355131421,7.60090245954208,3.68887945411394,3.91202300542815,1,1,1,0.9608,4,0.8573,LESS
7,43,50,7,93,43,50,3.76120011569356,3.91202300542815,0.150822889734584,7.67322312112171,3.76120011569356,3.91202300542815,0,0,1,1.0741,2,1.4776,LESS
7,50,47,3,97,47,50,3.91202300542815,3.85014760171006,0.0618754037180875,7.7621706071382,3.85014760171006,3.91202300542815,1,1,1,0.7959,2,1.2289,LESS
7,150,168,18,318,150,168,5.01063529409626,5.12396397940326,0.113328685307003,10.1345992734995,5.01063529409626,5.12396397940326,0,0,1,1.7223,1,0.9265,LESS
7,174,150,24,324,150,174,5.15905529921453,5.01063529409626,0.148420005118274,10.1696905933108,5.01063529409626,5.15905529921453,1,1,1,0.9369,3,0.9769,LESS
7,150,147,3,297,147,150,5.01063529409626,4.99043258677874,0.0202027073175195,10.001067880875,4.99043258677874,5.01063529409626,1,1,1,1.085,2,0.9808,LESS
7,147,150,3,297,150,147,4.99043258677874,5.01063529409626,0.0202027073175195,10.001067880875,5.01063529409626,4.99043258677874,1,0,0,1.447,3,1.0605,LESS
7,114,100,14,214,100,114,4.7361984483945,4.60517018598809,0.131028262406404,9.34136863438259,4.60517018598809,4.7361984483945,1,1,1,1.1696,3,1.0042,LESS
7,40,50,10,90,40,50,3.68887945411394,3.91202300542815,0.22314355131421,7.60090245954208,3.68887945411394,3.91202300542815,0,0,1,1.0267,3,1.5216,LESS
7,138,150,12,288,138,150,4.92725368515721,5.01063529409626,0.0833816089390504,9.93788897925346,4.92725368515721,5.01063529409626,0,0,1,1.1412,1,1.0537,LESS
7,100,90,10,190,90,100,4.60517018598809,4.49980967033027,0.105360515657827,9.10497985631836,4.49980967033027,4.60517018598809,1,1,1,2.3448,1,1.2544,LESS
7,177,150,27,327,150,177,5.17614973257383,5.01063529409626,0.165514438477573,10.1867850266701,5.01063529409626,5.17614973257383,1,1,1,1.4314,2,1.2295,LESS
7,100,118,18,218,100,118,4.60517018598809,4.77068462446567,0.165514438477573,9.37585481045376,4.60517018598809,4.77068462446567,0,0,1,1.5479,1,0.8939,LESS
7,50,45,5,95,45,50,3.91202300542815,3.80666248977032,0.105360515657826,7.71868549519847,3.80666248977032,3.91202300542815,1,1,1,1.1438,3,1.2601,LESS
7,156,150,6,306,150,156,5.04985600724954,5.01063529409626,0.0392207131532816,10.0604913013458,5.01063529409626,5.04985600724954,1,1,1,1.222,3,0.842,LESS
7,50,60,10,110,60,50,3.91202300542815,4.0943445622221,0.182321556793954,8.00636756765025,4.0943445622221,3.91202300542815,1,0,0,1.7654,1,0.8774,LESS
7,100,96,4,196,96,100,4.60517018598809,4.56434819146784,0.0408219945202557,9.16951837745593,4.56434819146784,4.60517018598809,1,1,1,1.0503,4,0.9836,LESS
7,162,150,12,312,150,162,5.08759633523238,5.01063529409626,0.0769610411361281,10.0982316293286,5.01063529409626,5.08759633523238,1,1,1,1.2191,4,0.8067,LESS
7,50,60,10,110,60,50,3.91202300542815,4.0943445622221,0.182321556793954,8.00636756765025,4.0943445622221,3.91202300542815,1,0,0,2.6185,1,0.7703,LESS
7,116,100,16,216,100,116,4.75359019110636,4.60517018598809,0.148420005118273,9.35876037709446,4.60517018598809,4.75359019110636,1,1,1,0.9592,4,0.8814,LESS
7,110,100,10,210,100,110,4.70048036579242,4.60517018598809,0.0953101798043248,9.30565055178051,4.60517018598809,4.70048036579242,1,1,1,1.2559,1,2.1165,LESS
7,52,50,2,102,50,52,3.95124371858143,3.91202300542815,0.0392207131532816,7.86326672400957,3.91202300542815,3.95124371858143,1,1,1,1.6242,2,0.8066,LESS
7,50,54,4,104,54,50,3.91202300542815,3.98898404656427,0.0769610411361286,7.90100705199242,3.98898404656427,3.91202300542815,1,0,0,1.4372,1,0.883,LESS
7,150,180,30,330,180,150,5.01063529409626,5.19295685089021,0.182321556793955,10.2035921449865,5.19295685089021,5.01063529409626,1,0,0,1.0576,1,1.7304,LESS
7,165,150,15,315,150,165,5.10594547390058,5.01063529409626,0.0953101798043248,10.1165807679968,5.01063529409626,5.10594547390058,1,1,1,1.8247,4,0.8937,LESS
7,100,120,20,220,100,120,4.60517018598809,4.78749174278205,0.182321556793954,9.39266192877014,4.60517018598809,4.78749174278205,0,0,1,1.1986,3,1.0996,LESS
7,150,177,27,327,177,150,5.01063529409626,5.17614973257383,0.165514438477573,10.1867850266701,5.17614973257383,5.01063529409626,1,0,0,1.6039,2,1.6687,LESS
7,150,180,30,330,150,180,5.01063529409626,5.19295685089021,0.182321556793955,10.2035921449865,5.01063529409626,5.19295685089021,0,0,1,1.2351,2,1.0079,LESS
7,100,114,14,214,100,114,4.60517018598809,4.7361984483945,0.131028262406404,9.34136863438259,4.60517018598809,4.7361984483945,0,0,1,2.7472,1,0.8908,LESS
7,150,129,21,279,129,150,5.01063529409626,4.85981240436167,0.150822889734584,9.87044769845793,4.85981240436167,5.01063529409626,1,1,1,1.2051,3,0.9659,LESS
7,58,50,8,108,50,58,4.06044301054642,3.91202300542815,0.148420005118273,7.97246601597456,3.91202300542815,4.06044301054642,1,1,1,1.0412,4,0.8113,LESS
7,180,150,30,330,150,180,5.19295685089021,5.01063529409626,0.182321556793955,10.2035921449865,5.01063529409626,5.19295685089021,1,1,1,1.0092,4,1.3593,LESS
7,104,100,4,204,100,104,4.64439089914137,4.60517018598809,0.0392207131532807,9.24956108512946,4.60517018598809,4.64439089914137,1,1,1,1.6722,4,0.3489,LESS
7,50,41,9,91,41,50,3.91202300542815,3.71357206670431,0.198450938723838,7.62559507213245,3.71357206670431,3.91202300542815,1,1,1,0.8286,4,0.9772,LESS
7,150,129,21,279,129,150,5.01063529409626,4.85981240436167,0.150822889734584,9.87044769845793,4.85981240436167,5.01063529409626,1,1,1,1.0051,4,0.8427,LESS
7,100,110,10,210,100,110,4.60517018598809,4.70048036579242,0.0953101798043248,9.30565055178051,4.60517018598809,4.70048036579242,0,0,1,1.5005,2,0.8846,LESS
7,50,55,5,105,55,50,3.91202300542815,4.00733318523247,0.0953101798043252,7.91935619066062,4.00733318523247,3.91202300542815,1,0,0,0.8625,4,0.941,LESS
7,144,150,6,294,144,150,4.969813299576,5.01063529409626,0.0408219945202548,9.98044859367226,4.969813299576,5.01063529409626,0,0,1,1.215,3,1.4119,LESS
7,50,47,3,97,47,50,3.91202300542815,3.85014760171006,0.0618754037180875,7.7621706071382,3.85014760171006,3.91202300542815,1,1,1,1.1776,3,1.0516,LESS
7,90,100,10,190,90,100,4.49980967033027,4.60517018598809,0.105360515657827,9.10497985631836,4.49980967033027,4.60517018598809,0,0,1,1.9004,2,1.0603,LESS
7,150,126,24,276,126,150,5.01063529409626,4.83628190695148,0.174353387144778,9.84691720104773,4.83628190695148,5.01063529409626,1,1,1,1.0284,2,1.2588,LESS
7,50,59,9,109,50,59,3.91202300542815,4.07753744390572,0.165514438477574,7.98956044933387,3.91202300542815,4.07753744390572,0,0,1,1.8157,2,0.8156,LESS
7,100,82,18,182,82,100,4.60517018598809,4.40671924726425,0.198450938723838,9.01188943325235,4.40671924726425,4.60517018598809,1,1,1,1.0435,3,1.549,LESS
7,150,123,27,273,123,150,5.01063529409626,4.81218435537242,0.198450938723838,9.82281964946867,4.81218435537242,5.01063529409626,1,1,1,1.0973,2,2.1969,LESS
7,50,58,8,108,58,50,3.91202300542815,4.06044301054642,0.148420005118273,7.97246601597456,4.06044301054642,3.91202300542815,1,0,0,1.4095,4,0.9732,LESS
7,50,43,7,93,43,50,3.91202300542815,3.76120011569356,0.150822889734584,7.67322312112171,3.76120011569356,3.91202300542815,1,1,1,0.8192,4,0.7958,LESS
7,168,150,18,318,150,168,5.12396397940326,5.01063529409626,0.113328685307003,10.1345992734995,5.01063529409626,5.12396397940326,1,1,1,1.2197,3,0.9431,LESS
7,150,147,3,297,150,147,5.01063529409626,4.99043258677874,0.0202027073175195,10.001067880875,5.01063529409626,4.99043258677874,0,1,0,1.9081,1,0.9774,LESS
7,44,50,6,94,44,50,3.78418963391826,3.91202300542815,0.127833371509885,7.69621263934641,3.78418963391826,3.91202300542815,0,0,1,1.5563,2,1.7766,LESS
7,56,50,6,106,50,56,4.02535169073515,3.91202300542815,0.113328685307004,7.9373746961633,3.91202300542815,4.02535169073515,1,1,1,1.0717,3,0.9692,LESS
7,45,50,5,95,45,50,3.80666248977032,3.91202300542815,0.105360515657826,7.71868549519847,3.80666248977032,3.91202300542815,0,0,1,1.2951,3,1.359,LESS
7,150,174,24,324,174,150,5.01063529409626,5.15905529921453,0.148420005118274,10.1696905933108,5.15905529921453,5.01063529409626,1,0,0,3.0398,1,1.014,LESS
7,49,50,1,99,50,49,3.89182029811063,3.91202300542815,0.0202027073175195,7.80384330353877,3.91202300542815,3.89182029811063,1,0,0,0.9296,3,1.2231,LESS
7,100,96,4,196,100,96,4.60517018598809,4.56434819146784,0.0408219945202557,9.16951837745593,4.60517018598809,4.56434819146784,0,1,0,1.4843,2,0.9319,LESS
7,108,100,8,208,100,108,4.68213122712422,4.60517018598809,0.0769610411361281,9.28730141311231,4.60517018598809,4.68213122712422,1,1,1,1.1112,3,0.8024,LESS
7,48,50,2,98,48,50,3.87120101090789,3.91202300542815,0.0408219945202548,7.78322401633604,3.87120101090789,3.91202300542815,0,0,1,1.4306,2,1.2024,LESS
7,50,53,3,103,53,50,3.91202300542815,3.97029191355212,0.058268908123976,7.88231491898027,3.97029191355212,3.91202300542815,1,0,0,2.7359,3,0.5135,LESS
7,96,100,4,196,96,100,4.56434819146784,4.60517018598809,0.0408219945202557,9.16951837745593,4.56434819146784,4.60517018598809,0,0,1,1.3195,3,1.3469,LESS
7,50,44,6,94,50,44,3.91202300542815,3.78418963391826,0.127833371509885,7.69621263934641,3.91202300542815,3.78418963391826,0,1,0,1.7879,2,0.878,LESS
7,53,50,3,103,50,53,3.97029191355212,3.91202300542815,0.058268908123976,7.88231491898027,3.91202300542815,3.97029191355212,1,1,1,2.982,1,0.8536,LESS
7,47,50,3,97,47,50,3.85014760171006,3.91202300542815,0.0618754037180875,7.7621706071382,3.85014760171006,3.91202300542815,0,0,1,1.1477,3,1.0182,LESS
7,129,150,21,279,129,150,4.85981240436167,5.01063529409626,0.150822889734584,9.87044769845793,4.85981240436167,5.01063529409626,0,0,1,1.985,1,0.6802,LESS
7,100,80,20,180,80,100,4.60517018598809,4.38202663467388,0.223143551314211,8.98719682066197,4.38202663467388,4.60517018598809,1,1,1,1.0726,3,1.3063,LESS
7,100,82,18,182,82,100,4.60517018598809,4.40671924726425,0.198450938723838,9.01188943325235,4.40671924726425,4.60517018598809,1,1,1,1.0071,4,0.8106,LESS
7,150,159,9,309,150,159,5.01063529409626,5.06890420222023,0.058268908123976,10.0795394963165,5.01063529409626,5.06890420222023,0,0,1,1.4017,2,1.1522,LESS
7,153,150,3,303,150,153,5.03043792139244,5.01063529409626,0.0198026272961798,10.0410732154887,5.01063529409626,5.03043792139244,1,1,1,1.709,3,1.0571,LESS
7,50,46,4,96,46,50,3.91202300542815,3.8286413964891,0.0833816089390509,7.74066440191724,3.8286413964891,3.91202300542815,1,1,1,0.8605,4,0.8573,LESS
7,120,150,30,270,150,120,4.78749174278205,5.01063529409626,0.22314355131421,9.7981270368783,5.01063529409626,4.78749174278205,1,0,0,2.9544,1,0.9357,LESS
7,45,50,5,95,50,45,3.80666248977032,3.91202300542815,0.105360515657826,7.71868549519847,3.91202300542815,3.80666248977032,1,0,0,0.8195,4,1.1384,LESS
7,180,150,30,330,150,180,5.19295685089021,5.01063529409626,0.182321556793955,10.2035921449865,5.01063529409626,5.19295685089021,1,1,1,0.8211,3,1.0471,LESS
7,51,50,1,101,50,51,3.93182563272433,3.91202300542815,0.0198026272961798,7.84384863815247,3.91202300542815,3.93182563272433,1,1,1,0.7542,3,1.6139,LESS
7,100,98,2,198,98,100,4.60517018598809,4.58496747867057,0.0202027073175195,9.19013766465866,4.58496747867057,4.60517018598809,1,1,1,2.0779,2,0.4673,LESS
7,100,116,16,216,100,116,4.60517018598809,4.75359019110636,0.148420005118273,9.35876037709446,4.60517018598809,4.75359019110636,0,0,1,0.9346,1,0.8359,LESS
7,162,150,12,312,150,162,5.08759633523238,5.01063529409626,0.0769610411361281,10.0982316293286,5.01063529409626,5.08759633523238,1,1,1,0.8593,3,1.2195,LESS
7,86,100,14,186,86,100,4.45434729625351,4.60517018598809,0.150822889734584,9.0595174822416,4.45434729625351,4.60517018598809,0,0,1,2.6874,1,0.9704,LESS
7,54,50,4,104,50,54,3.98898404656427,3.91202300542815,0.0769610411361286,7.90100705199242,3.91202300542815,3.98898404656427,1,1,1,3.1303,2,1.3866,LESS
7,100,106,6,206,106,100,4.60517018598809,4.66343909411207,0.0582689081239751,9.26860928010016,4.66343909411207,4.60517018598809,1,0,0,2.5911,1,0.3861,LESS
7,108,100,8,208,100,108,4.68213122712422,4.60517018598809,0.0769610411361281,9.28730141311231,4.60517018598809,4.68213122712422,1,1,1,1.4377,1,0.925,LESS
7,100,84,16,184,84,100,4.60517018598809,4.43081679884331,0.174353387144778,9.03598698483141,4.43081679884331,4.60517018598809,1,1,1,1.3613,2,0.8013,LESS
7,102,100,2,202,100,102,4.62497281328427,4.60517018598809,0.0198026272961789,9.23014299927236,4.60517018598809,4.62497281328427,1,1,1,1.4161,1,1.0252,LESS
7,57,50,7,107,50,57,4.04305126783455,3.91202300542815,0.131028262406404,7.9550742732627,3.91202300542815,4.04305126783455,1,1,1,1.1842,3,0.5665,LESS
7,120,100,20,220,120,100,4.78749174278205,4.60517018598809,0.182321556793954,9.39266192877014,4.78749174278205,4.60517018598809,0,1,0,1.474,1,0.7613,LESS
7,138,150,12,288,150,138,4.92725368515721,5.01063529409626,0.0833816089390504,9.93788897925346,5.01063529409626,4.92725368515721,1,0,0,2.1411,2,0.8395,LESS
7,150,153,3,303,150,153,5.01063529409626,5.03043792139244,0.0198026272961798,10.0410732154887,5.01063529409626,5.03043792139244,0,0,1,1.3186,1,0.6437,LESS
7,48,50,2,98,50,48,3.87120101090789,3.91202300542815,0.0408219945202548,7.78322401633604,3.91202300542815,3.87120101090789,1,0,0,0.9955,3,0.7201,LESS
7,112,100,12,212,100,112,4.71849887129509,4.60517018598809,0.113328685307002,9.32366905728319,4.60517018598809,4.71849887129509,1,1,1,2.3471,1,0.8541,LESS
7,100,102,2,202,100,102,4.60517018598809,4.62497281328427,0.0198026272961789,9.23014299927236,4.60517018598809,4.62497281328427,0,0,1,1.2194,1,0.6488,LESS
7,49,50,1,99,50,49,3.89182029811063,3.91202300542815,0.0202027073175195,7.80384330353877,3.91202300542815,3.89182029811063,1,0,0,1.5946,3,1.5446,LESS
7,60,50,10,110,50,60,4.0943445622221,3.91202300542815,0.182321556793954,8.00636756765025,3.91202300542815,4.0943445622221,1,1,1,1.0528,3,0.6232,LESS
7,150,144,6,294,150,144,5.01063529409626,4.969813299576,0.0408219945202548,9.98044859367226,5.01063529409626,4.969813299576,0,1,0,2.187,1,1.0489,LESS
7,129,150,21,279,129,150,4.85981240436167,5.01063529409626,0.150822889734584,9.87044769845793,4.85981240436167,5.01063529409626,0,0,1,1.3433,1,1.5244,LESS
7,100,104,4,204,100,104,4.60517018598809,4.64439089914137,0.0392207131532807,9.24956108512946,4.60517018598809,4.64439089914137,0,0,1,2.1171,1,0.716,LESS
7,150,153,3,303,153,150,5.01063529409626,5.03043792139244,0.0198026272961798,10.0410732154887,5.03043792139244,5.01063529409626,1,0,0,1.8521,2,1.5548,LESS
7,50,52,2,102,50,52,3.91202300542815,3.95124371858143,0.0392207131532816,7.86326672400957,3.91202300542815,3.95124371858143,0,0,1,1.6207,2,1.347,LESS
7,100,86,14,186,86,100,4.60517018598809,4.45434729625351,0.150822889734584,9.0595174822416,4.45434729625351,4.60517018598809,1,1,1,1.1122,4,1.0066,LESS
7,82,100,18,182,82,100,4.40671924726425,4.60517018598809,0.198450938723838,9.01188943325235,4.40671924726425,4.60517018598809,0,0,1,1.2565,2,0.799,LESS
7,100,86,14,186,86,100,4.60517018598809,4.45434729625351,0.150822889734584,9.0595174822416,4.45434729625351,4.60517018598809,1,1,1,0.8612,4,1.3495,LESS
7,116,100,16,216,100,116,4.75359019110636,4.60517018598809,0.148420005118273,9.35876037709446,4.60517018598809,4.75359019110636,1,1,1,1.0316,3,0.8117,LESS
7,50,42,8,92,42,50,3.91202300542815,3.73766961828337,0.174353387144778,7.64969262371151,3.73766961828337,3.91202300542815,1,1,1,0.9271,4,0.7632,LESS
7,41,50,9,91,41,50,3.71357206670431,3.91202300542815,0.198450938723838,7.62559507213245,3.71357206670431,3.91202300542815,0,0,1,1.0086,3,1.564,LESS
7,50,43,7,93,43,50,3.91202300542815,3.76120011569356,0.150822889734584,7.67322312112171,3.76120011569356,3.91202300542815,1,1,1,1.1427,4,0.8689,LESS
7,150,135,15,285,135,150,5.01063529409626,4.90527477843843,0.105360515657826,9.91591007253469,4.90527477843843,5.01063529409626,1,1,1,1.2432,3,0.761,LESS
7,150,171,21,321,150,171,5.01063529409626,5.14166355650266,0.131028262406405,10.1522988505989,5.01063529409626,5.14166355650266,0,0,1,1.4137,2,0.7183,LESS
7,50,58,8,108,58,50,3.91202300542815,4.06044301054642,0.148420005118273,7.97246601597456,4.06044301054642,3.91202300542815,1,0,0,0.9466,1,1.1806,LESS
7,46,50,4,96,50,46,3.8286413964891,3.91202300542815,0.0833816089390509,7.74066440191724,3.91202300542815,3.8286413964891,1,0,0,1.0331,3,1.519,LESS
7,150,141,9,291,150,141,5.01063529409626,4.94875989037817,0.0618754037180871,9.95939518447442,5.01063529409626,4.94875989037817,0,1,0,1.4015,2,0.6441,LESS
7,150,162,12,312,162,150,5.01063529409626,5.08759633523238,0.0769610411361281,10.0982316293286,5.08759633523238,5.01063529409626,1,0,0,0.9978,2,0.9333,LESS
7,150,171,21,321,150,171,5.01063529409626,5.14166355650266,0.131028262406405,10.1522988505989,5.01063529409626,5.14166355650266,0,0,1,1.2966,2,0.6545,LESS
7,100,108,8,208,108,100,4.60517018598809,4.68213122712422,0.0769610411361281,9.28730141311231,4.68213122712422,4.60517018598809,1,0,0,2.3216,2,1.0122,LESS
7,150,165,15,315,150,165,5.01063529409626,5.10594547390058,0.0953101798043248,10.1165807679968,5.01063529409626,5.10594547390058,0,0,1,1.2867,1,0.8947,LESS
7,52,50,2,102,52,50,3.95124371858143,3.91202300542815,0.0392207131532816,7.86326672400957,3.95124371858143,3.91202300542815,0,1,0,2.0797,1,0.8035,LESS
7,42,50,8,92,42,50,3.73766961828337,3.91202300542815,0.174353387144778,7.64969262371151,3.73766961828337,3.91202300542815,0,0,1,1.39,2,0.6907,LESS
7,150,156,6,306,156,150,5.01063529409626,5.04985600724954,0.0392207131532816,10.0604913013458,5.04985600724954,5.01063529409626,1,0,0,1.1305,3,0.6326,LESS
7,150,120,30,270,120,150,5.01063529409626,4.78749174278205,0.22314355131421,9.7981270368783,4.78749174278205,5.01063529409626,1,1,1,1.3116,2,0.7643,LESS
7,100,92,8,192,100,92,4.60517018598809,4.52178857704904,0.0833816089390513,9.12695876303713,4.60517018598809,4.52178857704904,0,1,0,1.8451,2,0.2996,LESS
7,92,100,8,192,92,100,4.52178857704904,4.60517018598809,0.0833816089390513,9.12695876303713,4.52178857704904,4.60517018598809,0,0,1,1.2628,3,2.4947,LESS
7,150,132,18,282,132,150,5.01063529409626,4.88280192258637,0.127833371509885,9.89343721668263,4.88280192258637,5.01063529409626,1,1,1,1.0668,3,0.7603,LESS
7,50,48,2,98,50,48,3.91202300542815,3.87120101090789,0.0408219945202548,7.78322401633604,3.91202300542815,3.87120101090789,0,1,0,1.4327,2,0.3868,LESS
7,44,50,6,94,44,50,3.78418963391826,3.91202300542815,0.127833371509885,7.69621263934641,3.78418963391826,3.91202300542815,0,0,1,1.2453,3,0.8402,LESS
7,50,44,6,94,44,50,3.91202300542815,3.78418963391826,0.127833371509885,7.69621263934641,3.78418963391826,3.91202300542815,1,1,1,0.9609,4,1.3688,LESS
7,114,100,14,214,100,114,4.7361984483945,4.60517018598809,0.131028262406404,9.34136863438259,4.60517018598809,4.7361984483945,1,1,1,0.9116,3,1.1749,LESS
7,168,150,18,318,150,168,5.12396397940326,5.01063529409626,0.113328685307003,10.1345992734995,5.01063529409626,5.12396397940326,1,1,1,0.7566,3,0.9763,LESS
7,106,100,6,206,106,100,4.66343909411207,4.60517018598809,0.0582689081239751,9.26860928010016,4.66343909411207,4.60517018598809,0,1,0,1.1496,2,0.9845,LESS
7,120,100,20,220,100,120,4.78749174278205,4.60517018598809,0.182321556793954,9.39266192877014,4.60517018598809,4.78749174278205,1,1,1,0.9713,3,0.9719,LESS
7,100,98,2,198,100,98,4.60517018598809,4.58496747867057,0.0202027073175195,9.19013766465866,4.60517018598809,4.58496747867057,0,1,0,1.259,2,1.3501,LESS
7,50,53,3,103,50,53,3.91202300542815,3.97029191355212,0.058268908123976,7.88231491898027,3.91202300542815,3.97029191355212,0,0,1,1.4589,1,0.8931,LESS
7,50,46,4,96,46,50,3.91202300542815,3.8286413964891,0.0833816089390509,7.74066440191724,3.8286413964891,3.91202300542815,1,1,1,0.9605,4,0.8856,LESS
7,100,106,6,206,100,106,4.60517018598809,4.66343909411207,0.0582689081239751,9.26860928010016,4.60517018598809,4.66343909411207,0,0,1,1.3074,2,0.7639,LESS
7,50,41,9,91,41,50,3.91202300542815,3.71357206670431,0.198450938723838,7.62559507213245,3.71357206670431,3.91202300542815,1,1,1,0.9261,2,1.3894,LESS
7,59,50,9,109,50,59,4.07753744390572,3.91202300542815,0.165514438477574,7.98956044933387,3.91202300542815,4.07753744390572,1,1,1,1.4712,3,0.9399,LESS
7,150,138,12,288,150,138,5.01063529409626,4.92725368515721,0.0833816089390504,9.93788897925346,5.01063529409626,4.92725368515721,0,1,0,1.7404,1,0.5599,LESS
7,150,168,18,318,150,168,5.01063529409626,5.12396397940326,0.113328685307003,10.1345992734995,5.01063529409626,5.12396397940326,0,0,1,1.7121,2,1.312,LESS
7,94,100,6,194,94,100,4.54329478227,4.60517018598809,0.061875403718088,9.1484649682581,4.54329478227,4.60517018598809,0,0,1,1.3258,2,0.8904,LESS
7,159,150,9,309,150,159,5.06890420222023,5.01063529409626,0.058268908123976,10.0795394963165,5.01063529409626,5.06890420222023,1,1,1,2.084,1,0.696,LESS
7,86,100,14,186,100,86,4.45434729625351,4.60517018598809,0.150822889734584,9.0595174822416,4.60517018598809,4.45434729625351,1,0,0,1.6555,2,1.4271,LESS
7,50,56,6,106,50,56,3.91202300542815,4.02535169073515,0.113328685307004,7.9373746961633,3.91202300542815,4.02535169073515,0,0,1,1.1179,3,1.3951,LESS
7,100,88,12,188,88,100,4.60517018598809,4.47733681447821,0.127833371509885,9.0825070004663,4.47733681447821,4.60517018598809,1,1,1,0.9397,4,0.8038,LESS
7,100,114,14,214,100,114,4.60517018598809,4.7361984483945,0.131028262406404,9.34136863438259,4.60517018598809,4.7361984483945,0,0,1,2.1624,2,0.7611,LESS
7,98,100,2,198,100,98,4.58496747867057,4.60517018598809,0.0202027073175195,9.19013766465866,4.60517018598809,4.58496747867057,1,0,0,2.1408,1,0.6793,LESS
7,50,40,10,90,40,50,3.91202300542815,3.68887945411394,0.22314355131421,7.60090245954208,3.68887945411394,3.91202300542815,1,1,1,1.1431,3,0.816,LESS
7,53,50,3,103,50,53,3.97029191355212,3.91202300542815,0.058268908123976,7.88231491898027,3.91202300542815,3.97029191355212,1,1,1,0.9773,4,0.8033,LESS
7,100,102,2,202,102,100,4.60517018598809,4.62497281328427,0.0198026272961789,9.23014299927236,4.62497281328427,4.60517018598809,1,0,0,0.899,4,0.7135,LESS
7,50,51,1,101,50,51,3.91202300542815,3.93182563272433,0.0198026272961798,7.84384863815247,3.91202300542815,3.93182563272433,0,0,1,0.9774,4,0.7782,LESS
7,100,116,16,216,100,116,4.60517018598809,4.75359019110636,0.148420005118273,9.35876037709446,4.60517018598809,4.75359019110636,0,0,1,1.9475,1,0.3872,LESS
7,132,150,18,282,132,150,4.88280192258637,5.01063529409626,0.127833371509885,9.89343721668263,4.88280192258637,5.01063529409626,0,0,1,0.9655,1,1.4382,LESS
7,120,150,30,270,120,150,4.78749174278205,5.01063529409626,0.22314355131421,9.7981270368783,4.78749174278205,5.01063529409626,0,0,1,1.5197,1,2.1101,LESS
7,171,150,21,321,150,171,5.14166355650266,5.01063529409626,0.131028262406405,10.1522988505989,5.01063529409626,5.14166355650266,1,1,1,1.0912,2,1.0558,LESS
7,171,150,21,321,171,150,5.14166355650266,5.01063529409626,0.131028262406405,10.1522988505989,5.14166355650266,5.01063529409626,0,1,0,2.9263,1,0.5468,LESS
7,132,150,18,282,132,150,4.88280192258637,5.01063529409626,0.127833371509885,9.89343721668263,4.88280192258637,5.01063529409626,0,0,1,1.3258,3,1.2783,LESS
7,150,123,27,273,123,150,5.01063529409626,4.81218435537242,0.198450938723838,9.82281964946867,4.81218435537242,5.01063529409626,1,1,1,1.1232,3,0.7198,LESS
7,153,150,3,303,150,153,5.03043792139244,5.01063529409626,0.0198026272961798,10.0410732154887,5.01063529409626,5.03043792139244,1,1,1,2.3205,1,0.8608,LESS
7,42,50,8,92,42,50,3.73766961828337,3.91202300542815,0.174353387144778,7.64969262371151,3.73766961828337,3.91202300542815,0,0,1,1.2447,4,1.1489,LESS
7,55,50,5,105,50,55,4.00733318523247,3.91202300542815,0.0953101798043252,7.91935619066062,3.91202300542815,4.00733318523247,1,1,1,0.9801,3,1.0092,LESS
7,150,177,27,327,150,177,5.01063529409626,5.17614973257383,0.165514438477573,10.1867850266701,5.01063529409626,5.17614973257383,0,0,1,1.049,3,0.4263,LESS
7,150,174,24,324,150,174,5.01063529409626,5.15905529921453,0.148420005118274,10.1696905933108,5.01063529409626,5.15905529921453,0,0,1,1.0417,2,0.9327,LESS
7,56,50,6,106,50,56,4.02535169073515,3.91202300542815,0.113328685307004,7.9373746961633,3.91202300542815,4.02535169073515,1,1,1,0.8305,3,0.9088,LESS
7,104,100,4,204,104,100,4.64439089914137,4.60517018598809,0.0392207131532807,9.24956108512946,4.64439089914137,4.60517018598809,0,1,0,1.2206,2,1.0985,LESS
7,40,50,10,90,40,50,3.68887945411394,3.91202300542815,0.22314355131421,7.60090245954208,3.68887945411394,3.91202300542815,0,0,1,1.0814,4,0.7554,LESS
7,57,50,7,107,50,57,4.04305126783455,3.91202300542815,0.131028262406404,7.9550742732627,3.91202300542815,4.04305126783455,1,1,1,0.9,3,0.6708,LESS
7,135,150,15,285,135,150,4.90527477843843,5.01063529409626,0.105360515657826,9.91591007253469,4.90527477843843,5.01063529409626,0,0,1,1.1821,2,1.51,LESS
7,147,150,3,297,150,147,4.99043258677874,5.01063529409626,0.0202027073175195,10.001067880875,5.01063529409626,4.99043258677874,1,0,0,1.0279,2,0.7227,LESS
7,50,57,7,107,50,57,3.91202300542815,4.04305126783455,0.131028262406404,7.9550742732627,3.91202300542815,4.04305126783455,0,0,1,3.24,1,0.3023,LESS
7,100,112,12,212,100,112,4.60517018598809,4.71849887129509,0.113328685307002,9.32366905728319,4.60517018598809,4.71849887129509,0,0,1,3.623,1,0.4681,LESS
7,50,49,1,99,49,50,3.91202300542815,3.89182029811063,0.0202027073175195,7.80384330353877,3.89182029811063,3.91202300542815,1,1,1,0.9684,4,0.8005,LESS
7,100,110,10,210,100,110,4.60517018598809,4.70048036579242,0.0953101798043248,9.30565055178051,4.60517018598809,4.70048036579242,0,0,1,1.4435,2,0.8007,LESS
7,98,100,2,198,98,100,4.58496747867057,4.60517018598809,0.0202027073175195,9.19013766465866,4.58496747867057,4.60517018598809,0,0,1,1.2942,1,0.8399,LESS
7,50,56,6,106,56,50,3.91202300542815,4.02535169073515,0.113328685307004,7.9373746961633,4.02535169073515,3.91202300542815,1,0,0,1.7629,1,0.6804,LESS
7,110,100,10,210,100,110,4.70048036579242,4.60517018598809,0.0953101798043248,9.30565055178051,4.60517018598809,4.70048036579242,1,1,1,1.3705,2,0.6367,LESS
7,50,49,1,99,49,50,3.91202300542815,3.89182029811063,0.0202027073175195,7.80384330353877,3.89182029811063,3.91202300542815,1,1,1,0.9018,1,0.9291,LESS
7,150,144,6,294,150,144,5.01063529409626,4.969813299576,0.0408219945202548,9.98044859367226,5.01063529409626,4.969813299576,0,1,0,1.3185,3,0.7709,LESS
7,156,150,6,306,156,150,5.04985600724954,5.01063529409626,0.0392207131532816,10.0604913013458,5.04985600724954,5.01063529409626,0,1,0,5.004,1,0.8069,LESS
7,150,162,12,312,150,162,5.01063529409626,5.08759633523238,0.0769610411361281,10.0982316293286,5.01063529409626,5.08759633523238,0,0,1,0.9612,3,1.0523,LESS
7,135,150,15,285,135,150,4.90527477843843,5.01063529409626,0.105360515657826,9.91591007253469,4.90527477843843,5.01063529409626,0,0,1,1.2856,3,0.3839,LESS
7,50,48,2,98,50,48,3.91202300542815,3.87120101090789,0.0408219945202548,7.78322401633604,3.91202300542815,3.87120101090789,0,1,0,1.3959,3,0.3456,LESS
7,54,50,4,104,50,54,3.98898404656427,3.91202300542815,0.0769610411361286,7.90100705199242,3.91202300542815,3.98898404656427,1,1,1,0.9376,4,0.8073,LESS
7,100,108,8,208,100,108,4.60517018598809,4.68213122712422,0.0769610411361281,9.28730141311231,4.60517018598809,4.68213122712422,0,0,1,1.0865,2,0.971,LESS
7,50,55,5,105,55,50,3.91202300542815,4.00733318523247,0.0953101798043252,7.91935619066062,4.00733318523247,3.91202300542815,1,0,0,1.0023,3,0.8802,LESS
7,84,100,16,184,100,84,4.43081679884331,4.60517018598809,0.174353387144778,9.03598698483141,4.60517018598809,4.43081679884331,1,0,0,1.5676,1,0.6422,LESS
7,100,104,4,204,100,104,4.60517018598809,4.64439089914137,0.0392207131532807,9.24956108512946,4.60517018598809,4.64439089914137,0,0,1,1.351,1,0.6531,LESS
7,123,150,27,273,123,150,4.81218435537242,5.01063529409626,0.198450938723838,9.82281964946867,4.81218435537242,5.01063529409626,0,0,1,1.2637,3,0.7145,LESS
7,92,100,8,192,92,100,4.52178857704904,4.60517018598809,0.0833816089390513,9.12695876303713,4.52178857704904,4.60517018598809,0,0,1,1.1581,2,0.6857,LESS
7,144,150,6,294,144,150,4.969813299576,5.01063529409626,0.0408219945202548,9.98044859367226,4.969813299576,5.01063529409626,0,0,1,1.5175,1,0.3928,LESS
7,150,120,30,270,120,150,5.01063529409626,4.78749174278205,0.22314355131421,9.7981270368783,4.78749174278205,5.01063529409626,1,1,1,1.0997,3,2.3487,LESS
7,126,150,24,276,126,150,4.83628190695148,5.01063529409626,0.174353387144778,9.84691720104773,4.83628190695148,5.01063529409626,0,0,1,1.2406,2,0.604,LESS
7,150,126,24,276,126,150,5.01063529409626,4.83628190695148,0.174353387144778,9.84691720104773,4.83628190695148,5.01063529409626,1,1,1,1.0942,4,0.805,LESS
7,80,100,20,180,80,100,4.38202663467388,4.60517018598809,0.223143551314211,8.98719682066197,4.38202663467388,4.60517018598809,0,0,1,0.753,4,0.5966,LESS
7,84,100,16,184,84,100,4.43081679884331,4.60517018598809,0.174353387144778,9.03598698483141,4.43081679884331,4.60517018598809,0,0,1,0.8671,3,1.1543,LESS
7,102,100,2,202,100,102,4.62497281328427,4.60517018598809,0.0198026272961789,9.23014299927236,4.60517018598809,4.62497281328427,1,1,1,0.809,4,1.081,LESS
7,100,94,6,194,94,100,4.60517018598809,4.54329478227,0.061875403718088,9.1484649682581,4.54329478227,4.60517018598809,1,1,1,0.7799,3,0.8789,LESS
7,50,54,4,104,50,54,3.91202300542815,3.98898404656427,0.0769610411361286,7.90100705199242,3.91202300542815,3.98898404656427,0,0,1,1.3997,2,0.6853,LESS
7,60,50,10,110,50,60,4.0943445622221,3.91202300542815,0.182321556793954,8.00636756765025,3.91202300542815,4.0943445622221,1,1,1,0.6715,4,0.8943,LESS
7,123,150,27,273,123,150,4.81218435537242,5.01063529409626,0.198450938723838,9.82281964946867,4.81218435537242,5.01063529409626,0,0,1,0.9948,3,0.7915,LESS
7,100,80,20,180,80,100,4.60517018598809,4.38202663467388,0.223143551314211,8.98719682066197,4.38202663467388,4.60517018598809,1,1,1,0.8577,4,1.5159,LESS
7,118,100,18,218,100,118,4.77068462446567,4.60517018598809,0.165514438477573,9.37585481045376,4.60517018598809,4.77068462446567,1,1,1,0.9414,3,0.6715,LESS
7,41,50,9,91,41,50,3.71357206670431,3.91202300542815,0.198450938723838,7.62559507213245,3.71357206670431,3.91202300542815,0,0,1,0.6856,3,1.1383,LESS
7,159,150,9,309,150,159,5.06890420222023,5.01063529409626,0.058268908123976,10.0795394963165,5.01063529409626,5.06890420222023,1,1,1,1.0618,2,0.7494,LESS
7,96,100,4,196,100,96,4.56434819146784,4.60517018598809,0.0408219945202557,9.16951837745593,4.60517018598809,4.56434819146784,1,0,0,1.0107,2,1.7616,LESS
7,50,51,1,101,50,51,3.91202300542815,3.93182563272433,0.0198026272961798,7.84384863815247,3.91202300542815,3.93182563272433,0,0,1,1.0027,3,0.9835,LESS
7,150,135,15,285,135,150,5.01063529409626,4.90527477843843,0.105360515657826,9.91591007253469,4.90527477843843,5.01063529409626,1,1,1,1.9588,1,0.3793,LESS
7,82,100,18,182,82,100,4.40671924726425,4.60517018598809,0.198450938723838,9.01188943325235,4.40671924726425,4.60517018598809,0,0,1,1.1409,2,2.3203,LESS
7,150,138,12,288,138,150,5.01063529409626,4.92725368515721,0.0833816089390504,9.93788897925346,4.92725368515721,5.01063529409626,1,1,1,1.0396,2,1.6769,LESS
7,88,100,12,188,88,100,4.47733681447821,4.60517018598809,0.127833371509885,9.0825070004663,4.47733681447821,4.60517018598809,0,0,1,1.2096,2,0.6771,LESS
7,100,120,20,220,100,120,4.60517018598809,4.78749174278205,0.182321556793954,9.39266192877014,4.60517018598809,4.78749174278205,0,0,1,0.9496,4,0.8458,LESS
7,126,150,24,276,126,150,4.83628190695148,5.01063529409626,0.174353387144778,9.84691720104773,4.83628190695148,5.01063529409626,0,0,1,1.3201,2,0.8019,LESS
7,55,50,5,105,55,50,4.00733318523247,3.91202300542815,0.0953101798043252,7.91935619066062,4.00733318523247,3.91202300542815,0,1,0,3.2821,2,1.0951,LESS
7,177,150,27,327,150,177,5.17614973257383,5.01063529409626,0.165514438477573,10.1867850266701,5.01063529409626,5.17614973257383,1,1,1,0.7919,3,0.8895,LESS
7,141,150,9,291,141,150,4.94875989037817,5.01063529409626,0.0618754037180871,9.95939518447442,4.94875989037817,5.01063529409626,0,0,1,0.9971,2,1.4716,LESS
7,100,118,18,218,100,118,4.60517018598809,4.77068462446567,0.165514438477573,9.37585481045376,4.60517018598809,4.77068462446567,0,0,1,1.9763,1,0.8014,LESS
7,58,50,8,108,58,50,4.06044301054642,3.91202300542815,0.148420005118273,7.97246601597456,4.06044301054642,3.91202300542815,0,1,0,1.4957,1,0.9356,LESS
7,150,165,15,315,150,165,5.01063529409626,5.10594547390058,0.0953101798043248,10.1165807679968,5.01063529409626,5.10594547390058,0,0,1,2.0645,1,0.428,LESS
7,100,84,16,184,84,100,4.60517018598809,4.43081679884331,0.174353387144778,9.03598698483141,4.43081679884331,4.60517018598809,1,1,1,0.8258,4,0.9264,LESS
7,112,100,12,212,100,112,4.71849887129509,4.60517018598809,0.113328685307002,9.32366905728319,4.60517018598809,4.71849887129509,1,1,1,2.3764,1,0.5875,LESS
7,43,50,7,93,50,43,3.76120011569356,3.91202300542815,0.150822889734584,7.67322312112171,3.91202300542815,3.76120011569356,1,0,0,1.035,4,0.8942,LESS
7,141,150,9,291,150,141,4.94875989037817,5.01063529409626,0.0618754037180871,9.95939518447442,5.01063529409626,4.94875989037817,1,0,0,0.8281,3,0.6414,LESS
7,50,59,9,109,59,50,3.91202300542815,4.07753744390572,0.165514438477574,7.98956044933387,4.07753744390572,3.91202300542815,1,0,0,0.8949,1,1.5207,LESS
7,150,159,9,309,159,150,5.01063529409626,5.06890420222023,0.058268908123976,10.0795394963165,5.06890420222023,5.01063529409626,1,0,0,1.6143,2,0.5063,LESS
7,106,100,6,206,100,106,4.66343909411207,4.60517018598809,0.0582689081239751,9.26860928010016,4.60517018598809,4.66343909411207,1,1,1,2.7043,1,0.2987,LESS
7,50,57,7,107,50,57,3.91202300542815,4.04305126783455,0.131028262406404,7.9550742732627,3.91202300542815,4.04305126783455,0,0,1,1.1291,3,1.4227,LESS
7,100,92,8,192,92,100,4.60517018598809,4.52178857704904,0.0833816089390513,9.12695876303713,4.52178857704904,4.60517018598809,1,1,1,2.282,1,0.9887,LESS
7,80,100,20,180,80,100,4.38202663467388,4.60517018598809,0.223143551314211,8.98719682066197,4.38202663467388,4.60517018598809,0,0,1,2.3489,1,0.5808,LESS
7,46,50,4,96,50,46,3.8286413964891,3.91202300542815,0.0833816089390509,7.74066440191724,3.91202300542815,3.8286413964891,1,0,0,0.8564,4,0.7566,LESS
7,165,150,15,315,150,165,5.10594547390058,5.01063529409626,0.0953101798043248,10.1165807679968,5.01063529409626,5.10594547390058,1,1,1,1.14,2,0.8299,LESS
7,150,141,9,291,141,150,5.01063529409626,4.94875989037817,0.0618754037180871,9.95939518447442,4.94875989037817,5.01063529409626,1,1,1,0.8025,1,0.8493,LESS
7,88,100,12,188,100,88,4.47733681447821,4.60517018598809,0.127833371509885,9.0825070004663,4.60517018598809,4.47733681447821,1,0,0,1.1651,1,0.968,LESS
7,50,52,2,102,52,50,3.91202300542815,3.95124371858143,0.0392207131532816,7.86326672400957,3.95124371858143,3.91202300542815,1,0,0,0.7926,4,0.7219,LESS
7,100,112,12,212,112,100,4.60517018598809,4.71849887129509,0.113328685307002,9.32366905728319,4.71849887129509,4.60517018598809,1,0,0,1.3058,3,0.5552,LESS
7,174,150,24,324,150,174,5.15905529921453,5.01063529409626,0.148420005118274,10.1696905933108,5.01063529409626,5.15905529921453,1,1,1,1.631,2,0.6819,LESS
7,100,94,6,194,94,100,4.60517018598809,4.54329478227,0.061875403718088,9.1484649682581,4.54329478227,4.60517018598809,1,1,1,1.5854,1,0.5515,LESS
7,100,88,12,188,100,88,4.60517018598809,4.47733681447821,0.127833371509885,9.0825070004663,4.60517018598809,4.47733681447821,0,1,0,1.7298,1,0.4211,LESS
7,118,100,18,218,100,118,4.77068462446567,4.60517018598809,0.165514438477573,9.37585481045376,4.60517018598809,4.77068462446567,1,1,1,3.0359,1,0.4499,LESS
7,47,50,3,97,47,50,3.85014760171006,3.91202300542815,0.0618754037180875,7.7621706071382,3.85014760171006,3.91202300542815,0,0,1,2.0376,1,0.8931,LESS
8,129,150,21,279,129,150,4.85981240436167,5.01063529409626,0.150822889734584,9.87044769845793,4.85981240436167,5.01063529409626,0,0,1,1.062,3,1.45,LESS
8,45,50,5,95,45,50,3.80666248977032,3.91202300542815,0.105360515657826,7.71868549519847,3.80666248977032,3.91202300542815,0,0,1,1.323,4,0.955,LESS
8,138,150,12,288,138,150,4.92725368515721,5.01063529409626,0.0833816089390504,9.93788897925346,4.92725368515721,5.01063529409626,0,0,1,1.784,1,2.703,LESS
8,100,102,2,202,100,102,4.60517018598809,4.62497281328427,0.0198026272961789,9.23014299927236,4.60517018598809,4.62497281328427,0,0,1,2.054,2,1.003,LESS
8,45,50,5,95,50,45,3.80666248977032,3.91202300542815,0.105360515657826,7.71868549519847,3.91202300542815,3.80666248977032,1,0,0,2.669,2,2.217,LESS
8,150,153,3,303,153,150,5.01063529409626,5.03043792139244,0.0198026272961798,10.0410732154887,5.03043792139244,5.01063529409626,1,0,0,1.624,1,1.835,LESS
8,147,150,3,297,150,147,4.99043258677874,5.01063529409626,0.0202027073175195,10.001067880875,5.01063529409626,4.99043258677874,1,0,0,2.58,2,1.175,LESS
8,150,144,6,294,144,150,5.01063529409626,4.969813299576,0.0408219945202548,9.98044859367226,4.969813299576,5.01063529409626,1,1,1,1.939,1,1.451,LESS
8,150,129,21,279,129,150,5.01063529409626,4.85981240436167,0.150822889734584,9.87044769845793,4.85981240436167,5.01063529409626,1,1,1,2.486,2,2.269,LESS
8,150,120,30,270,120,150,5.01063529409626,4.78749174278205,0.22314355131421,9.7981270368783,4.78749174278205,5.01063529409626,1,1,1,1.408,4,1.218,LESS
8,50,43,7,93,43,50,3.91202300542815,3.76120011569356,0.150822889734584,7.67322312112171,3.76120011569356,3.91202300542815,1,1,1,2.048,3,1.319,LESS
8,50,49,1,99,49,50,3.91202300542815,3.89182029811063,0.0202027073175195,7.80384330353877,3.89182029811063,3.91202300542815,1,1,1,1.246,3,1.141,LESS
8,56,50,6,106,50,56,4.02535169073515,3.91202300542815,0.113328685307004,7.9373746961633,3.91202300542815,4.02535169073515,1,1,1,1.049,4,1.035,LESS
8,58,50,8,108,50,58,4.06044301054642,3.91202300542815,0.148420005118273,7.97246601597456,3.91202300542815,4.06044301054642,1,1,1,1.389,3,1.102,LESS
8,50,54,4,104,54,50,3.91202300542815,3.98898404656427,0.0769610411361286,7.90100705199242,3.98898404656427,3.91202300542815,1,0,0,1.295,3,1.635,LESS
8,46,50,4,96,50,46,3.8286413964891,3.91202300542815,0.0833816089390509,7.74066440191724,3.91202300542815,3.8286413964891,1,0,0,1.146,3,1.039,LESS
8,40,50,10,90,40,50,3.68887945411394,3.91202300542815,0.22314355131421,7.60090245954208,3.68887945411394,3.91202300542815,0,0,1,3.111,1,1.401,LESS
8,100,96,4,196,96,100,4.60517018598809,4.56434819146784,0.0408219945202557,9.16951837745593,4.56434819146784,4.60517018598809,1,1,1,2.04,2,1.072,LESS
8,150,123,27,273,123,150,5.01063529409626,4.81218435537242,0.198450938723838,9.82281964946867,4.81218435537242,5.01063529409626,1,1,1,1.446,2,1.485,LESS
8,150,177,27,327,150,177,5.01063529409626,5.17614973257383,0.165514438477573,10.1867850266701,5.01063529409626,5.17614973257383,0,0,1,1.074,3,2.05,LESS
8,50,43,7,93,43,50,3.91202300542815,3.76120011569356,0.150822889734584,7.67322312112171,3.76120011569356,3.91202300542815,1,1,1,1.454,4,1.272,LESS
8,50,42,8,92,42,50,3.91202300542815,3.73766961828337,0.174353387144778,7.64969262371151,3.73766961828337,3.91202300542815,1,1,1,1.888,2,1.975,LESS
8,100,102,2,202,100,102,4.60517018598809,4.62497281328427,0.0198026272961789,9.23014299927236,4.60517018598809,4.62497281328427,0,0,1,1.544,1,1.125,LESS
8,57,50,7,107,50,57,4.04305126783455,3.91202300542815,0.131028262406404,7.9550742732627,3.91202300542815,4.04305126783455,1,1,1,1.123,4,1.134,LESS
8,174,150,24,324,150,174,5.15905529921453,5.01063529409626,0.148420005118274,10.1696905933108,5.01063529409626,5.15905529921453,1,1,1,1.11,3,1.152,LESS
8,132,150,18,282,150,132,4.88280192258637,5.01063529409626,0.127833371509885,9.89343721668263,5.01063529409626,4.88280192258637,1,0,0,1.42,1,1.168,LESS
8,50,49,1,99,50,49,3.91202300542815,3.89182029811063,0.0202027073175195,7.80384330353877,3.91202300542815,3.89182029811063,0,1,0,1.528,2,1.103,LESS
8,100,110,10,210,100,110,4.60517018598809,4.70048036579242,0.0953101798043248,9.30565055178051,4.60517018598809,4.70048036579242,0,0,1,1.761,2,1.052,LESS
8,53,50,3,103,53,50,3.97029191355212,3.91202300542815,0.058268908123976,7.88231491898027,3.97029191355212,3.91202300542815,0,1,0,2.954,2,1.269,LESS
8,50,48,2,98,50,48,3.91202300542815,3.87120101090789,0.0408219945202548,7.78322401633604,3.91202300542815,3.87120101090789,0,1,0,1.287,2,1.732,LESS
8,141,150,9,291,150,141,4.94875989037817,5.01063529409626,0.0618754037180871,9.95939518447442,5.01063529409626,4.94875989037817,1,0,0,1.526,1,1.251,LESS
8,50,52,2,102,52,50,3.91202300542815,3.95124371858143,0.0392207131532816,7.86326672400957,3.95124371858143,3.91202300542815,1,0,0,1.278,3,1.134,LESS
8,150,147,3,297,147,150,5.01063529409626,4.99043258677874,0.0202027073175195,10.001067880875,4.99043258677874,5.01063529409626,1,1,1,2.195,2,1.1,LESS
8,80,100,20,180,80,100,4.38202663467388,4.60517018598809,0.223143551314211,8.98719682066197,4.38202663467388,4.60517018598809,0,0,1,1.147,3,1.419,LESS
8,59,50,9,109,50,59,4.07753744390572,3.91202300542815,0.165514438477574,7.98956044933387,3.91202300542815,4.07753744390572,1,1,1,1.267,4,1.073,LESS
8,50,44,6,94,44,50,3.91202300542815,3.78418963391826,0.127833371509885,7.69621263934641,3.78418963391826,3.91202300542815,1,1,1,1.334,3,1.456,LESS
8,57,50,7,107,50,57,4.04305126783455,3.91202300542815,0.131028262406404,7.9550742732627,3.91202300542815,4.04305126783455,1,1,1,1.146,4,1.034,LESS
8,150,132,18,282,132,150,5.01063529409626,4.88280192258637,0.127833371509885,9.89343721668263,4.88280192258637,5.01063529409626,1,1,1,1.263,3,0.992,LESS
8,177,150,27,327,150,177,5.17614973257383,5.01063529409626,0.165514438477573,10.1867850266701,5.01063529409626,5.17614973257383,1,1,1,1.32,2,1.053,LESS
8,138,150,12,288,138,150,4.92725368515721,5.01063529409626,0.0833816089390504,9.93788897925346,4.92725368515721,5.01063529409626,0,0,1,2.974,1,0.957,LESS
8,100,94,6,194,100,94,4.60517018598809,4.54329478227,0.061875403718088,9.1484649682581,4.60517018598809,4.54329478227,0,1,0,1.282,2,1.337,LESS
8,56,50,6,106,50,56,4.02535169073515,3.91202300542815,0.113328685307004,7.9373746961633,3.91202300542815,4.02535169073515,1,1,1,1.184,3,0.854,LESS
8,100,84,16,184,84,100,4.60517018598809,4.43081679884331,0.174353387144778,9.03598698483141,4.43081679884331,4.60517018598809,1,1,1,1.233,3,1.085,LESS
8,102,100,2,202,100,102,4.62497281328427,4.60517018598809,0.0198026272961789,9.23014299927236,4.60517018598809,4.62497281328427,1,1,1,1.2,3,1.336,LESS
8,88,100,12,188,100,88,4.47733681447821,4.60517018598809,0.127833371509885,9.0825070004663,4.60517018598809,4.47733681447821,1,0,0,1.957,1,1.051,LESS
8,116,100,16,216,100,116,4.75359019110636,4.60517018598809,0.148420005118273,9.35876037709446,4.60517018598809,4.75359019110636,1,1,1,1.111,4,0.939,LESS
8,108,100,8,208,100,108,4.68213122712422,4.60517018598809,0.0769610411361281,9.28730141311231,4.60517018598809,4.68213122712422,1,1,1,1.309,2,1.236,LESS
8,44,50,6,94,44,50,3.78418963391826,3.91202300542815,0.127833371509885,7.69621263934641,3.78418963391826,3.91202300542815,0,0,1,1.185,3,1.017,LESS
8,150,132,18,282,132,150,5.01063529409626,4.88280192258637,0.127833371509885,9.89343721668263,4.88280192258637,5.01063529409626,1,1,1,1.305,2,1.066,LESS
8,50,45,5,95,45,50,3.91202300542815,3.80666248977032,0.105360515657826,7.71868549519847,3.80666248977032,3.91202300542815,1,1,1,1.387,4,0.853,LESS
8,84,100,16,184,84,100,4.43081679884331,4.60517018598809,0.174353387144778,9.03598698483141,4.43081679884331,4.60517018598809,0,0,1,1.277,3,1.001,LESS
8,150,135,15,285,135,150,5.01063529409626,4.90527477843843,0.105360515657826,9.91591007253469,4.90527477843843,5.01063529409626,1,1,1,1.12,3,0.933,LESS
8,110,100,10,210,100,110,4.70048036579242,4.60517018598809,0.0953101798043248,9.30565055178051,4.60517018598809,4.70048036579242,1,1,1,1.841,1,0.907,LESS
8,96,100,4,196,96,100,4.56434819146784,4.60517018598809,0.0408219945202557,9.16951837745593,4.56434819146784,4.60517018598809,0,0,1,1.131,3,1.158,LESS
8,100,98,2,198,98,100,4.60517018598809,4.58496747867057,0.0202027073175195,9.19013766465866,4.58496747867057,4.60517018598809,1,1,1,1.6,2,0.954,LESS
8,50,47,3,97,47,50,3.91202300542815,3.85014760171006,0.0618754037180875,7.7621706071382,3.85014760171006,3.91202300542815,1,1,1,1.256,4,1.006,LESS
8,116,100,16,216,116,100,4.75359019110636,4.60517018598809,0.148420005118273,9.35876037709446,4.75359019110636,4.60517018598809,0,1,0,1.67,2,0.855,LESS
8,162,150,12,312,150,162,5.08759633523238,5.01063529409626,0.0769610411361281,10.0982316293286,5.01063529409626,5.08759633523238,1,1,1,1.19,3,0.983,LESS
8,50,41,9,91,41,50,3.91202300542815,3.71357206670431,0.198450938723838,7.62559507213245,3.71357206670431,3.91202300542815,1,1,1,1.141,4,0.852,LESS
8,50,59,9,109,50,59,3.91202300542815,4.07753744390572,0.165514438477574,7.98956044933387,3.91202300542815,4.07753744390572,0,0,1,1.928,2,0.97,LESS
8,48,50,2,98,48,50,3.87120101090789,3.91202300542815,0.0408219945202548,7.78322401633604,3.87120101090789,3.91202300542815,0,0,1,1.324,2,1.307,LESS
8,100,88,12,188,100,88,4.60517018598809,4.47733681447821,0.127833371509885,9.0825070004663,4.60517018598809,4.47733681447821,0,1,0,1.239,1,3.184,LESS
8,150,144,6,294,144,150,5.01063529409626,4.969813299576,0.0408219945202548,9.98044859367226,4.969813299576,5.01063529409626,1,1,1,1.273,3,1.001,LESS
8,104,100,4,204,100,104,4.64439089914137,4.60517018598809,0.0392207131532807,9.24956108512946,4.60517018598809,4.64439089914137,1,1,1,1.104,3,1.834,LESS
8,120,100,20,220,100,120,4.78749174278205,4.60517018598809,0.182321556793954,9.39266192877014,4.60517018598809,4.78749174278205,1,1,1,1.099,4,1.519,LESS
8,150,162,12,312,150,162,5.01063529409626,5.08759633523238,0.0769610411361281,10.0982316293286,5.01063529409626,5.08759633523238,0,0,1,2.501,1,0.931,LESS
8,150,174,24,324,174,150,5.01063529409626,5.15905529921453,0.148420005118274,10.1696905933108,5.15905529921453,5.01063529409626,1,0,0,1.853,2,0.986,LESS
8,100,98,2,198,100,98,4.60517018598809,4.58496747867057,0.0202027073175195,9.19013766465866,4.60517018598809,4.58496747867057,0,1,0,1.334,3,0.833,LESS
8,100,92,8,192,92,100,4.60517018598809,4.52178857704904,0.0833816089390513,9.12695876303713,4.52178857704904,4.60517018598809,1,1,1,1.274,4,0.951,LESS
8,112,100,12,212,100,112,4.71849887129509,4.60517018598809,0.113328685307002,9.32366905728319,4.60517018598809,4.71849887129509,1,1,1,1.224,4,1.291,LESS
8,150,162,12,312,150,162,5.01063529409626,5.08759633523238,0.0769610411361281,10.0982316293286,5.01063529409626,5.08759633523238,0,0,1,1.806,2,0.934,LESS
8,110,100,10,210,100,110,4.70048036579242,4.60517018598809,0.0953101798043248,9.30565055178051,4.60517018598809,4.70048036579242,1,1,1,1.236,4,1.022,LESS
8,162,150,12,312,150,162,5.08759633523238,5.01063529409626,0.0769610411361281,10.0982316293286,5.01063529409626,5.08759633523238,1,1,1,1.475,3,1.016,LESS
8,49,50,1,99,49,50,3.89182029811063,3.91202300542815,0.0202027073175195,7.80384330353877,3.89182029811063,3.91202300542815,0,0,1,1.86,2,0.902,LESS
8,50,57,7,107,57,50,3.91202300542815,4.04305126783455,0.131028262406404,7.9550742732627,4.04305126783455,3.91202300542815,1,0,0,1.904,2,1.053,LESS
8,86,100,14,186,86,100,4.45434729625351,4.60517018598809,0.150822889734584,9.0595174822416,4.45434729625351,4.60517018598809,0,0,1,2.52,2,0.887,LESS
8,50,48,2,98,48,50,3.91202300542815,3.87120101090789,0.0408219945202548,7.78322401633604,3.87120101090789,3.91202300542815,1,1,1,1.538,3,1.025,LESS
8,156,150,6,306,150,156,5.04985600724954,5.01063529409626,0.0392207131532816,10.0604913013458,5.01063529409626,5.04985600724954,1,1,1,1.192,3,0.852,LESS
8,150,171,21,321,150,171,5.01063529409626,5.14166355650266,0.131028262406405,10.1522988505989,5.01063529409626,5.14166355650266,0,0,1,2.217,1,0.787,LESS
8,150,165,15,315,150,165,5.01063529409626,5.10594547390058,0.0953101798043248,10.1165807679968,5.01063529409626,5.10594547390058,0,0,1,1.244,2,0.85,LESS
8,100,90,10,190,90,100,4.60517018598809,4.49980967033027,0.105360515657827,9.10497985631836,4.49980967033027,4.60517018598809,1,1,1,1.304,2,1.187,LESS
8,112,100,12,212,100,112,4.71849887129509,4.60517018598809,0.113328685307002,9.32366905728319,4.60517018598809,4.71849887129509,1,1,1,1.081,3,0.885,LESS
8,43,50,7,93,43,50,3.76120011569356,3.91202300542815,0.150822889734584,7.67322312112171,3.76120011569356,3.91202300542815,0,0,1,1.277,4,0.839,LESS
8,100,110,10,210,110,100,4.60517018598809,4.70048036579242,0.0953101798043248,9.30565055178051,4.70048036579242,4.60517018598809,1,0,0,1.369,3,0.905,LESS
8,100,112,12,212,112,100,4.60517018598809,4.71849887129509,0.113328685307002,9.32366905728319,4.71849887129509,4.60517018598809,1,0,0,1.211,3,0.854,LESS
8,100,118,18,218,100,118,4.60517018598809,4.77068462446567,0.165514438477573,9.37585481045376,4.60517018598809,4.77068462446567,0,0,1,1.15,4,0.84,LESS
8,90,100,10,190,90,100,4.49980967033027,4.60517018598809,0.105360515657827,9.10497985631836,4.49980967033027,4.60517018598809,0,0,1,1.255,2,0.969,LESS
8,51,50,1,101,50,51,3.93182563272433,3.91202300542815,0.0198026272961798,7.84384863815247,3.91202300542815,3.93182563272433,1,1,1,1.324,2,1.271,LESS
8,96,100,4,196,96,100,4.56434819146784,4.60517018598809,0.0408219945202557,9.16951837745593,4.56434819146784,4.60517018598809,0,0,1,1.782,1,1.166,LESS
8,41,50,9,91,41,50,3.71357206670431,3.91202300542815,0.198450938723838,7.62559507213245,3.71357206670431,3.91202300542815,0,0,1,1.209,4,0.883,LESS
8,168,150,18,318,150,168,5.12396397940326,5.01063529409626,0.113328685307003,10.1345992734995,5.01063529409626,5.12396397940326,1,1,1,1.061,2,1.035,LESS
8,150,138,12,288,138,150,5.01063529409626,4.92725368515721,0.0833816089390504,9.93788897925346,4.92725368515721,5.01063529409626,1,1,1,1.574,2,1.02,LESS
8,50,40,10,90,40,50,3.91202300542815,3.68887945411394,0.22314355131421,7.60090245954208,3.68887945411394,3.91202300542815,1,1,1,1.339,4,0.889,LESS
8,150,174,24,324,150,174,5.01063529409626,5.15905529921453,0.148420005118274,10.1696905933108,5.01063529409626,5.15905529921453,0,0,1,1.254,2,1.174,LESS
8,50,60,10,110,50,60,3.91202300542815,4.0943445622221,0.182321556793954,8.00636756765025,3.91202300542815,4.0943445622221,0,0,1,1.184,4,0.833,LESS
8,44,50,6,94,44,50,3.78418963391826,3.91202300542815,0.127833371509885,7.69621263934641,3.78418963391826,3.91202300542815,0,0,1,1.96,3,1.173,LESS
8,42,50,8,92,42,50,3.73766961828337,3.91202300542815,0.174353387144778,7.64969262371151,3.73766961828337,3.91202300542815,0,0,1,1.32,4,0.886,LESS
8,47,50,3,97,47,50,3.85014760171006,3.91202300542815,0.0618754037180875,7.7621706071382,3.85014760171006,3.91202300542815,0,0,1,1.334,3,1.066,LESS
8,150,147,3,297,147,150,5.01063529409626,4.99043258677874,0.0202027073175195,10.001067880875,4.99043258677874,5.01063529409626,1,1,1,1.43,1,0.981,LESS
8,100,120,20,220,120,100,4.60517018598809,4.78749174278205,0.182321556793954,9.39266192877014,4.78749174278205,4.60517018598809,1,0,0,1.88,1,1.233,LESS
8,120,100,20,220,100,120,4.78749174278205,4.60517018598809,0.182321556793954,9.39266192877014,4.60517018598809,4.78749174278205,1,1,1,1.288,2,0.898,LESS
8,100,86,14,186,86,100,4.60517018598809,4.45434729625351,0.150822889734584,9.0595174822416,4.45434729625351,4.60517018598809,1,1,1,1.426,3,1.071,LESS
8,100,114,14,214,114,100,4.60517018598809,4.7361984483945,0.131028262406404,9.34136863438259,4.7361984483945,4.60517018598809,1,0,0,1.921,1,0.999,LESS
8,150,129,21,279,129,150,5.01063529409626,4.85981240436167,0.150822889734584,9.87044769845793,4.85981240436167,5.01063529409626,1,1,1,1.292,2,0.951,LESS
8,120,150,30,270,120,150,4.78749174278205,5.01063529409626,0.22314355131421,9.7981270368783,4.78749174278205,5.01063529409626,0,0,1,1.283,3,0.782,LESS
8,50,51,1,101,50,51,3.91202300542815,3.93182563272433,0.0198026272961798,7.84384863815247,3.91202300542815,3.93182563272433,0,0,1,1.33,3,0.954,LESS
8,50,47,3,97,47,50,3.91202300542815,3.85014760171006,0.0618754037180875,7.7621706071382,3.85014760171006,3.91202300542815,1,1,1,1.685,2,1.137,LESS
8,55,50,5,105,50,55,4.00733318523247,3.91202300542815,0.0953101798043252,7.91935619066062,3.91202300542815,4.00733318523247,1,1,1,1.323,3,0.882,LESS
8,55,50,5,105,50,55,4.00733318523247,3.91202300542815,0.0953101798043252,7.91935619066062,3.91202300542815,4.00733318523247,1,1,1,1.367,3,0.869,LESS
8,129,150,21,279,150,129,4.85981240436167,5.01063529409626,0.150822889734584,9.87044769845793,5.01063529409626,4.85981240436167,1,0,0,1.422,1,2.633,LESS
8,100,90,10,190,100,90,4.60517018598809,4.49980967033027,0.105360515657827,9.10497985631836,4.60517018598809,4.49980967033027,0,1,0,2.14,2,0.932,LESS
8,106,100,6,206,100,106,4.66343909411207,4.60517018598809,0.0582689081239751,9.26860928010016,4.60517018598809,4.66343909411207,1,1,1,1.444,2,1.051,LESS
8,50,58,8,108,50,58,3.91202300542815,4.06044301054642,0.148420005118273,7.97246601597456,3.91202300542815,4.06044301054642,0,0,1,1.534,4,1.755,LESS
8,100,86,14,186,86,100,4.60517018598809,4.45434729625351,0.150822889734584,9.0595174822416,4.45434729625351,4.60517018598809,1,1,1,1.728,3,0.867,LESS
8,50,40,10,90,40,50,3.91202300542815,3.68887945411394,0.22314355131421,7.60090245954208,3.68887945411394,3.91202300542815,1,1,1,2.071,3,1.098,LESS
8,100,112,12,212,100,112,4.60517018598809,4.71849887129509,0.113328685307002,9.32366905728319,4.60517018598809,4.71849887129509,0,0,1,1.321,2,1.018,LESS
8,50,55,5,105,50,55,3.91202300542815,4.00733318523247,0.0953101798043252,7.91935619066062,3.91202300542815,4.00733318523247,0,0,1,1.248,3,0.985,LESS
8,50,51,1,101,50,51,3.91202300542815,3.93182563272433,0.0198026272961798,7.84384863815247,3.91202300542815,3.93182563272433,0,0,1,1.389,4,0.95,LESS
8,92,100,8,192,92,100,4.52178857704904,4.60517018598809,0.0833816089390513,9.12695876303713,4.52178857704904,4.60517018598809,0,0,1,1.677,2,0.833,LESS
8,150,135,15,285,135,150,5.01063529409626,4.90527477843843,0.105360515657826,9.91591007253469,4.90527477843843,5.01063529409626,1,1,1,1.097,2,0.947,LESS
8,123,150,27,273,123,150,4.81218435537242,5.01063529409626,0.198450938723838,9.82281964946867,4.81218435537242,5.01063529409626,0,0,1,2.469,1,0.9,LESS
8,150,165,15,315,165,150,5.01063529409626,5.10594547390058,0.0953101798043248,10.1165807679968,5.10594547390058,5.01063529409626,1,0,0,1.289,2,0.981,LESS
8,54,50,4,104,50,54,3.98898404656427,3.91202300542815,0.0769610411361286,7.90100705199242,3.91202300542815,3.98898404656427,1,1,1,1.707,3,1.117,LESS
8,150,177,27,327,150,177,5.01063529409626,5.17614973257383,0.165514438477573,10.1867850266701,5.01063529409626,5.17614973257383,0,0,1,1.428,3,1.219,LESS
8,100,104,4,204,104,100,4.60517018598809,4.64439089914137,0.0392207131532807,9.24956108512946,4.64439089914137,4.60517018598809,1,0,0,1.631,1,0.903,LESS
8,52,50,2,102,52,50,3.95124371858143,3.91202300542815,0.0392207131532816,7.86326672400957,3.95124371858143,3.91202300542815,0,1,0,1.233,4,0.901,LESS
8,150,180,30,330,150,180,5.01063529409626,5.19295685089021,0.182321556793955,10.2035921449865,5.01063529409626,5.19295685089021,0,0,1,1.337,2,0.972,LESS
8,43,50,7,93,43,50,3.76120011569356,3.91202300542815,0.150822889734584,7.67322312112171,3.76120011569356,3.91202300542815,0,0,1,1.211,4,1.072,LESS
8,100,108,8,208,100,108,4.60517018598809,4.68213122712422,0.0769610411361281,9.28730141311231,4.60517018598809,4.68213122712422,0,0,1,1.735,2,0.934,LESS
8,54,50,4,104,50,54,3.98898404656427,3.91202300542815,0.0769610411361286,7.90100705199242,3.91202300542815,3.98898404656427,1,1,1,1.867,1,1.016,LESS
8,41,50,9,91,41,50,3.71357206670431,3.91202300542815,0.198450938723838,7.62559507213245,3.71357206670431,3.91202300542815,0,0,1,1.328,4,1.015,LESS
8,50,41,9,91,41,50,3.91202300542815,3.71357206670431,0.198450938723838,7.62559507213245,3.71357206670431,3.91202300542815,1,1,1,1.632,2,0.902,LESS
8,42,50,8,92,42,50,3.73766961828337,3.91202300542815,0.174353387144778,7.64969262371151,3.73766961828337,3.91202300542815,0,0,1,1.242,4,0.989,LESS
8,100,80,20,180,80,100,4.60517018598809,4.38202663467388,0.223143551314211,8.98719682066197,4.38202663467388,4.60517018598809,1,1,1,1.248,4,0.985,LESS
8,48,50,2,98,48,50,3.87120101090789,3.91202300542815,0.0408219945202548,7.78322401633604,3.87120101090789,3.91202300542815,0,0,1,1.162,4,0.869,LESS
8,50,56,6,106,50,56,3.91202300542815,4.02535169073515,0.113328685307004,7.9373746961633,3.91202300542815,4.02535169073515,0,0,1,1.169,4,0.932,LESS
8,123,150,27,273,123,150,4.81218435537242,5.01063529409626,0.198450938723838,9.82281964946867,4.81218435537242,5.01063529409626,0,0,1,1.658,2,1.083,LESS
8,132,150,18,282,132,150,4.88280192258637,5.01063529409626,0.127833371509885,9.89343721668263,4.88280192258637,5.01063529409626,0,0,1,1.092,3,1.772,LESS
8,171,150,21,321,150,171,5.14166355650266,5.01063529409626,0.131028262406405,10.1522988505989,5.01063529409626,5.14166355650266,1,1,1,1.085,3,0.915,LESS
8,147,150,3,297,150,147,4.99043258677874,5.01063529409626,0.0202027073175195,10.001067880875,5.01063529409626,4.99043258677874,1,0,0,2.105,1,0.981,LESS
8,50,60,10,110,50,60,3.91202300542815,4.0943445622221,0.182321556793954,8.00636756765025,3.91202300542815,4.0943445622221,0,0,1,1.171,4,0.849,LESS
8,80,100,20,180,80,100,4.38202663467388,4.60517018598809,0.223143551314211,8.98719682066197,4.38202663467388,4.60517018598809,0,0,1,1.281,2,0.949,LESS
8,150,171,21,321,150,171,5.01063529409626,5.14166355650266,0.131028262406405,10.1522988505989,5.01063529409626,5.14166355650266,0,0,1,1.856,2,1.052,LESS
8,114,100,14,214,100,114,4.7361984483945,4.60517018598809,0.131028262406404,9.34136863438259,4.60517018598809,4.7361984483945,1,1,1,1.168,1,1.615,LESS
8,100,82,18,182,100,82,4.60517018598809,4.40671924726425,0.198450938723838,9.01188943325235,4.60517018598809,4.40671924726425,0,1,0,1.487,3,0.882,LESS
8,180,150,30,330,150,180,5.19295685089021,5.01063529409626,0.182321556793955,10.2035921449865,5.01063529409626,5.19295685089021,1,1,1,1.053,3,0.822,LESS
8,168,150,18,318,150,168,5.12396397940326,5.01063529409626,0.113328685307003,10.1345992734995,5.01063529409626,5.12396397940326,1,1,1,0.982,3,0.797,LESS
8,88,100,12,188,88,100,4.47733681447821,4.60517018598809,0.127833371509885,9.0825070004663,4.47733681447821,4.60517018598809,0,0,1,1.058,3,0.955,LESS
8,100,94,6,194,94,100,4.60517018598809,4.54329478227,0.061875403718088,9.1484649682581,4.54329478227,4.60517018598809,1,1,1,1.408,2,0.919,LESS
8,50,46,4,96,50,46,3.91202300542815,3.8286413964891,0.0833816089390509,7.74066440191724,3.91202300542815,3.8286413964891,0,1,0,1.408,3,1.225,LESS
8,84,100,16,184,84,100,4.43081679884331,4.60517018598809,0.174353387144778,9.03598698483141,4.43081679884331,4.60517018598809,0,0,1,1.343,3,1.357,LESS
8,82,100,18,182,82,100,4.40671924726425,4.60517018598809,0.198450938723838,9.01188943325235,4.40671924726425,4.60517018598809,0,0,1,1.401,2,1.066,LESS
8,144,150,6,294,150,144,4.969813299576,5.01063529409626,0.0408219945202548,9.98044859367226,5.01063529409626,4.969813299576,1,0,0,1.782,1,1.051,LESS
8,50,53,3,103,50,53,3.91202300542815,3.97029191355212,0.058268908123976,7.88231491898027,3.91202300542815,3.97029191355212,0,0,1,1.243,4,1.082,LESS
8,100,88,12,188,88,100,4.60517018598809,4.47733681447821,0.127833371509885,9.0825070004663,4.47733681447821,4.60517018598809,1,1,1,3.668,1,1.007,LESS
8,150,138,12,288,138,150,5.01063529409626,4.92725368515721,0.0833816089390504,9.93788897925346,4.92725368515721,5.01063529409626,1,1,1,1.321,3,0.931,LESS
8,46,50,4,96,46,50,3.8286413964891,3.91202300542815,0.0833816089390509,7.74066440191724,3.8286413964891,3.91202300542815,0,0,1,1.22,3,0.989,LESS
8,100,118,18,218,118,100,4.60517018598809,4.77068462446567,0.165514438477573,9.37585481045376,4.77068462446567,4.60517018598809,1,0,0,1.388,2,1.282,LESS
8,150,168,18,318,150,168,5.01063529409626,5.12396397940326,0.113328685307003,10.1345992734995,5.01063529409626,5.12396397940326,0,0,1,1.214,2,1.02,LESS
8,59,50,9,109,50,59,4.07753744390572,3.91202300542815,0.165514438477574,7.98956044933387,3.91202300542815,4.07753744390572,1,1,1,1.22,3,0.97,LESS
8,150,123,27,273,123,150,5.01063529409626,4.81218435537242,0.198450938723838,9.82281964946867,4.81218435537242,5.01063529409626,1,1,1,1.528,2,1.233,LESS
8,100,116,16,216,100,116,4.60517018598809,4.75359019110636,0.148420005118273,9.35876037709446,4.60517018598809,4.75359019110636,0,0,1,1.887,2,1.082,LESS
8,100,82,18,182,82,100,4.60517018598809,4.40671924726425,0.198450938723838,9.01188943325235,4.40671924726425,4.60517018598809,1,1,1,1.381,3,1.133,LESS
8,100,108,8,208,100,108,4.60517018598809,4.68213122712422,0.0769610411361281,9.28730141311231,4.60517018598809,4.68213122712422,0,0,1,1.239,3,1.121,LESS
8,126,150,24,276,126,150,4.83628190695148,5.01063529409626,0.174353387144778,9.84691720104773,4.83628190695148,5.01063529409626,0,0,1,2.118,1,0.831,LESS
8,50,53,3,103,53,50,3.91202300542815,3.97029191355212,0.058268908123976,7.88231491898027,3.97029191355212,3.91202300542815,1,0,0,1.414,4,1.049,LESS
8,50,55,5,105,50,55,3.91202300542815,4.00733318523247,0.0953101798043252,7.91935619066062,3.91202300542815,4.00733318523247,0,0,1,1.311,4,0.902,LESS
8,135,150,15,285,135,150,4.90527477843843,5.01063529409626,0.105360515657826,9.91591007253469,4.90527477843843,5.01063529409626,0,0,1,1.294,2,1.119,LESS
8,150,180,30,330,150,180,5.01063529409626,5.19295685089021,0.182321556793955,10.2035921449865,5.01063529409626,5.19295685089021,0,0,1,1.679,2,1.049,LESS
8,150,126,24,276,126,150,5.01063529409626,4.83628190695148,0.174353387144778,9.84691720104773,4.83628190695148,5.01063529409626,1,1,1,1.123,4,1.032,LESS
8,98,100,2,198,98,100,4.58496747867057,4.60517018598809,0.0202027073175195,9.19013766465866,4.58496747867057,4.60517018598809,0,0,1,1.158,3,0.971,LESS
8,150,126,24,276,126,150,5.01063529409626,4.83628190695148,0.174353387144778,9.84691720104773,4.83628190695148,5.01063529409626,1,1,1,1.037,4,0.884,LESS
8,94,100,6,194,100,94,4.54329478227,4.60517018598809,0.061875403718088,9.1484649682581,4.60517018598809,4.54329478227,1,0,0,1.657,1,1.065,LESS
8,50,59,9,109,50,59,3.91202300542815,4.07753744390572,0.165514438477574,7.98956044933387,3.91202300542815,4.07753744390572,0,0,1,1.01,4,0.985,LESS
8,100,106,6,206,106,100,4.60517018598809,4.66343909411207,0.0582689081239751,9.26860928010016,4.66343909411207,4.60517018598809,1,0,0,1.118,3,0.952,LESS
8,150,168,18,318,150,168,5.01063529409626,5.12396397940326,0.113328685307003,10.1345992734995,5.01063529409626,5.12396397940326,0,0,1,2.244,1,0.916,LESS
8,100,92,8,192,92,100,4.60517018598809,4.52178857704904,0.0833816089390513,9.12695876303713,4.52178857704904,4.60517018598809,1,1,1,2.182,2,0.916,LESS
8,50,57,7,107,50,57,3.91202300542815,4.04305126783455,0.131028262406404,7.9550742732627,3.91202300542815,4.04305126783455,0,0,1,1.804,3,0.949,LESS
8,47,50,3,97,50,47,3.85014760171006,3.91202300542815,0.0618754037180875,7.7621706071382,3.91202300542815,3.85014760171006,1,0,0,1.549,3,1.373,LESS
8,100,120,20,220,100,120,4.60517018598809,4.78749174278205,0.182321556793954,9.39266192877014,4.60517018598809,4.78749174278205,0,0,1,1.061,2,1.367,LESS
8,52,50,2,102,50,52,3.95124371858143,3.91202300542815,0.0392207131532816,7.86326672400957,3.91202300542815,3.95124371858143,1,1,1,1.339,2,1.083,LESS
8,153,150,3,303,153,150,5.03043792139244,5.01063529409626,0.0198026272961798,10.0410732154887,5.03043792139244,5.01063529409626,0,1,0,1.311,1,1.117,LESS
8,165,150,15,315,150,165,5.10594547390058,5.01063529409626,0.0953101798043248,10.1165807679968,5.01063529409626,5.10594547390058,1,1,1,1.955,1,0.965,LESS
8,100,106,6,206,106,100,4.60517018598809,4.66343909411207,0.0582689081239751,9.26860928010016,4.66343909411207,4.60517018598809,1,0,0,1.718,2,0.884,LESS
8,86,100,14,186,86,100,4.45434729625351,4.60517018598809,0.150822889734584,9.0595174822416,4.45434729625351,4.60517018598809,0,0,1,1.046,4,0.967,LESS
8,159,150,9,309,150,159,5.06890420222023,5.01063529409626,0.058268908123976,10.0795394963165,5.01063529409626,5.06890420222023,1,1,1,1.118,4,1.305,LESS
8,150,153,3,303,153,150,5.01063529409626,5.03043792139244,0.0198026272961798,10.0410732154887,5.03043792139244,5.01063529409626,1,0,0,1.564,2,1.488,LESS
8,126,150,24,276,126,150,4.83628190695148,5.01063529409626,0.174353387144778,9.84691720104773,4.83628190695148,5.01063529409626,0,0,1,1.105,3,0.97,LESS
8,50,56,6,106,50,56,3.91202300542815,4.02535169073515,0.113328685307004,7.9373746961633,3.91202300542815,4.02535169073515,0,0,1,1.143,4,0.932,LESS
8,141,150,9,291,141,150,4.94875989037817,5.01063529409626,0.0618754037180871,9.95939518447442,4.94875989037817,5.01063529409626,0,0,1,1.082,3,0.971,LESS
8,150,159,9,309,150,159,5.01063529409626,5.06890420222023,0.058268908123976,10.0795394963165,5.01063529409626,5.06890420222023,0,0,1,1.569,1,1.006,LESS
8,108,100,8,208,100,108,4.68213122712422,4.60517018598809,0.0769610411361281,9.28730141311231,4.60517018598809,4.68213122712422,1,1,1,1.625,2,0.839,LESS
8,50,58,8,108,50,58,3.91202300542815,4.06044301054642,0.148420005118273,7.97246601597456,3.91202300542815,4.06044301054642,0,0,1,1.195,3,0.882,LESS
8,60,50,10,110,50,60,4.0943445622221,3.91202300542815,0.182321556793954,8.00636756765025,3.91202300542815,4.0943445622221,1,1,1,1.198,3,0.918,LESS
8,98,100,2,198,98,100,4.58496747867057,4.60517018598809,0.0202027073175195,9.19013766465866,4.58496747867057,4.60517018598809,0,0,1,2.427,2,0.951,LESS
8,40,50,10,90,40,50,3.68887945411394,3.91202300542815,0.22314355131421,7.60090245954208,3.68887945411394,3.91202300542815,0,0,1,1.173,4,0.866,LESS
8,49,50,1,99,49,50,3.89182029811063,3.91202300542815,0.0202027073175195,7.80384330353877,3.89182029811063,3.91202300542815,0,0,1,1.137,4,1.065,LESS
8,150,120,30,270,120,150,5.01063529409626,4.78749174278205,0.22314355131421,9.7981270368783,4.78749174278205,5.01063529409626,1,1,1,1.114,4,0.818,LESS
8,94,100,6,194,100,94,4.54329478227,4.60517018598809,0.061875403718088,9.1484649682581,4.60517018598809,4.54329478227,1,0,0,1.303,3,0.989,LESS
8,50,45,5,95,45,50,3.91202300542815,3.80666248977032,0.105360515657826,7.71868549519847,3.80666248977032,3.91202300542815,1,1,1,1.345,3,1.255,LESS
8,150,156,6,306,150,156,5.01063529409626,5.04985600724954,0.0392207131532816,10.0604913013458,5.01063529409626,5.04985600724954,0,0,1,1.165,2,1.116,LESS
8,104,100,4,204,100,104,4.64439089914137,4.60517018598809,0.0392207131532807,9.24956108512946,4.60517018598809,4.64439089914137,1,1,1,1.2,2,0.989,LESS
8,50,54,4,104,50,54,3.91202300542815,3.98898404656427,0.0769610411361286,7.90100705199242,3.91202300542815,3.98898404656427,0,0,1,1.309,3,1.048,LESS
8,50,46,4,96,46,50,3.91202300542815,3.8286413964891,0.0833816089390509,7.74066440191724,3.8286413964891,3.91202300542815,1,1,1,1.775,2,1.385,LESS
8,165,150,15,315,150,165,5.10594547390058,5.01063529409626,0.0953101798043248,10.1165807679968,5.01063529409626,5.10594547390058,1,1,1,1.481,3,3.037,LESS
8,153,150,3,303,153,150,5.03043792139244,5.01063529409626,0.0198026272961798,10.0410732154887,5.03043792139244,5.01063529409626,0,1,0,2.886,1,0.948,LESS
8,171,150,21,321,150,171,5.14166355650266,5.01063529409626,0.131028262406405,10.1522988505989,5.01063529409626,5.14166355650266,1,1,1,1.129,4,0.904,LESS
8,50,44,6,94,50,44,3.91202300542815,3.78418963391826,0.127833371509885,7.69621263934641,3.91202300542815,3.78418963391826,0,1,0,3.25,2,0.965,LESS
8,100,96,4,196,96,100,4.60517018598809,4.56434819146784,0.0408219945202557,9.16951837745593,4.56434819146784,4.60517018598809,1,1,1,1.251,2,0.948,LESS
8,100,116,16,216,100,116,4.60517018598809,4.75359019110636,0.148420005118273,9.35876037709446,4.60517018598809,4.75359019110636,0,0,1,1.141,4,0.982,LESS
8,156,150,6,306,150,156,5.04985600724954,5.01063529409626,0.0392207131532816,10.0604913013458,5.01063529409626,5.04985600724954,1,1,1,1.571,1,1.165,LESS
8,159,150,9,309,150,159,5.06890420222023,5.01063529409626,0.058268908123976,10.0795394963165,5.01063529409626,5.06890420222023,1,1,1,1.907,2,1.221,LESS
8,135,150,15,285,150,135,4.90527477843843,5.01063529409626,0.105360515657826,9.91591007253469,5.01063529409626,4.90527477843843,1,0,0,1.246,2,1.398,LESS
8,53,50,3,103,53,50,3.97029191355212,3.91202300542815,0.058268908123976,7.88231491898027,3.97029191355212,3.91202300542815,0,1,0,1.283,3,0.987,LESS
8,180,150,30,330,150,180,5.19295685089021,5.01063529409626,0.182321556793955,10.2035921449865,5.01063529409626,5.19295685089021,1,1,1,1.265,3,0.984,LESS
8,118,100,18,218,100,118,4.77068462446567,4.60517018598809,0.165514438477573,9.37585481045376,4.60517018598809,4.77068462446567,1,1,1,1.246,2,1.033,LESS
8,50,52,2,102,50,52,3.91202300542815,3.95124371858143,0.0392207131532816,7.86326672400957,3.91202300542815,3.95124371858143,0,0,1,1.936,3,1.032,LESS
8,102,100,2,202,100,102,4.62497281328427,4.60517018598809,0.0198026272961789,9.23014299927236,4.60517018598809,4.62497281328427,1,1,1,1.391,2,1.647,LESS
8,118,100,18,218,100,118,4.77068462446567,4.60517018598809,0.165514438477573,9.37585481045376,4.60517018598809,4.77068462446567,1,1,1,1.169,3,1.105,LESS
8,150,141,9,291,141,150,5.01063529409626,4.94875989037817,0.0618754037180871,9.95939518447442,4.94875989037817,5.01063529409626,1,1,1,1.183,3,0.917,LESS
8,150,156,6,306,156,150,5.01063529409626,5.04985600724954,0.0392207131532816,10.0604913013458,5.04985600724954,5.01063529409626,1,0,0,1.383,1,1.082,LESS
8,120,150,30,270,120,150,4.78749174278205,5.01063529409626,0.22314355131421,9.7981270368783,4.78749174278205,5.01063529409626,0,0,1,1.202,2,1.001,LESS
8,150,159,9,309,159,150,5.01063529409626,5.06890420222023,0.058268908123976,10.0795394963165,5.06890420222023,5.01063529409626,1,0,0,1.768,2,1.148,LESS
8,92,100,8,192,92,100,4.52178857704904,4.60517018598809,0.0833816089390513,9.12695876303713,4.52178857704904,4.60517018598809,0,0,1,1.201,4,1.002,LESS
8,90,100,10,190,90,100,4.49980967033027,4.60517018598809,0.105360515657827,9.10497985631836,4.49980967033027,4.60517018598809,0,0,1,1.058,3,1.071,LESS
8,150,141,9,291,141,150,5.01063529409626,4.94875989037817,0.0618754037180871,9.95939518447442,4.94875989037817,5.01063529409626,1,1,1,1.515,1,1.017,LESS
8,51,50,1,101,51,50,3.93182563272433,3.91202300542815,0.0198026272961798,7.84384863815247,3.93182563272433,3.91202300542815,0,1,0,1.153,4,0.935,LESS
8,82,100,18,182,82,100,4.40671924726425,4.60517018598809,0.198450938723838,9.01188943325235,4.40671924726425,4.60517018598809,0,0,1,0.977,3,0.916,LESS
8,60,50,10,110,50,60,4.0943445622221,3.91202300542815,0.182321556793954,8.00636756765025,3.91202300542815,4.0943445622221,1,1,1,1.293,2,0.967,LESS
8,100,80,20,180,80,100,4.60517018598809,4.38202663467388,0.223143551314211,8.98719682066197,4.38202663467388,4.60517018598809,1,1,1,1.196,2,1.221,LESS
8,100,104,4,204,100,104,4.60517018598809,4.64439089914137,0.0392207131532807,9.24956108512946,4.60517018598809,4.64439089914137,0,0,1,1.017,1,2.061,LESS
8,100,84,16,184,100,84,4.60517018598809,4.43081679884331,0.174353387144778,9.03598698483141,4.60517018598809,4.43081679884331,0,1,0,1.452,2,1.132,LESS
8,114,100,14,214,100,114,4.7361984483945,4.60517018598809,0.131028262406404,9.34136863438259,4.60517018598809,4.7361984483945,1,1,1,1.346,1,1.173,LESS
8,58,50,8,108,50,58,4.06044301054642,3.91202300542815,0.148420005118273,7.97246601597456,3.91202300542815,4.06044301054642,1,1,1,1.386,3,0.921,LESS
8,174,150,24,324,150,174,5.15905529921453,5.01063529409626,0.148420005118274,10.1696905933108,5.01063529409626,5.15905529921453,1,1,1,1.15,3,1.04,LESS
8,144,150,6,294,150,144,4.969813299576,5.01063529409626,0.0408219945202548,9.98044859367226,5.01063529409626,4.969813299576,1,0,0,1.513,1,0.948,LESS
8,106,100,6,206,106,100,4.66343909411207,4.60517018598809,0.0582689081239751,9.26860928010016,4.66343909411207,4.60517018598809,0,1,0,2.389,1,1.083,LESS
8,177,150,27,327,150,177,5.17614973257383,5.01063529409626,0.165514438477573,10.1867850266701,5.01063529409626,5.17614973257383,1,1,1,1.167,2,0.947,LESS
8,50,42,8,92,42,50,3.91202300542815,3.73766961828337,0.174353387144778,7.64969262371151,3.73766961828337,3.91202300542815,1,1,1,1.399,3,1.056,LESS
8,100,114,14,214,114,100,4.60517018598809,4.7361984483945,0.131028262406404,9.34136863438259,4.7361984483945,4.60517018598809,1,0,0,2.722,2,1.906,LESS
9,50,56,6,106,56,50,3.91202300542815,4.02535169073515,0.113328685307004,7.9373746961633,4.02535169073515,3.91202300542815,1,0,0,1.079,2,1.1475,LESS
9,80,100,20,180,80,100,4.38202663467388,4.60517018598809,0.223143551314211,8.98719682066197,4.38202663467388,4.60517018598809,0,0,1,1.2836,2,2.5558,LESS
9,42,50,8,92,50,42,3.73766961828337,3.91202300542815,0.174353387144778,7.64969262371151,3.91202300542815,3.73766961828337,1,0,0,1.5953,1,1.5659,LESS
9,180,150,30,330,150,180,5.19295685089021,5.01063529409626,0.182321556793955,10.2035921449865,5.01063529409626,5.19295685089021,1,1,1,1.112,1,2.0867,LESS
9,159,150,9,309,150,159,5.06890420222023,5.01063529409626,0.058268908123976,10.0795394963165,5.01063529409626,5.06890420222023,1,1,1,1.0851,2,1.2155,LESS
9,150,123,27,273,123,150,5.01063529409626,4.81218435537242,0.198450938723838,9.82281964946867,4.81218435537242,5.01063529409626,1,1,1,1.5229,1,1.0239,LESS
9,100,108,8,208,100,108,4.60517018598809,4.68213122712422,0.0769610411361281,9.28730141311231,4.60517018598809,4.68213122712422,0,0,1,1.1959,3,1.7496,LESS
9,50,57,7,107,50,57,3.91202300542815,4.04305126783455,0.131028262406404,7.9550742732627,3.91202300542815,4.04305126783455,0,0,1,1.3885,2,0.8383,LESS
9,44,50,6,94,44,50,3.78418963391826,3.91202300542815,0.127833371509885,7.69621263934641,3.78418963391826,3.91202300542815,0,0,1,1.906,3,1.1818,LESS
9,57,50,7,107,50,57,4.04305126783455,3.91202300542815,0.131028262406404,7.9550742732627,3.91202300542815,4.04305126783455,1,1,1,1.1485,4,1.0149,LESS
9,141,150,9,291,141,150,4.94875989037817,5.01063529409626,0.0618754037180871,9.95939518447442,4.94875989037817,5.01063529409626,0,0,1,1.7115,1,1.0362,LESS
9,86,100,14,186,100,86,4.45434729625351,4.60517018598809,0.150822889734584,9.0595174822416,4.60517018598809,4.45434729625351,1,0,0,1.0327,4,1.3243,LESS
9,150,153,3,303,153,150,5.01063529409626,5.03043792139244,0.0198026272961798,10.0410732154887,5.03043792139244,5.01063529409626,1,0,0,1.316,3,1.149,LESS
9,171,150,21,321,150,171,5.14166355650266,5.01063529409626,0.131028262406405,10.1522988505989,5.01063529409626,5.14166355650266,1,1,1,1.1296,1,0.915,LESS
9,50,40,10,90,40,50,3.91202300542815,3.68887945411394,0.22314355131421,7.60090245954208,3.68887945411394,3.91202300542815,1,1,1,1.8697,1,1.5746,LESS
9,56,50,6,106,56,50,4.02535169073515,3.91202300542815,0.113328685307004,7.9373746961633,4.02535169073515,3.91202300542815,0,1,0,1.5555,2,1.7198,LESS
9,50,45,5,95,50,45,3.91202300542815,3.80666248977032,0.105360515657826,7.71868549519847,3.91202300542815,3.80666248977032,0,1,0,1.2557,1,0.9845,LESS
9,46,50,4,96,46,50,3.8286413964891,3.91202300542815,0.0833816089390509,7.74066440191724,3.8286413964891,3.91202300542815,0,0,1,1.5307,4,1.7896,LESS
9,60,50,10,110,60,50,4.0943445622221,3.91202300542815,0.182321556793954,8.00636756765025,4.0943445622221,3.91202300542815,0,1,0,1.8579,1,1.417,LESS
9,135,150,15,285,150,135,4.90527477843843,5.01063529409626,0.105360515657826,9.91591007253469,5.01063529409626,4.90527477843843,1,0,0,1.1877,1,0.8055,LESS
9,150,135,15,285,135,150,5.01063529409626,4.90527477843843,0.105360515657826,9.91591007253469,4.90527477843843,5.01063529409626,1,1,1,1.0628,2,1.5399,LESS
9,54,50,4,104,54,50,3.98898404656427,3.91202300542815,0.0769610411361286,7.90100705199242,3.98898404656427,3.91202300542815,0,1,0,1.2619,3,1.3055,LESS
9,150,162,12,312,150,162,5.01063529409626,5.08759633523238,0.0769610411361281,10.0982316293286,5.01063529409626,5.08759633523238,0,0,1,1.7266,1,0.5216,LESS
9,49,50,1,99,49,50,3.89182029811063,3.91202300542815,0.0202027073175195,7.80384330353877,3.89182029811063,3.91202300542815,0,0,1,1.682,2,0.9841,LESS
9,100,92,8,192,92,100,4.60517018598809,4.52178857704904,0.0833816089390513,9.12695876303713,4.52178857704904,4.60517018598809,1,1,1,1.3679,3,0.9851,LESS
9,150,180,30,330,150,180,5.01063529409626,5.19295685089021,0.182321556793955,10.2035921449865,5.01063529409626,5.19295685089021,0,0,1,2.29,1,0.8302,LESS
9,50,57,7,107,50,57,3.91202300542815,4.04305126783455,0.131028262406404,7.9550742732627,3.91202300542815,4.04305126783455,0,0,1,1.1934,4,1.3819,LESS
9,96,100,4,196,100,96,4.56434819146784,4.60517018598809,0.0408219945202557,9.16951837745593,4.60517018598809,4.56434819146784,1,0,0,2.4978,1,0.7233,LESS
9,53,50,3,103,53,50,3.97029191355212,3.91202300542815,0.058268908123976,7.88231491898027,3.97029191355212,3.91202300542815,0,1,0,1.1282,3,1.0148,LESS
9,100,104,4,204,104,100,4.60517018598809,4.64439089914137,0.0392207131532807,9.24956108512946,4.64439089914137,4.60517018598809,1,0,0,1.3188,1,0.6868,LESS
9,86,100,14,186,100,86,4.45434729625351,4.60517018598809,0.150822889734584,9.0595174822416,4.60517018598809,4.45434729625351,1,0,0,2.5529,1,1.0586,LESS
9,58,50,8,108,50,58,4.06044301054642,3.91202300542815,0.148420005118273,7.97246601597456,3.91202300542815,4.06044301054642,1,1,1,1.3378,4,0.4982,LESS
9,100,106,6,206,106,100,4.60517018598809,4.66343909411207,0.0582689081239751,9.26860928010016,4.66343909411207,4.60517018598809,1,0,0,1.7035,2,0.765,LESS
9,100,92,8,192,92,100,4.60517018598809,4.52178857704904,0.0833816089390513,9.12695876303713,4.52178857704904,4.60517018598809,1,1,1,2.2393,1,0.8213,LESS
9,168,150,18,318,150,168,5.12396397940326,5.01063529409626,0.113328685307003,10.1345992734995,5.01063529409626,5.12396397940326,1,1,1,1.0673,3,0.9529,LESS
9,135,150,15,285,150,135,4.90527477843843,5.01063529409626,0.105360515657826,9.91591007253469,5.01063529409626,4.90527477843843,1,0,0,1.6256,1,0.3256,LESS
9,100,94,6,194,100,94,4.60517018598809,4.54329478227,0.061875403718088,9.1484649682581,4.60517018598809,4.54329478227,0,1,0,1.6254,1,0.3158,LESS
9,102,100,2,202,100,102,4.62497281328427,4.60517018598809,0.0198026272961789,9.23014299927236,4.60517018598809,4.62497281328427,1,1,1,1.1879,3,2.8876,LESS
9,150,120,30,270,120,150,5.01063529409626,4.78749174278205,0.22314355131421,9.7981270368783,4.78749174278205,5.01063529409626,1,1,1,1.0191,3,0.867,LESS
9,58,50,8,108,50,58,4.06044301054642,3.91202300542815,0.148420005118273,7.97246601597456,3.91202300542815,4.06044301054642,1,1,1,1.7948,3,2.0552,LESS
9,150,153,3,303,153,150,5.01063529409626,5.03043792139244,0.0198026272961798,10.0410732154887,5.03043792139244,5.01063529409626,1,0,0,1.217,2,0.6724,LESS
9,50,48,2,98,48,50,3.91202300542815,3.87120101090789,0.0408219945202548,7.78322401633604,3.87120101090789,3.91202300542815,1,1,1,1.2445,4,0.8669,LESS
9,180,150,30,330,150,180,5.19295685089021,5.01063529409626,0.182321556793955,10.2035921449865,5.01063529409626,5.19295685089021,1,1,1,1.3441,2,0.6973,LESS
9,126,150,24,276,126,150,4.83628190695148,5.01063529409626,0.174353387144778,9.84691720104773,4.83628190695148,5.01063529409626,0,0,1,1.3131,2,1.147,LESS
9,150,168,18,318,150,168,5.01063529409626,5.12396397940326,0.113328685307003,10.1345992734995,5.01063529409626,5.12396397940326,0,0,1,1.2617,2,0.8978,LESS
9,47,50,3,97,47,50,3.85014760171006,3.91202300542815,0.0618754037180875,7.7621706071382,3.85014760171006,3.91202300542815,0,0,1,1.2175,3,1.0477,LESS
9,150,126,24,276,126,150,5.01063529409626,4.83628190695148,0.174353387144778,9.84691720104773,4.83628190695148,5.01063529409626,1,1,1,1.0385,4,0.7065,LESS
9,153,150,3,303,150,153,5.03043792139244,5.01063529409626,0.0198026272961798,10.0410732154887,5.01063529409626,5.03043792139244,1,1,1,1.9303,1,2.421,LESS
9,150,141,9,291,141,150,5.01063529409626,4.94875989037817,0.0618754037180871,9.95939518447442,4.94875989037817,5.01063529409626,1,1,1,0.9602,2,1.065,LESS
9,50,58,8,108,50,58,3.91202300542815,4.06044301054642,0.148420005118273,7.97246601597456,3.91202300542815,4.06044301054642,0,0,1,1.0966,4,0.7574,LESS
9,100,80,20,180,80,100,4.60517018598809,4.38202663467388,0.223143551314211,8.98719682066197,4.38202663467388,4.60517018598809,1,1,1,1.2065,4,0.8855,LESS
9,50,58,8,108,50,58,3.91202300542815,4.06044301054642,0.148420005118273,7.97246601597456,3.91202300542815,4.06044301054642,0,0,1,1.1353,4,0.4562,LESS
9,174,150,24,324,150,174,5.15905529921453,5.01063529409626,0.148420005118274,10.1696905933108,5.01063529409626,5.15905529921453,1,1,1,0.9601,3,1.1472,LESS
9,174,150,24,324,150,174,5.15905529921453,5.01063529409626,0.148420005118274,10.1696905933108,5.01063529409626,5.15905529921453,1,1,1,1.1096,4,0.6485,LESS
9,156,150,6,306,156,150,5.04985600724954,5.01063529409626,0.0392207131532816,10.0604913013458,5.04985600724954,5.01063529409626,0,1,0,2.5461,2,0.4702,LESS
9,50,53,3,103,50,53,3.91202300542815,3.97029191355212,0.058268908123976,7.88231491898027,3.91202300542815,3.97029191355212,0,0,1,1.1359,2,0.9842,LESS
9,100,86,14,186,100,86,4.60517018598809,4.45434729625351,0.150822889734584,9.0595174822416,4.60517018598809,4.45434729625351,0,1,0,0.9814,2,1.6726,LESS
9,98,100,2,198,98,100,4.58496747867057,4.60517018598809,0.0202027073175195,9.19013766465866,4.58496747867057,4.60517018598809,0,0,1,2.2209,2,0.5062,LESS
9,106,100,6,206,100,106,4.66343909411207,4.60517018598809,0.0582689081239751,9.26860928010016,4.60517018598809,4.66343909411207,1,1,1,1.2009,1,0.9546,LESS
9,82,100,18,182,82,100,4.40671924726425,4.60517018598809,0.198450938723838,9.01188943325235,4.40671924726425,4.60517018598809,0,0,1,1.0077,3,1.3424,LESS
9,100,84,16,184,84,100,4.60517018598809,4.43081679884331,0.174353387144778,9.03598698483141,4.43081679884331,4.60517018598809,1,1,1,0.963,4,0.4897,LESS
9,40,50,10,90,40,50,3.68887945411394,3.91202300542815,0.22314355131421,7.60090245954208,3.68887945411394,3.91202300542815,0,0,1,1.0386,4,0.3651,LESS
9,138,150,12,288,138,150,4.92725368515721,5.01063529409626,0.0833816089390504,9.93788897925346,4.92725368515721,5.01063529409626,0,0,1,1.0507,2,1.2485,LESS
9,50,51,1,101,51,50,3.91202300542815,3.93182563272433,0.0198026272961798,7.84384863815247,3.93182563272433,3.91202300542815,1,0,0,1.0018,3,0.8349,LESS
9,50,45,5,95,50,45,3.91202300542815,3.80666248977032,0.105360515657826,7.71868549519847,3.91202300542815,3.80666248977032,0,1,0,1.1636,1,1.4698,LESS
9,50,44,6,94,44,50,3.91202300542815,3.78418963391826,0.127833371509885,7.69621263934641,3.78418963391826,3.91202300542815,1,1,1,0.9771,4,0.4983,LESS
9,60,50,10,110,60,50,4.0943445622221,3.91202300542815,0.182321556793954,8.00636756765025,4.0943445622221,3.91202300542815,0,1,0,1.2271,2,1.5712,LESS
9,45,50,5,95,45,50,3.80666248977032,3.91202300542815,0.105360515657826,7.71868549519847,3.80666248977032,3.91202300542815,0,0,1,1.0584,4,0.4173,LESS
9,150,165,15,315,150,165,5.01063529409626,5.10594547390058,0.0953101798043248,10.1165807679968,5.01063529409626,5.10594547390058,0,0,1,1.2392,1,0.9152,LESS
9,150,144,6,294,144,150,5.01063529409626,4.969813299576,0.0408219945202548,9.98044859367226,4.969813299576,5.01063529409626,1,1,1,0.9711,1,0.5026,LESS
9,150,159,9,309,159,150,5.01063529409626,5.06890420222023,0.058268908123976,10.0795394963165,5.06890420222023,5.01063529409626,1,0,0,1.6139,1,0.3809,LESS
9,165,150,15,315,150,165,5.10594547390058,5.01063529409626,0.0953101798043248,10.1165807679968,5.01063529409626,5.10594547390058,1,1,1,0.9427,1,0.4984,LESS
9,106,100,6,206,106,100,4.66343909411207,4.60517018598809,0.0582689081239751,9.26860928010016,4.66343909411207,4.60517018598809,0,1,0,1.9089,3,1.5215,LESS
9,50,55,5,105,50,55,3.91202300542815,4.00733318523247,0.0953101798043252,7.91935619066062,3.91202300542815,4.00733318523247,0,0,1,1.3685,2,1.3421,LESS
9,80,100,20,180,80,100,4.38202663467388,4.60517018598809,0.223143551314211,8.98719682066197,4.38202663467388,4.60517018598809,0,0,1,1.0919,2,1.4751,LESS
9,50,59,9,109,50,59,3.91202300542815,4.07753744390572,0.165514438477574,7.98956044933387,3.91202300542815,4.07753744390572,0,0,1,1.0825,3,0.8874,LESS
9,108,100,8,208,100,108,4.68213122712422,4.60517018598809,0.0769610411361281,9.28730141311231,4.60517018598809,4.68213122712422,1,1,1,0.92,3,0.9174,LESS
9,100,118,18,218,100,118,4.60517018598809,4.77068462446567,0.165514438477573,9.37585481045376,4.60517018598809,4.77068462446567,0,0,1,1.0076,1,1.0975,LESS
9,144,150,6,294,150,144,4.969813299576,5.01063529409626,0.0408219945202548,9.98044859367226,5.01063529409626,4.969813299576,1,0,0,0.9191,1,0.8652,LESS
9,50,49,1,99,50,49,3.912023,3.89182,0.02020271,7.803843,3.912023,3.89182,0,1,0,1.966,1,0.9581,LESS
9,84,100,16,184,84,100,4.430817,4.60517,0.1743534,9.035987,4.430817,4.60517,0,0,1,1.0111,1,1.248,LESS
9,110,100,10,210,100,110,4.70048,4.60517,0.09531018,9.305651,4.60517,4.70048,1,1,1,1.7626,1,0.8682,LESS
9,120,100,20,220,100,120,4.787492,4.60517,0.1823216,9.392662,4.60517,4.787492,1,1,1,0.8795,3,1.146,LESS
9,52,50,2,102,50,52,3.951244,3.912023,0.03922071,7.863267,3.912023,3.951244,1,1,1,2.645,1,0.8598,LESS
9,48,50,2,98,48,50,3.871201,3.912023,0.04082199,7.783224,3.871201,3.912023,0,0,1,1.041,1,1.7861,LESS
9,141,150,9,291,141,150,4.94876,5.010635,0.0618754,9.959395,4.94876,5.010635,0,0,1,1.7229,1,0.6476,LESS
9,90,100,10,190,90,100,4.49981,4.60517,0.1053605,9.10498,4.49981,4.60517,0,0,1,1.5528,1,0.6863,LESS
9,50,40,10,90,50,40,3.912023,3.688879,0.2231436,7.600902,3.912023,3.688879,0,1,0,1.3864,2,0.9181,LESS
9,177,150,27,327,150,177,5.17615,5.010635,0.1655144,10.18679,5.010635,5.17615,1,1,1,0.9589,3,1.8705,LESS
9,100,120,20,220,100,120,4.60517,4.787492,0.1823216,9.392662,4.60517,4.787492,0,0,1,1.1275,1,1.103,LESS
9,100,116,16,216,100,116,4.60517,4.75359,0.14842,9.35876,4.60517,4.75359,0,0,1,2.8863,1,0.7025,LESS
9,100,82,18,182,82,100,4.60517,4.406719,0.1984509,9.011889,4.406719,4.60517,1,1,1,1.3034,3,0.8332,LESS
9,100,98,2,198,100,98,4.60517,4.584967,0.02020271,9.190138,4.60517,4.584967,0,1,0,1.153,3,1.7394,LESS
9,50,60,10,110,50,60,3.912023,4.094345,0.1823216,8.006368,3.912023,4.094345,0,0,1,1.1441,4,0.49,LESS
9,129,150,21,279,129,150,4.859812,5.010635,0.1508229,9.870448,4.859812,5.010635,0,0,1,1.3187,1,1.1698,LESS
9,50,48,2,98,50,48,3.912023,3.871201,0.04082199,7.783224,3.912023,3.871201,0,1,0,1.2957,3,0.9817,LESS
9,41,50,9,91,41,50,3.713572,3.912023,0.1984509,7.625595,3.713572,3.912023,0,0,1,1.2065,4,0.374,LESS
9,59,50,9,109,50,59,4.077537,3.912023,0.1655144,7.98956,3.912023,4.077537,1,1,1,1.1744,1,1.002,LESS
9,50,47,3,97,50,47,3.912023,3.850148,0.0618754,7.762171,3.912023,3.850148,0,1,0,1.0468,3,1.4064,LESS
9,150,132,18,282,132,150,5.010635,4.882802,0.1278334,9.893437,4.882802,5.010635,1,1,1,1.902,1,1.5058,LESS
9,50,53,3,103,50,53,3.912023,3.970292,0.05826891,7.882315,3.912023,3.970292,0,0,1,1.0343,2,1.8239,LESS
9,112,100,12,212,100,112,4.718499,4.60517,0.1133287,9.323669,4.60517,4.718499,1,1,1,1.3678,2,0.9174,LESS
9,100,86,14,186,86,100,4.60517,4.454347,0.1508229,9.059517,4.454347,4.60517,1,1,1,1.0045,2,0.6867,LESS
9,156,150,6,306,156,150,5.049856,5.010635,0.03922071,10.06049,5.049856,5.010635,0,1,0,1.4993,1,0.4308,LESS
9,150,120,30,270,120,150,5.010635,4.787492,0.2231436,9.798127,4.787492,5.010635,1,1,1,1.135,2,0.8247,LESS
9,150,141,9,291,141,150,5.010635,4.94876,0.0618754,9.959395,4.94876,5.010635,1,1,1,0.9008,2,0.503,LESS
9,100,106,6,206,100,106,4.60517,4.663439,0.05826891,9.268609,4.60517,4.663439,0,0,1,1.053,1,0.7825,LESS
9,162,150,12,312,150,162,5.087596,5.010635,0.07696104,10.09823,5.010635,5.087596,1,1,1,2.0332,1,1.4007,LESS
9,104,100,4,204,104,100,4.644391,4.60517,0.03922071,9.249561,4.644391,4.60517,0,1,0,1.2104,1,0.5029,LESS
9,50,42,8,92,42,50,3.912023,3.73767,0.1743534,7.649693,3.73767,3.912023,1,1,1,0.9904,3,0.9158,LESS
9,150,177,27,327,150,177,5.010635,5.17615,0.1655144,10.18679,5.010635,5.17615,0,0,1,1.0323,2,2.075,LESS
9,98,100,2,198,98,100,4.584967,4.60517,0.02020271,9.190138,4.584967,4.60517,0,0,1,0.6928,3,1.5501,LESS
9,150,177,27,327,177,150,5.010635,5.17615,0.1655144,10.18679,5.17615,5.010635,1,0,0,1.3891,1,0.7311,LESS
9,150,180,30,330,150,180,5.010635,5.192957,0.1823216,10.20359,5.010635,5.192957,0,0,1,0.9886,1,0.6347,LESS
9,120,150,30,270,120,150,4.787492,5.010635,0.2231436,9.798127,4.787492,5.010635,0,0,1,1.0733,1,0.8481,LESS
9,50,42,8,92,42,50,3.912023,3.73767,0.1743534,7.649693,3.73767,3.912023,1,1,1,1.4558,1,1.4481,LESS
9,153,150,3,303,153,150,5.030438,5.010635,0.01980263,10.04107,5.030438,5.010635,0,1,0,2.6556,1,0.1341,LESS
9,100,118,18,218,100,118,4.60517,4.770685,0.1655144,9.375855,4.60517,4.770685,0,0,1,1.0056,2,1.1506,LESS
9,57,50,7,107,50,57,4.043051,3.912023,0.1310283,7.955074,3.912023,4.043051,1,1,1,1.8875,1,1.3227,LESS
9,55,50,5,105,55,50,4.007333,3.912023,0.09531018,7.919356,4.007333,3.912023,0,1,0,1.2695,1,0.8236,LESS
9,40,50,10,90,40,50,3.688879,3.912023,0.2231436,7.600902,3.688879,3.912023,0,0,1,1.0115,3,1.3984,LESS
9,100,112,12,212,100,112,4.60517,4.718499,0.1133287,9.323669,4.60517,4.718499,0,0,1,1.3523,2,0.9395,LESS
9,150,132,18,282,132,150,5.010635,4.882802,0.1278334,9.893437,4.882802,5.010635,1,1,1,0.9017,3,1.0062,LESS
9,43,50,7,93,43,50,3.7612,3.912023,0.1508229,7.673223,3.7612,3.912023,0,0,1,0.8422,4,0.7015,LESS
9,150,168,18,318,168,150,5.010635,5.123964,0.1133287,10.1346,5.123964,5.010635,1,0,0,1.7323,1,0.7557,LESS
9,90,100,10,190,90,100,4.49981,4.60517,0.1053605,9.10498,4.49981,4.60517,0,0,1,0.8787,3,0.8211,LESS
9,100,114,14,214,100,114,4.60517,4.736198,0.1310283,9.341369,4.60517,4.736198,0,0,1,1.0855,1,0.9382,LESS
9,147,150,3,297,147,150,4.990433,5.010635,0.02020271,10.00107,4.990433,5.010635,0,0,1,1.6706,1,0.4811,LESS
9,114,100,14,214,100,114,4.736198,4.60517,0.1310283,9.341369,4.60517,4.736198,1,1,1,1.0789,3,1.4009,LESS
9,50,46,4,96,50,46,3.912023,3.828641,0.08338161,7.740664,3.912023,3.828641,0,1,0,1.5665,2,1.3486,LESS
9,150,156,6,306,150,156,5.010635,5.049856,0.03922071,10.06049,5.010635,5.049856,0,0,1,1.22,1,0.4657,LESS
9,43,50,7,93,43,50,3.7612,3.912023,0.1508229,7.673223,3.7612,3.912023,0,0,1,1.2468,2,0.8551,LESS
9,50,49,1,99,50,49,3.912023,3.89182,0.02020271,7.803843,3.912023,3.89182,0,1,0,1.5098,2,1.0545,LESS
9,50,51,1,101,50,51,3.912023,3.931826,0.01980263,7.843849,3.912023,3.931826,0,0,1,1.2471,2,0.9082,LESS
9,50,41,9,91,41,50,3.912023,3.713572,0.1984509,7.625595,3.713572,3.912023,1,1,1,1.0872,2,1.0074,LESS
9,150,174,24,324,150,174,5.010635,5.159055,0.14842,10.16969,5.010635,5.159055,0,0,1,2.0402,1,0.521,LESS
9,50,56,6,106,50,56,3.912023,4.025352,0.1133287,7.937375,3.912023,4.025352,0,0,1,1.2357,1,1.282,LESS
9,100,108,8,208,100,108,4.60517,4.682131,0.07696104,9.287301,4.60517,4.682131,0,0,1,1.9738,1,1.0135,LESS
9,132,150,18,282,132,150,4.882802,5.010635,0.1278334,9.893437,4.882802,5.010635,0,0,1,1.2672,1,0.4162,LESS
9,177,150,27,327,150,177,5.17615,5.010635,0.1655144,10.18679,5.010635,5.17615,1,1,1,0.9827,3,0.7806,LESS
9,100,120,20,220,100,120,4.60517,4.787492,0.1823216,9.392662,4.60517,4.787492,0,0,1,1.0175,3,1.1327,LESS
9,100,88,12,188,88,100,4.60517,4.477337,0.1278334,9.082507,4.477337,4.60517,1,1,1,0.9427,4,0.6187,LESS
9,150,156,6,306,156,150,5.010635,5.049856,0.03922071,10.06049,5.049856,5.010635,1,0,0,1.5842,1,0.3754,LESS
9,46,50,4,96,46,50,3.828641,3.912023,0.08338161,7.740664,3.828641,3.912023,0,0,1,1.048,1,0.7983,LESS
9,118,100,18,218,100,118,4.770685,4.60517,0.1655144,9.375855,4.60517,4.770685,1,1,1,1.0394,2,0.6084,LESS
9,123,150,27,273,123,150,4.812184,5.010635,0.1984509,9.82282,4.812184,5.010635,0,0,1,1.9306,1,0.2177,LESS
9,88,100,12,188,100,88,4.477337,4.60517,0.1278334,9.082507,4.60517,4.477337,1,0,0,1.5441,2,0.571,LESS
9,150,135,15,285,135,150,5.010635,4.905275,0.1053605,9.91591,4.905275,5.010635,1,1,1,1.7805,1,0.476,LESS
9,100,110,10,210,110,100,4.60517,4.70048,0.09531018,9.305651,4.70048,4.60517,1,0,0,1.2169,1,0.5322,LESS
9,120,150,30,270,120,150,4.787492,5.010635,0.2231436,9.798127,4.787492,5.010635,0,0,1,1.1331,2,0.7819,LESS
9,150,147,3,297,147,150,5.010635,4.990433,0.02020271,10.00107,4.990433,5.010635,1,1,1,0.8988,2,0.9808,LESS
9,150,129,21,279,129,150,5.010635,4.859812,0.1508229,9.870448,4.859812,5.010635,1,1,1,1.0299,2,0.9522,LESS
9,100,80,20,180,80,100,4.60517,4.382027,0.2231436,8.987197,4.382027,4.60517,1,1,1,1.1033,3,0.5136,LESS
9,150,171,21,321,171,150,5.010635,5.141664,0.1310283,10.1523,5.141664,5.010635,1,0,0,1.9306,1,0.3144,LESS
9,47,50,3,97,47,50,3.850148,3.912023,0.0618754,7.762171,3.850148,3.912023,0,0,1,1.3364,1,1.291,LESS
9,100,98,2,198,98,100,4.60517,4.584967,0.02020271,9.190138,4.584967,4.60517,1,1,1,1.0964,2,0.5515,LESS
9,50,44,6,94,44,50,3.912023,3.78419,0.1278334,7.696213,3.78419,3.912023,1,1,1,1.7179,1,0.652,LESS
9,150,144,6,294,144,150,5.010635,4.969813,0.04082199,9.980449,4.969813,5.010635,1,1,1,1.0528,2,1.4716,LESS
9,168,150,18,318,150,168,5.123964,5.010635,0.1133287,10.1346,5.010635,5.123964,1,1,1,0.863,2,0.8715,LESS
9,150,138,12,288,138,150,5.010635,4.927254,0.08338161,9.937889,4.927254,5.010635,1,1,1,1.1479,1,0.4044,LESS
9,50,52,2,102,50,52,3.912023,3.951244,0.03922071,7.863267,3.912023,3.951244,0,0,1,0.97,1,0.6584,LESS
9,150,162,12,312,150,162,5.010635,5.087596,0.07696104,10.09823,5.010635,5.087596,0,0,1,1.3519,1,0.638,LESS
9,50,43,7,93,50,43,3.912023,3.7612,0.1508229,7.673223,3.912023,3.7612,0,1,0,1.0929,1,1.6666,LESS
9,92,100,8,192,100,92,4.521789,4.60517,0.08338161,9.126959,4.60517,4.521789,1,0,0,1.0576,3,0.7672,LESS
9,100,102,2,202,102,100,4.60517,4.624973,0.01980263,9.230143,4.624973,4.60517,1,0,0,1.0319,2,0.9144,LESS
9,50,41,9,91,41,50,3.912023,3.713572,0.1984509,7.625595,3.713572,3.912023,1,1,1,1.3589,1,1.4473,LESS
9,50,59,9,109,50,59,3.912023,4.077537,0.1655144,7.98956,3.912023,4.077537,0,0,1,1.0975,3,0.7319,LESS
9,100,84,16,184,84,100,4.60517,4.430817,0.1743534,9.035987,4.430817,4.60517,1,1,1,1.0622,3,0.6204,LESS
9,132,150,18,282,132,150,4.882802,5.010635,0.1278334,9.893437,4.882802,5.010635,0,0,1,1.4247,2,0.8483,LESS
9,144,150,6,294,150,144,4.969813,5.010635,0.04082199,9.980449,5.010635,4.969813,1,0,0,0.9713,3,1.3987,LESS
9,94,100,6,194,94,100,4.543295,4.60517,0.0618754,9.148465,4.543295,4.60517,0,0,1,2.9991,1,0.6482,LESS
9,100,88,12,188,88,100,4.60517,4.477337,0.1278334,9.082507,4.477337,4.60517,1,1,1,1.0856,3,0.5875,LESS
9,112,100,12,212,100,112,4.718499,4.60517,0.1133287,9.323669,4.60517,4.718499,1,1,1,1.3881,1,0.4898,LESS
9,150,123,27,273,123,150,5.010635,4.812184,0.1984509,9.82282,4.812184,5.010635,1,1,1,0.7787,4,0.4659,LESS
9,100,96,4,196,96,100,4.60517,4.564348,0.04082199,9.169518,4.564348,4.60517,1,1,1,2.3921,1,0.4164,LESS
9,50,55,5,105,50,55,3.912023,4.007333,0.09531018,7.919356,3.912023,4.007333,0,0,1,1.1369,4,0.3693,LESS
9,52,50,2,102,50,52,3.951244,3.912023,0.03922071,7.863267,3.912023,3.951244,1,1,1,1.157,2,1.0515,LESS
9,120,100,20,220,100,120,4.787492,4.60517,0.1823216,9.392662,4.60517,4.787492,1,1,1,0.9656,3,0.4889,LESS
9,50,60,10,110,50,60,3.912023,4.094345,0.1823216,8.006368,3.912023,4.094345,0,0,1,0.9929,4,0.4367,LESS
9,56,50,6,106,56,50,4.025352,3.912023,0.1133287,7.937375,4.025352,3.912023,0,1,0,1.259,2,1.0915,LESS
9,102,100,2,202,102,100,4.624973,4.60517,0.01980263,9.230143,4.624973,4.60517,0,1,0,2.1131,1,0.7342,LESS
9,150,165,15,315,165,150,5.010635,5.105945,0.09531018,10.11658,5.105945,5.010635,1,0,0,1.0382,1,1.4702,LESS
9,41,50,9,91,41,50,3.713572,3.912023,0.1984509,7.625595,3.713572,3.912023,0,0,1,1.115,4,0.3325,LESS
9,100,116,16,216,116,100,4.60517,4.75359,0.14842,9.35876,4.75359,4.60517,1,0,0,2.1317,1,0.4806,LESS
9,50,46,4,96,46,50,3.912023,3.828641,0.08338161,7.740664,3.828641,3.912023,1,1,1,1.2367,2,0.7384,LESS
9,84,100,16,184,100,84,4.430817,4.60517,0.1743534,9.035987,4.60517,4.430817,1,0,0,1.2502,1,0.7991,LESS
9,100,104,4,204,104,100,4.60517,4.644391,0.03922071,9.249561,4.644391,4.60517,1,0,0,1.3678,1,0.4479,LESS
9,96,100,4,196,100,96,4.564348,4.60517,0.04082199,9.169518,4.60517,4.564348,1,0,0,1.0118,1,0.4051,LESS
9,54,50,4,104,50,54,3.988984,3.912023,0.07696104,7.901007,3.912023,3.988984,1,1,1,1.0942,1,1.5813,LESS
9,162,150,12,312,150,162,5.087596,5.010635,0.07696104,10.09823,5.010635,5.087596,1,1,1,0.7954,3,0.7651,LESS
9,118,100,18,218,100,118,4.770685,4.60517,0.1655144,9.375855,4.60517,4.770685,1,1,1,0.8625,3,1.2149,LESS
9,147,150,3,297,150,147,4.990433,5.010635,0.02020271,10.00107,5.010635,4.990433,1,0,0,0.9854,2,1.5199,LESS
9,45,50,5,95,45,50,3.806662,3.912023,0.1053605,7.718685,3.806662,3.912023,0,0,1,1.3828,2,0.6716,LESS
9,100,94,6,194,94,100,4.60517,4.543295,0.0618754,9.148465,4.543295,4.60517,1,1,1,0.8539,3,1.0196,LESS
9,94,100,6,194,94,100,4.543295,4.60517,0.0618754,9.148465,4.543295,4.60517,0,0,1,3.2643,1,0.234,LESS
9,59,50,9,109,59,50,4.077537,3.912023,0.1655144,7.98956,4.077537,3.912023,0,1,0,1.8722,4,0.5201,LESS
9,114,100,14,214,100,114,4.736198,4.60517,0.1310283,9.341369,4.60517,4.736198,1,1,1,0.8555,2,1.1477,LESS
9,82,100,18,182,82,100,4.406719,4.60517,0.1984509,9.011889,4.406719,4.60517,0,0,1,0.8184,4,1.7509,LESS
9,150,129,21,279,129,150,5.010635,4.859812,0.1508229,9.870448,4.859812,5.010635,1,1,1,0.6723,3,1.0156,LESS
9,44,50,6,94,50,44,3.78419,3.912023,0.1278334,7.696213,3.912023,3.78419,1,0,0,0.9756,3,1.0319,LESS
9,55,50,5,105,50,55,4.007333,3.912023,0.09531018,7.919356,3.912023,4.007333,1,1,1,0.576,4,0.7532,LESS
9,100,110,10,210,100,110,4.60517,4.70048,0.09531018,9.305651,4.60517,4.70048,0,0,1,0.6838,3,1.6726,LESS
9,150,171,21,321,150,171,5.010635,5.141664,0.1310283,10.1523,5.010635,5.141664,0,0,1,3.0499,1,0.7834,LESS
9,49,50,1,99,50,49,3.89182,3.912023,0.02020271,7.803843,3.912023,3.89182,1,0,0,1.2446,1,0.6995,LESS
9,165,150,15,315,150,165,5.105945,5.010635,0.09531018,10.11658,5.010635,5.105945,1,1,1,1.0466,2,0.6316,LESS
9,129,150,21,279,129,150,4.859812,5.010635,0.1508229,9.870448,4.859812,5.010635,0,0,1,1.643,1,0.6516,LESS
9,51,50,1,101,51,50,3.931826,3.912023,0.01980263,7.843849,3.931826,3.912023,0,1,0,1.7337,1,0.3343,LESS
9,150,174,24,324,150,174,5.010635,5.159055,0.14842,10.16969,5.010635,5.159055,0,0,1,1.0072,2,1.0174,LESS
9,150,138,12,288,138,150,5.010635,4.927254,0.08338161,9.937889,4.927254,5.010635,1,1,1,1.0137,2,0.8238,LESS
9,150,147,3,297,147,150,5.010635,4.990433,0.02020271,10.00107,4.990433,5.010635,1,1,1,1.0285,1,0.8378,LESS
9,42,50,8,92,42,50,3.73767,3.912023,0.1743534,7.649693,3.73767,3.912023,0,0,1,0.9833,4,0.2829,LESS
9,159,150,9,309,150,159,5.068904,5.010635,0.05826891,10.07954,5.010635,5.068904,1,1,1,1.5112,1,0.5063,LESS
9,100,82,18,182,82,100,4.60517,4.406719,0.1984509,9.011889,4.406719,4.60517,1,1,1,0.7992,1,0.5468,LESS
9,50,52,2,102,50,52,3.912023,3.951244,0.03922071,7.863267,3.912023,3.951244,0,0,1,1.5387,1,0.7032,LESS
9,50,43,7,93,43,50,3.912023,3.7612,0.1508229,7.673223,3.7612,3.912023,1,1,1,2.6239,1,0.567,LESS
9,51,50,1,101,51,50,3.931826,3.912023,0.01980263,7.843849,3.931826,3.912023,0,1,0,1.7535,1,0.3319,LESS
9,100,90,10,190,100,90,4.60517,4.49981,0.1053605,9.10498,4.60517,4.49981,0,1,0,1.476,1,0.6306,LESS
9,100,102,2,202,100,102,4.60517,4.624973,0.01980263,9.230143,4.60517,4.624973,0,0,1,1.8137,1,1.067,LESS
9,100,96,4,196,96,100,4.60517,4.564348,0.04082199,9.169518,4.564348,4.60517,1,1,1,2.1048,1,0.6096,LESS
9,116,100,16,216,100,116,4.75359,4.60517,0.14842,9.35876,4.60517,4.75359,1,1,1,1.315,1,0.5982,LESS
9,110,100,10,210,100,110,4.70048,4.60517,0.09531018,9.305651,4.60517,4.70048,1,1,1,2.2508,1,0.9514,LESS
9,50,54,4,104,50,54,3.912023,3.988984,0.07696104,7.901007,3.912023,3.988984,0,0,1,1.6138,2,0.6207,LESS
9,100,90,10,190,100,90,4.60517,4.49981,0.1053605,9.10498,4.60517,4.49981,0,1,0,1.4926,1,0.7979,LESS
9,88,100,12,188,88,100,4.477337,4.60517,0.1278334,9.082507,4.477337,4.60517,0,0,1,0.9913,1,0.6642,LESS
9,50,47,3,97,50,47,3.912023,3.850148,0.0618754,7.762171,3.912023,3.850148,0,1,0,1.1732,3,0.5352,LESS
9,171,150,21,321,150,171,5.141664,5.010635,0.1310283,10.1523,5.010635,5.141664,1,1,1,1.5201,1,1.1036,LESS
9,92,100,8,192,92,100,4.521789,4.60517,0.08338161,9.126959,4.521789,4.60517,0,0,1,0.9146,2,0.7742,LESS
9,123,150,27,273,123,150,4.812184,5.010635,0.1984509,9.82282,4.812184,5.010635,0,0,1,0.8209,3,0.7999,LESS
9,150,159,9,309,150,159,5.010635,5.068904,0.05826891,10.07954,5.010635,5.068904,0,0,1,2.6954,1,0.6816,LESS
9,116,100,16,216,100,116,4.75359,4.60517,0.14842,9.35876,4.60517,4.75359,1,1,1,0.9798,3,0.856,LESS
9,100,112,12,212,100,112,4.60517,4.718499,0.1133287,9.323669,4.60517,4.718499,0,0,1,1.0903,2,0.6148,LESS
9,138,150,12,288,138,150,4.927254,5.010635,0.08338161,9.937889,4.927254,5.010635,0,0,1,1.1668,1,0.4028,LESS
9,104,100,4,204,104,100,4.644391,4.60517,0.03922071,9.249561,4.644391,4.60517,0,1,0,1.1813,2,1.0559,LESS
9,126,150,24,276,126,150,4.836282,5.010635,0.1743534,9.846917,4.836282,5.010635,0,0,1,1.0045,1,0.4553,LESS
9,150,126,24,276,126,150,5.010635,4.836282,0.1743534,9.846917,4.836282,5.010635,1,1,1,1.1204,1,0.3361,LESS
9,50,54,4,104,50,54,3.912023,3.988984,0.07696104,7.901007,3.912023,3.988984,0,0,1,1.716,1,0.299,LESS
9,100,114,14,214,100,114,4.60517,4.736198,0.1310283,9.341369,4.60517,4.736198,0,0,1,2.0029,2,0.9799,LESS
9,108,100,8,208,100,108,4.682131,4.60517,0.07696104,9.287301,4.60517,4.682131,1,1,1,1.0423,4,1.016,LESS
9,48,50,2,98,48,50,3.871201,3.912023,0.04082199,7.783224,3.871201,3.912023,0,0,1,2.5656,1,0.403,LESS
9,53,50,3,103,50,53,3.970292,3.912023,0.05826891,7.882315,3.912023,3.970292,1,1,1,1.7347,1,0.8385,LESS
10,100,110,10,210,100,110,4.60517,4.70048,0.09531018,9.305651,4.60517,4.70048,0,0,1,1.009,2,0.599,LESS
10,40,50,10,90,40,50,3.688879,3.912023,0.2231436,7.600902,3.688879,3.912023,0,0,1,0.849,4,0.605,LESS
10,50,56,6,106,50,56,3.912023,4.025352,0.1133287,7.937375,3.912023,4.025352,0,0,1,1.099,2,1.024,LESS
10,51,50,1,101,51,50,3.931826,3.912023,0.01980263,7.843849,3.931826,3.912023,0,1,0,1.29,3,0.688,LESS
10,100,106,6,206,106,100,4.60517,4.663439,0.05826891,9.268609,4.663439,4.60517,1,0,0,1.454,2,0.782,LESS
10,48,50,2,98,48,50,3.871201,3.912023,0.04082199,7.783224,3.871201,3.912023,0,0,1,1.305,4,0.423,LESS
10,50,60,10,110,50,60,3.912023,4.094345,0.1823216,8.006368,3.912023,4.094345,0,0,1,1.264,2,0.565,LESS
10,49,50,1,99,49,50,3.89182,3.912023,0.02020271,7.803843,3.89182,3.912023,0,0,1,1.398,2,0.687,LESS
10,108,100,8,208,100,108,4.682131,4.60517,0.07696104,9.287301,4.60517,4.682131,1,1,1,1.527,2,0.596,LESS
10,98,100,2,198,100,98,4.584967,4.60517,0.02020271,9.190138,4.60517,4.584967,1,0,0,1.405,1,0.766,LESS
10,50,41,9,91,41,50,3.912023,3.713572,0.1984509,7.625595,3.713572,3.912023,1,1,1,1.795,2,0.754,LESS
10,112,100,12,212,100,112,4.718499,4.60517,0.1133287,9.323669,4.60517,4.718499,1,1,1,1.408,2,0.513,LESS
10,57,50,7,107,57,50,4.043051,3.912023,0.1310283,7.955074,4.043051,3.912023,0,1,0,1.141,3,0.614,LESS
10,150,120,30,270,150,120,5.010635,4.787492,0.2231436,9.798127,5.010635,4.787492,0,1,0,1.027,2,0.533,LESS
10,84,100,16,184,84,100,4.430817,4.60517,0.1743534,9.035987,4.430817,4.60517,0,0,1,1.013,4,0.517,LESS
10,90,100,10,190,90,100,4.49981,4.60517,0.1053605,9.10498,4.49981,4.60517,0,0,1,1.022,4,0.72,LESS
10,165,150,15,315,165,150,5.105945,5.010635,0.09531018,10.11658,5.105945,5.010635,0,1,0,1.569,2,0.816,LESS
10,150,138,12,288,150,138,5.010635,4.927254,0.08338161,9.937889,5.010635,4.927254,0,1,0,0.991,2,0.669,LESS
10,50,51,1,101,50,51,3.912023,3.931826,0.01980263,7.843849,3.912023,3.931826,0,0,1,1.21,2,0.592,LESS
10,120,100,20,220,100,120,4.787492,4.60517,0.1823216,9.392662,4.60517,4.787492,1,1,1,1.92,3,0.716,LESS
10,100,118,18,218,100,118,4.60517,4.770685,0.1655144,9.375855,4.60517,4.770685,0,0,1,1.499,2,0.716,LESS
10,100,96,4,196,96,100,4.60517,4.564348,0.04082199,9.169518,4.564348,4.60517,1,1,1,2.492,1,0.383,LESS
10,86,100,14,186,100,86,4.454347,4.60517,0.1508229,9.059517,4.60517,4.454347,1,0,0,2.032,2,0.602,LESS
10,100,80,20,180,80,100,4.60517,4.382027,0.2231436,8.987197,4.382027,4.60517,1,1,1,1.241,2,0.634,LESS
10,159,150,9,309,159,150,5.068904,5.010635,0.05826891,10.07954,5.068904,5.010635,0,1,0,1.41,1,0.628,LESS
10,150,132,18,282,150,132,5.010635,4.882802,0.1278334,9.893437,5.010635,4.882802,0,1,0,1.125,1,0.431,LESS
10,153,150,3,303,150,153,5.030438,5.010635,0.01980263,10.04107,5.010635,5.030438,1,1,1,0.99,4,0.45,LESS
10,108,100,8,208,100,108,4.682131,4.60517,0.07696104,9.287301,4.60517,4.682131,1,1,1,0.927,3,0.784,LESS
10,43,50,7,93,43,50,3.7612,3.912023,0.1508229,7.673223,3.7612,3.912023,0,0,1,1.723,1,0.562,LESS
10,90,100,10,190,90,100,4.49981,4.60517,0.1053605,9.10498,4.49981,4.60517,0,0,1,1.509,2,0.448,LESS
10,120,150,30,270,120,150,4.787492,5.010635,0.2231436,9.798127,4.787492,5.010635,0,0,1,0.993,4,0.699,LESS
10,98,100,2,198,98,100,4.584967,4.60517,0.02020271,9.190138,4.584967,4.60517,0,0,1,2.273,2,0.262,LESS
10,96,100,4,196,96,100,4.564348,4.60517,0.04082199,9.169518,4.564348,4.60517,0,0,1,1.017,4,0.378,LESS
10,48,50,2,98,48,50,3.871201,3.912023,0.04082199,7.783224,3.871201,3.912023,0,0,1,1.175,4,0.317,LESS
10,100,110,10,210,100,110,4.60517,4.70048,0.09531018,9.305651,4.60517,4.70048,0,0,1,1.524,2,0.499,LESS
10,150,120,30,270,120,150,5.010635,4.787492,0.2231436,9.798127,4.787492,5.010635,1,1,1,1.025,4,0.3,LESS
10,50,45,5,95,45,50,3.912023,3.806662,0.1053605,7.718685,3.806662,3.912023,1,1,1,1.338,2,0.488,LESS
10,118,100,18,218,100,118,4.770685,4.60517,0.1655144,9.375855,4.60517,4.770685,1,1,1,1.091,2,0.539,LESS
10,46,50,4,96,46,50,3.828641,3.912023,0.08338161,7.740664,3.828641,3.912023,0,0,1,1.172,4,0.301,LESS
10,168,150,18,318,150,168,5.123964,5.010635,0.1133287,10.1346,5.010635,5.123964,1,1,1,1.122,3,0.482,LESS
10,100,118,18,218,100,118,4.60517,4.770685,0.1655144,9.375855,4.60517,4.770685,0,0,1,1.005,2,0.701,LESS
10,50,42,8,92,50,42,3.912023,3.73767,0.1743534,7.649693,3.912023,3.73767,0,1,0,0.928,3,1.029,LESS
10,42,50,8,92,42,50,3.73767,3.912023,0.1743534,7.649693,3.73767,3.912023,0,0,1,1.138,3,0.649,LESS
10,174,150,24,324,150,174,5.159055,5.010635,0.14842,10.16969,5.010635,5.159055,1,1,1,1.005,4,0.759,LESS
10,150,171,21,321,150,171,5.010635,5.141664,0.1310283,10.1523,5.010635,5.141664,0,0,1,1.428,3,0.556,LESS
10,100,90,10,190,90,100,4.60517,4.49981,0.1053605,9.10498,4.49981,4.60517,1,1,1,0.948,3,0.693,LESS
10,100,116,16,216,100,116,4.60517,4.75359,0.14842,9.35876,4.60517,4.75359,0,0,1,1.286,2,0.508,LESS
10,150,168,18,318,168,150,5.010635,5.123964,0.1133287,10.1346,5.123964,5.010635,1,0,0,1.439,1,0.629,LESS
10,116,100,16,216,100,116,4.75359,4.60517,0.14842,9.35876,4.60517,4.75359,1,1,1,2.092,1,0.299,LESS
10,50,45,5,95,45,50,3.912023,3.806662,0.1053605,7.718685,3.806662,3.912023,1,1,1,2.124,2,0.649,LESS
10,100,108,8,208,108,100,4.60517,4.682131,0.07696104,9.287301,4.682131,4.60517,1,0,0,1.612,2,0.811,LESS
10,41,50,9,91,41,50,3.713572,3.912023,0.1984509,7.625595,3.713572,3.912023,0,0,1,1.185,4,0.55,LESS
10,102,100,2,202,100,102,4.624973,4.60517,0.01980263,9.230143,4.60517,4.624973,1,1,1,1.904,2,0.753,LESS
10,150,138,12,288,138,150,5.010635,4.927254,0.08338161,9.937889,4.927254,5.010635,1,1,1,2.528,2,0.381,LESS
10,162,150,12,312,150,162,5.087596,5.010635,0.07696104,10.09823,5.010635,5.087596,1,1,1,1.579,2,0.427,LESS
10,49,50,1,99,50,49,3.89182,3.912023,0.02020271,7.803843,3.912023,3.89182,1,0,0,1.848,2,1.064,LESS
10,100,116,16,216,100,116,4.60517,4.75359,0.14842,9.35876,4.60517,4.75359,0,0,1,1.271,2,0.413,LESS
10,50,42,8,92,50,42,3.912023,3.73767,0.1743534,7.649693,3.912023,3.73767,0,1,0,1.048,4,0.436,LESS
10,43,50,7,93,43,50,3.7612,3.912023,0.1508229,7.673223,3.7612,3.912023,0,0,1,1.625,2,0.373,LESS
10,50,52,2,102,50,52,3.912023,3.951244,0.03922071,7.863267,3.912023,3.951244,0,0,1,1.536,2,0.686,LESS
10,100,112,12,212,112,100,4.60517,4.718499,0.1133287,9.323669,4.718499,4.60517,1,0,0,1.571,2,0.538,LESS
10,100,104,4,204,100,104,4.60517,4.644391,0.03922071,9.249561,4.60517,4.644391,0,0,1,1.309,2,0.385,LESS
10,138,150,12,288,150,138,4.927254,5.010635,0.08338161,9.937889,5.010635,4.927254,1,0,0,1.235,2,0.436,LESS
10,100,84,16,184,84,100,4.60517,4.430817,0.1743534,9.035987,4.430817,4.60517,1,1,1,1.721,2,0.485,LESS
10,50,43,7,93,43,50,3.912023,3.7612,0.1508229,7.673223,3.7612,3.912023,1,1,1,1.194,3,0.657,LESS
10,50,46,4,96,50,46,3.912023,3.828641,0.08338161,7.740664,3.912023,3.828641,0,1,0,1.206,4,0.432,LESS
10,168,150,18,318,150,168,5.123964,5.010635,0.1133287,10.1346,5.010635,5.123964,1,1,1,1.032,2,0.53,LESS
10,150,174,24,324,150,174,5.010635,5.159055,0.14842,10.16969,5.010635,5.159055,0,0,1,1.109,2,0.582,LESS
10,40,50,10,90,40,50,3.688879,3.912023,0.2231436,7.600902,3.688879,3.912023,0,0,1,0.929,4,0.451,LESS
10,50,56,6,106,50,56,3.912023,4.025352,0.1133287,7.937375,3.912023,4.025352,0,0,1,1.065,4,0.351,LESS
10,177,150,27,327,150,177,5.17615,5.010635,0.1655144,10.18679,5.010635,5.17615,1,1,1,1.027,3,0.545,LESS
10,59,50,9,109,59,50,4.077537,3.912023,0.1655144,7.98956,4.077537,3.912023,0,1,0,1.171,2,0.702,LESS
10,147,150,3,297,150,147,4.990433,5.010635,0.02020271,10.00107,5.010635,4.990433,1,0,0,1.282,4,0.334,LESS
10,126,150,24,276,126,150,4.836282,5.010635,0.1743534,9.846917,4.836282,5.010635,0,0,1,1.231,3,0.7,LESS
10,50,58,8,108,50,58,3.912023,4.060443,0.14842,7.972466,3.912023,4.060443,0,0,1,1.646,2,0.805,LESS
10,150,147,3,297,147,150,5.010635,4.990433,0.02020271,10.00107,4.990433,5.010635,1,1,1,1.55,2,0.406,LESS
10,100,96,4,196,96,100,4.60517,4.564348,0.04082199,9.169518,4.564348,4.60517,1,1,1,1.093,3,0.524,LESS
10,100,120,20,220,120,100,4.60517,4.787492,0.1823216,9.392662,4.787492,4.60517,1,0,0,1.512,2,0.744,LESS
10,150,180,30,330,150,180,5.010635,5.192957,0.1823216,10.20359,5.010635,5.192957,0,0,1,1.128,1,0.973,LESS
10,150,141,9,291,141,150,5.010635,4.94876,0.0618754,9.959395,4.94876,5.010635,1,1,1,0.981,3,1,LESS
10,162,150,12,312,150,162,5.087596,5.010635,0.07696104,10.09823,5.010635,5.087596,1,1,1,0.888,3,0.616,LESS
10,50,44,6,94,50,44,3.912023,3.78419,0.1278334,7.696213,3.912023,3.78419,0,1,0,2.072,2,0.358,LESS
10,50,48,2,98,50,48,3.912023,3.871201,0.04082199,7.783224,3.912023,3.871201,0,1,0,1.479,2,0.746,LESS
10,150,171,21,321,171,150,5.010635,5.141664,0.1310283,10.1523,5.141664,5.010635,1,0,0,0.973,2,0.387,LESS
10,150,132,18,282,132,150,5.010635,4.882802,0.1278334,9.893437,4.882802,5.010635,1,1,1,1.696,2,0.683,LESS
10,53,50,3,103,50,53,3.970292,3.912023,0.05826891,7.882315,3.912023,3.970292,1,1,1,2.512,1,0.39,LESS
10,100,94,6,194,94,100,4.60517,4.543295,0.0618754,9.148465,4.543295,4.60517,1,1,1,2.272,1,0.433,LESS
10,50,49,1,99,50,49,3.912023,3.89182,0.02020271,7.803843,3.912023,3.89182,0,1,0,1.047,4,0.416,LESS
10,50,57,7,107,57,50,3.912023,4.043051,0.1310283,7.955074,4.043051,3.912023,1,0,0,3.221,1,0.46,LESS
10,150,156,6,306,156,150,5.010635,5.049856,0.03922071,10.06049,5.049856,5.010635,1,0,0,0.967,3,0.583,LESS
10,50,43,7,93,50,43,3.912023,3.7612,0.1508229,7.673223,3.912023,3.7612,0,1,0,1.889,2,0.884,LESS
10,47,50,3,97,50,47,3.850148,3.912023,0.0618754,7.762171,3.912023,3.850148,1,0,0,1.332,2,0.802,LESS
10,118,100,18,218,100,118,4.770685,4.60517,0.1655144,9.375855,4.60517,4.770685,1,1,1,1.243,2,1.118,LESS
10,50,53,3,103,50,53,3.912023,3.970292,0.05826891,7.882315,3.912023,3.970292,0,0,1,2.13,2,0.64,LESS
10,150,123,27,273,123,150,5.010635,4.812184,0.1984509,9.82282,4.812184,5.010635,1,1,1,0.913,3,1.039,LESS
10,116,100,16,216,100,116,4.75359,4.60517,0.14842,9.35876,4.60517,4.75359,1,1,1,1.474,3,0.534,LESS
10,147,150,3,297,150,147,4.990433,5.010635,0.02020271,10.00107,5.010635,4.990433,1,0,0,1.271,2,1.365,LESS
10,50,47,3,97,50,47,3.912023,3.850148,0.0618754,7.762171,3.912023,3.850148,0,1,0,1.215,3,0.52,LESS
10,129,150,21,279,150,129,4.859812,5.010635,0.1508229,9.870448,5.010635,4.859812,1,0,0,0.941,2,0.689,LESS
10,50,54,4,104,50,54,3.912023,3.988984,0.07696104,7.901007,3.912023,3.988984,0,0,1,3.21,2,0.553,LESS
10,60,50,10,110,50,60,4.094345,3.912023,0.1823216,8.006368,3.912023,4.094345,1,1,1,2.165,2,0.451,LESS
10,129,150,21,279,150,129,4.859812,5.010635,0.1508229,9.870448,5.010635,4.859812,1,0,0,1.895,1,0.664,LESS
10,104,100,4,204,100,104,4.644391,4.60517,0.03922071,9.249561,4.60517,4.644391,1,1,1,0.998,3,0.759,LESS
10,100,108,8,208,100,108,4.60517,4.682131,0.07696104,9.287301,4.60517,4.682131,0,0,1,1.104,2,0.66,LESS
10,150,156,6,306,156,150,5.010635,5.049856,0.03922071,10.06049,5.049856,5.010635,1,0,0,1.746,1,1.921,LESS
10,171,150,21,321,150,171,5.141664,5.010635,0.1310283,10.1523,5.010635,5.141664,1,1,1,0.925,3,0.6,LESS
10,100,98,2,198,98,100,4.60517,4.584967,0.02020271,9.190138,4.584967,4.60517,1,1,1,1.052,3,0.801,LESS
10,102,100,2,202,100,102,4.624973,4.60517,0.01980263,9.230143,4.60517,4.624973,1,1,1,1.481,2,0.4,LESS
10,44,50,6,94,44,50,3.78419,3.912023,0.1278334,7.696213,3.78419,3.912023,0,0,1,1.039,4,0.366,LESS
10,57,50,7,107,50,57,4.043051,3.912023,0.1310283,7.955074,3.912023,4.043051,1,1,1,1.695,2,0.435,LESS
10,123,150,27,273,123,150,4.812184,5.010635,0.1984509,9.82282,4.812184,5.010635,0,0,1,1.419,3,0.817,LESS
10,138,150,12,288,138,150,4.927254,5.010635,0.08338161,9.937889,4.927254,5.010635,0,0,1,1.146,2,0.374,LESS
10,50,52,2,102,50,52,3.912023,3.951244,0.03922071,7.863267,3.912023,3.951244,0,0,1,1.296,2,0.424,LESS
10,150,141,9,291,141,150,5.010635,4.94876,0.0618754,9.959395,4.94876,5.010635,1,1,1,1.246,2,0.413,LESS
10,135,150,15,285,135,150,4.905275,5.010635,0.1053605,9.91591,4.905275,5.010635,0,0,1,2.608,1,0.845,LESS
10,150,159,9,309,150,159,5.010635,5.068904,0.05826891,10.07954,5.010635,5.068904,0,0,1,1.056,2,0.4,LESS
10,88,100,12,188,100,88,4.477337,4.60517,0.1278334,9.082507,4.60517,4.477337,1,0,0,1.893,2,0.896,LESS
10,54,50,4,104,50,54,3.988984,3.912023,0.07696104,7.901007,3.912023,3.988984,1,1,1,1.097,2,1.024,LESS
10,141,150,9,291,150,141,4.94876,5.010635,0.0618754,9.959395,5.010635,4.94876,1,0,0,1.947,1,1.48,LESS
10,52,50,2,102,52,50,3.951244,3.912023,0.03922071,7.863267,3.951244,3.912023,0,1,0,1.487,2,0.432,LESS
10,58,50,8,108,50,58,4.060443,3.912023,0.14842,7.972466,3.912023,4.060443,1,1,1,1.819,2,0.632,LESS
10,51,50,1,101,51,50,3.931826,3.912023,0.01980263,7.843849,3.931826,3.912023,0,1,0,1.056,4,0.58,LESS
10,123,150,27,273,123,150,4.812184,5.010635,0.1984509,9.82282,4.812184,5.010635,0,0,1,1.154,1,0.572,LESS
10,47,50,3,97,47,50,3.850148,3.912023,0.0618754,7.762171,3.850148,3.912023,0,0,1,0.96,4,0.408,LESS
10,150,144,6,294,144,150,5.010635,4.969813,0.04082199,9.980449,4.969813,5.010635,1,1,1,1.689,1,0.982,LESS
10,50,53,3,103,50,53,3.912023,3.970292,0.05826891,7.882315,3.912023,3.970292,0,0,1,1.338,4,3.005,LESS
10,150,129,21,279,150,129,5.010635,4.859812,0.1508229,9.870448,5.010635,4.859812,0,1,0,1.445,2,1,LESS
10,150,159,9,309,159,150,5.010635,5.068904,0.05826891,10.07954,5.068904,5.010635,1,0,0,1.887,2,0.586,LESS
10,59,50,9,109,50,59,4.077537,3.912023,0.1655144,7.98956,3.912023,4.077537,1,1,1,1.098,3,0.55,LESS
10,55,50,5,105,55,50,4.007333,3.912023,0.09531018,7.919356,4.007333,3.912023,0,1,0,1.571,1,0.544,LESS
10,150,153,3,303,153,150,5.010635,5.030438,0.01980263,10.04107,5.030438,5.010635,1,0,0,2.857,1,0.814,LESS
10,110,100,10,210,100,110,4.70048,4.60517,0.09531018,9.305651,4.60517,4.70048,1,1,1,1.41,1,0.482,LESS
10,150,180,30,330,150,180,5.010635,5.192957,0.1823216,10.20359,5.010635,5.192957,0,0,1,1.169,2,0.587,LESS
10,100,92,8,192,100,92,4.60517,4.521789,0.08338161,9.126959,4.60517,4.521789,0,1,0,2.141,1,0.66,LESS
10,50,58,8,108,50,58,3.912023,4.060443,0.14842,7.972466,3.912023,4.060443,0,0,1,2.666,2,1.081,LESS
10,153,150,3,303,150,153,5.030438,5.010635,0.01980263,10.04107,5.010635,5.030438,1,1,1,1.56,2,0.814,LESS
10,174,150,24,324,150,174,5.159055,5.010635,0.14842,10.16969,5.010635,5.159055,1,1,1,1.197,2,0.796,LESS
10,165,150,15,315,150,165,5.105945,5.010635,0.09531018,10.11658,5.010635,5.105945,1,1,1,1.796,1,0.854,LESS
10,150,165,15,315,150,165,5.010635,5.105945,0.09531018,10.11658,5.010635,5.105945,0,0,1,1.483,2,0.82,LESS
10,50,48,2,98,50,48,3.912023,3.871201,0.04082199,7.783224,3.912023,3.871201,0,1,0,1.087,4,0.404,LESS
10,150,162,12,312,162,150,5.010635,5.087596,0.07696104,10.09823,5.087596,5.010635,1,0,0,1.175,2,0.443,LESS
10,100,80,20,180,80,100,4.60517,4.382027,0.2231436,8.987197,4.382027,4.60517,1,1,1,1.133,2,0.493,LESS
10,100,82,18,182,82,100,4.60517,4.406719,0.1984509,9.011889,4.406719,4.60517,1,1,1,0.935,4,0.551,LESS
10,100,102,2,202,102,100,4.60517,4.624973,0.01980263,9.230143,4.624973,4.60517,1,0,0,1.812,2,0.449,LESS
10,100,120,20,220,120,100,4.60517,4.787492,0.1823216,9.392662,4.787492,4.60517,1,0,0,1.999,1,0.531,LESS
10,100,88,12,188,88,100,4.60517,4.477337,0.1278334,9.082507,4.477337,4.60517,1,1,1,1.32,2,0.447,LESS
10,114,100,14,214,114,100,4.736198,4.60517,0.1310283,9.341369,4.736198,4.60517,0,1,0,1.583,2,0.75,LESS
10,114,100,14,214,100,114,4.736198,4.60517,0.1310283,9.341369,4.60517,4.736198,1,1,1,1.152,3,0.603,LESS
10,56,50,6,106,50,56,4.025352,3.912023,0.1133287,7.937375,3.912023,4.025352,1,1,1,1.287,4,1.215,LESS
10,141,150,9,291,150,141,4.94876,5.010635,0.0618754,9.959395,5.010635,4.94876,1,0,0,2.375,1,0.573,LESS
10,56,50,6,106,56,50,4.025352,3.912023,0.1133287,7.937375,4.025352,3.912023,0,1,0,1.824,1,0.898,LESS
10,42,50,8,92,42,50,3.73767,3.912023,0.1743534,7.649693,3.73767,3.912023,0,0,1,1.402,2,1.223,LESS
10,50,49,1,99,50,49,3.912023,3.89182,0.02020271,7.803843,3.912023,3.89182,0,1,0,1.223,2,0.464,LESS
10,150,123,27,273,123,150,5.010635,4.812184,0.1984509,9.82282,4.812184,5.010635,1,1,1,0.947,4,0.722,LESS
10,52,50,2,102,52,50,3.951244,3.912023,0.03922071,7.863267,3.951244,3.912023,0,1,0,1.324,2,0.395,LESS
10,100,114,14,214,114,100,4.60517,4.736198,0.1310283,9.341369,4.736198,4.60517,1,0,0,2.057,1,0.673,LESS
10,50,47,3,97,50,47,3.912023,3.850148,0.0618754,7.762171,3.912023,3.850148,0,1,0,1.772,1,0.876,LESS
10,50,59,9,109,50,59,3.912023,4.077537,0.1655144,7.98956,3.912023,4.077537,0,0,1,1.419,2,0.386,LESS
10,150,177,27,327,177,150,5.010635,5.17615,0.1655144,10.18679,5.17615,5.010635,1,0,0,1.679,1,0.385,LESS
10,50,57,7,107,50,57,3.912023,4.043051,0.1310283,7.955074,3.912023,4.043051,0,0,1,1.095,3,0.771,LESS
10,100,94,6,194,94,100,4.60517,4.543295,0.0618754,9.148465,4.543295,4.60517,1,1,1,0.89,3,0.997,LESS
10,41,50,9,91,41,50,3.713572,3.912023,0.1984509,7.625595,3.713572,3.912023,0,0,1,1.186,3,0.536,LESS
10,144,150,6,294,150,144,4.969813,5.010635,0.04082199,9.980449,5.010635,4.969813,1,0,0,1.034,2,0.603,LESS
10,53,50,3,103,53,50,3.970292,3.912023,0.05826891,7.882315,3.970292,3.912023,0,1,0,1.29,2,0.617,LESS
10,60,50,10,110,50,60,4.094345,3.912023,0.1823216,8.006368,3.912023,4.094345,1,1,1,1.152,2,0.502,LESS
10,150,168,18,318,168,150,5.010635,5.123964,0.1133287,10.1346,5.123964,5.010635,1,0,0,0.922,2,0.38,LESS
10,50,40,10,90,40,50,3.912023,3.688879,0.2231436,7.600902,3.688879,3.912023,1,1,1,1.019,3,0.651,LESS
10,100,88,12,188,88,100,4.60517,4.477337,0.1278334,9.082507,4.477337,4.60517,1,1,1,1.299,2,0.72,LESS
10,50,60,10,110,50,60,3.912023,4.094345,0.1823216,8.006368,3.912023,4.094345,0,0,1,0.969,3,0.888,LESS
10,100,98,2,198,98,100,4.60517,4.584967,0.02020271,9.190138,4.584967,4.60517,1,1,1,0.972,2,1.384,LESS
10,45,50,5,95,45,50,3.806662,3.912023,0.1053605,7.718685,3.806662,3.912023,0,0,1,0.966,4,0.384,LESS
10,44,50,6,94,44,50,3.78419,3.912023,0.1278334,7.696213,3.78419,3.912023,0,0,1,1.042,4,0.399,LESS
10,55,50,5,105,55,50,4.007333,3.912023,0.09531018,7.919356,4.007333,3.912023,0,1,0,2.318,2,0.441,LESS
10,50,44,6,94,44,50,3.912023,3.78419,0.1278334,7.696213,3.78419,3.912023,1,1,1,1.195,2,0.81,LESS
10,150,165,15,315,165,150,5.010635,5.105945,0.09531018,10.11658,5.105945,5.010635,1,0,0,0.954,2,0.516,LESS
10,82,100,18,182,82,100,4.406719,4.60517,0.1984509,9.011889,4.406719,4.60517,0,0,1,0.963,3,1.67,LESS
10,120,150,30,270,150,120,4.787492,5.010635,0.2231436,9.798127,5.010635,4.787492,1,0,0,2.446,1,0.423,LESS
10,106,100,6,206,100,106,4.663439,4.60517,0.05826891,9.268609,4.60517,4.663439,1,1,1,1.517,3,0.482,LESS
10,106,100,6,206,100,106,4.663439,4.60517,0.05826891,9.268609,4.60517,4.663439,1,1,1,1.1,2,1.366,LESS
10,100,104,4,204,100,104,4.60517,4.644391,0.03922071,9.249561,4.60517,4.644391,0,0,1,1.529,1,0.437,LESS
10,100,82,18,182,82,100,4.60517,4.406719,0.1984509,9.011889,4.406719,4.60517,1,1,1,0.991,3,0.518,LESS
10,150,174,24,324,150,174,5.010635,5.159055,0.14842,10.16969,5.010635,5.159055,0,0,1,2.79,1,0.648,LESS
10,94,100,6,194,100,94,4.543295,4.60517,0.0618754,9.148465,4.60517,4.543295,1,0,0,1.279,3,0.654,LESS
10,50,46,4,96,46,50,3.912023,3.828641,0.08338161,7.740664,3.828641,3.912023,1,1,1,1.73,2,0.502,LESS
10,46,50,4,96,50,46,3.828641,3.912023,0.08338161,7.740664,3.912023,3.828641,1,0,0,1.236,4,0.388,LESS
10,100,86,14,186,86,100,4.60517,4.454347,0.1508229,9.059517,4.454347,4.60517,1,1,1,1.515,2,0.725,LESS
10,156,150,6,306,150,156,5.049856,5.010635,0.03922071,10.06049,5.010635,5.049856,1,1,1,1.365,1,0.436,LESS
10,50,55,5,105,50,55,3.912023,4.007333,0.09531018,7.919356,3.912023,4.007333,0,0,1,1.803,1,0.72,LESS
10,126,150,24,276,150,126,4.836282,5.010635,0.1743534,9.846917,5.010635,4.836282,1,0,0,0.885,2,0.537,LESS
10,150,147,3,297,147,150,5.010635,4.990433,0.02020271,10.00107,4.990433,5.010635,1,1,1,0.838,1,0.499,LESS
10,94,100,6,194,100,94,4.543295,4.60517,0.0618754,9.148465,4.60517,4.543295,1,0,0,1.607,1,0.635,LESS
10,100,90,10,190,90,100,4.60517,4.49981,0.1053605,9.10498,4.49981,4.60517,1,1,1,1.214,1,0.349,LESS
10,150,126,24,276,126,150,5.010635,4.836282,0.1743534,9.846917,4.836282,5.010635,1,1,1,0.908,3,0.493,LESS
10,80,100,20,180,80,100,4.382027,4.60517,0.2231436,8.987197,4.382027,4.60517,0,0,1,1.356,2,0.438,LESS
10,50,40,10,90,40,50,3.912023,3.688879,0.2231436,7.600902,3.688879,3.912023,1,1,1,1.105,4,0.315,LESS
10,50,51,1,101,51,50,3.912023,3.931826,0.01980263,7.843849,3.931826,3.912023,1,0,0,1.274,3,0.418,LESS
10,132,150,18,282,132,150,4.882802,5.010635,0.1278334,9.893437,4.882802,5.010635,0,0,1,2.468,1,0.658,LESS
10,120,100,20,220,100,120,4.787492,4.60517,0.1823216,9.392662,4.60517,4.787492,1,1,1,1.028,3,1.154,LESS
10,50,54,4,104,50,54,3.912023,3.988984,0.07696104,7.901007,3.912023,3.988984,0,0,1,1.101,3,1.253,LESS
10,50,55,5,105,55,50,3.912023,4.007333,0.09531018,7.919356,4.007333,3.912023,1,0,0,1.041,3,0.795,LESS
10,135,150,15,285,150,135,4.905275,5.010635,0.1053605,9.91591,5.010635,4.905275,1,0,0,0.98,2,0.645,LESS
10,104,100,4,204,104,100,4.644391,4.60517,0.03922071,9.249561,4.644391,4.60517,0,1,0,1.549,1,0.735,LESS
10,100,84,16,184,84,100,4.60517,4.430817,0.1743534,9.035987,4.430817,4.60517,1,1,1,1.017,2,1.038,LESS
10,159,150,9,309,150,159,5.068904,5.010635,0.05826891,10.07954,5.010635,5.068904,1,1,1,0.807,2,0.529,LESS
10,150,126,24,276,126,150,5.010635,4.836282,0.1743534,9.846917,4.836282,5.010635,1,1,1,0.686,2,0.322,LESS
10,86,100,14,186,86,100,4.454347,4.60517,0.1508229,9.059517,4.454347,4.60517,0,0,1,1.678,1,0.47,LESS
10,112,100,12,212,112,100,4.718499,4.60517,0.1133287,9.323669,4.718499,4.60517,0,1,0,2.807,1,0.451,LESS
10,58,50,8,108,50,58,4.060443,3.912023,0.14842,7.972466,3.912023,4.060443,1,1,1,0.956,4,0.334,LESS
10,92,100,8,192,100,92,4.521789,4.60517,0.08338161,9.126959,4.60517,4.521789,1,0,0,1.334,2,0.498,LESS
10,100,92,8,192,92,100,4.60517,4.521789,0.08338161,9.126959,4.521789,4.60517,1,1,1,1.047,2,0.739,LESS
10,88,100,12,188,100,88,4.477337,4.60517,0.1278334,9.082507,4.60517,4.477337,1,0,0,1.059,3,0.551,LESS
10,100,112,12,212,100,112,4.60517,4.718499,0.1133287,9.323669,4.60517,4.718499,0,0,1,1.63,1,0.336,LESS
10,144,150,6,294,150,144,4.969813,5.010635,0.04082199,9.980449,5.010635,4.969813,1,0,0,0.855,4,0.821,LESS
10,180,150,30,330,150,180,5.192957,5.010635,0.1823216,10.20359,5.010635,5.192957,1,1,1,1.704,2,0.587,LESS
10,80,100,20,180,100,80,4.382027,4.60517,0.2231436,8.987197,4.60517,4.382027,1,0,0,1.367,2,0.389,LESS
10,180,150,30,330,150,180,5.192957,5.010635,0.1823216,10.20359,5.010635,5.192957,1,1,1,0.8,4,0.481,LESS
10,82,100,18,182,100,82,4.406719,4.60517,0.1984509,9.011889,4.60517,4.406719,1,0,0,1.001,2,0.573,LESS
10,84,100,16,184,84,100,4.430817,4.60517,0.1743534,9.035987,4.430817,4.60517,0,0,1,1.593,1,0.552,LESS
10,50,59,9,109,50,59,3.912023,4.077537,0.1655144,7.98956,3.912023,4.077537,0,0,1,1.1,4,0.66,LESS
10,110,100,10,210,100,110,4.70048,4.60517,0.09531018,9.305651,4.60517,4.70048,1,1,1,1.131,1,0.872,LESS
10,45,50,5,95,45,50,3.806662,3.912023,0.1053605,7.718685,3.806662,3.912023,0,0,1,1.964,2,0.471,LESS
10,96,100,4,196,100,96,4.564348,4.60517,0.04082199,9.169518,4.60517,4.564348,1,0,0,2.553,1,0.278,LESS
10,156,150,6,306,150,156,5.049856,5.010635,0.03922071,10.06049,5.010635,5.049856,1,1,1,1.04,3,0.755,LESS
10,100,114,14,214,100,114,4.60517,4.736198,0.1310283,9.341369,4.60517,4.736198,0,0,1,2.728,1,0.724,LESS
10,132,150,18,282,150,132,4.882802,5.010635,0.1278334,9.893437,5.010635,4.882802,1,0,0,0.902,2,0.505,LESS
10,150,153,3,303,153,150,5.010635,5.030438,0.01980263,10.04107,5.030438,5.010635,1,0,0,1.91,1,0.605,LESS
10,150,144,6,294,144,150,5.010635,4.969813,0.04082199,9.980449,4.969813,5.010635,1,1,1,0.963,3,0.654,LESS
10,50,41,9,91,50,41,3.912023,3.713572,0.1984509,7.625595,3.912023,3.713572,0,1,0,1.243,2,0.645,LESS
10,150,162,12,312,162,150,5.010635,5.087596,0.07696104,10.09823,5.087596,5.010635,1,0,0,1.926,1,0.794,LESS
10,100,86,14,186,86,100,4.60517,4.454347,0.1508229,9.059517,4.454347,4.60517,1,1,1,1.414,1,0.668,LESS
10,100,102,2,202,100,102,4.60517,4.624973,0.01980263,9.230143,4.60517,4.624973,0,0,1,1.081,2,0.78,LESS
10,92,100,8,192,92,100,4.521789,4.60517,0.08338161,9.126959,4.521789,4.60517,0,0,1,1.363,2,0.594,LESS
10,150,177,27,327,150,177,5.010635,5.17615,0.1655144,10.18679,5.010635,5.17615,0,0,1,2.249,1,0.408,LESS
10,171,150,21,321,150,171,5.141664,5.010635,0.1310283,10.1523,5.010635,5.141664,1,1,1,1.11,2,0.558,LESS
10,100,106,6,206,100,106,4.60517,4.663439,0.05826891,9.268609,4.60517,4.663439,0,0,1,1.109,2,1.364,LESS
10,150,135,15,285,135,150,5.010635,4.905275,0.1053605,9.91591,4.905275,5.010635,1,1,1,0.861,3,0.637,LESS
10,150,129,21,279,129,150,5.010635,4.859812,0.1508229,9.870448,4.859812,5.010635,1,1,1,1.228,2,0.823,LESS
10,150,135,15,285,135,150,5.010635,4.905275,0.1053605,9.91591,4.905275,5.010635,1,1,1,0.905,3,0.656,LESS
10,54,50,4,104,50,54,3.988984,3.912023,0.07696104,7.901007,3.912023,3.988984,1,1,1,2.908,1,0.335,LESS
10,177,150,27,327,150,177,5.17615,5.010635,0.1655144,10.18679,5.010635,5.17615,1,1,1,0.752,3,0.511,LESS
11,177,150,27,327,150,177,5.17615,5.010635,0.1655144,10.18679,5.010635,5.17615,1,1,1,0.6489,1,1.2974,LESS
11,116,100,16,216,100,116,4.75359,4.60517,0.14842,9.35876,4.60517,4.75359,1,1,1,0.6928,4,1.2976,LESS
11,123,150,27,273,150,123,4.812184,5.010635,0.1984509,9.82282,5.010635,4.812184,1,0,0,0.9566,2,0.8484,LESS
11,168,150,18,318,150,168,5.123964,5.010635,0.1133287,10.1346,5.010635,5.123964,1,1,1,0.612,1,0.5846,LESS
11,150,159,9,309,159,150,5.010635,5.068904,0.05826891,10.07954,5.068904,5.010635,1,0,0,0.5898,1,0.8642,LESS
11,150,162,12,312,162,150,5.010635,5.087596,0.07696104,10.09823,5.087596,5.010635,1,0,0,0.7138,2,0.7817,LESS
11,100,116,16,216,100,116,4.60517,4.75359,0.14842,9.35876,4.60517,4.75359,0,0,1,0.7197,1,0.7166,LESS
11,150,147,3,297,147,150,5.010635,4.990433,0.02020271,10.00107,4.990433,5.010635,1,1,1,0.8821,2,0.7523,LESS
11,50,46,4,96,46,50,3.912023,3.828641,0.08338161,7.740664,3.828641,3.912023,1,1,1,0.7111,2,0.6981,LESS
11,112,100,12,212,100,112,4.718499,4.60517,0.1133287,9.323669,4.60517,4.718499,1,1,1,0.5506,1,0.5532,LESS
11,150,159,9,309,159,150,5.010635,5.068904,0.05826891,10.07954,5.068904,5.010635,1,0,0,0.7238,1,0.9337,LESS
11,108,100,8,208,100,108,4.682131,4.60517,0.07696104,9.287301,4.60517,4.682131,1,1,1,0.5308,1,0.5589,LESS
11,80,100,20,180,80,100,4.382027,4.60517,0.2231436,8.987197,4.382027,4.60517,0,0,1,0.6068,4,0.7646,LESS
11,150,144,6,294,144,150,5.010635,4.969813,0.04082199,9.980449,4.969813,5.010635,1,1,1,0.7831,3,1.1134,LESS
11,150,171,21,321,171,150,5.010635,5.141664,0.1310283,10.1523,5.141664,5.010635,1,0,0,0.6663,2,1.108,LESS
11,50,53,3,103,50,53,3.912023,3.970292,0.05826891,7.882315,3.912023,3.970292,0,0,1,0.7919,1,1.2514,LESS
11,50,52,2,102,50,52,3.912023,3.951244,0.03922071,7.863267,3.912023,3.951244,0,0,1,2.0276,4,0.6744,LESS
11,50,48,2,98,50,48,3.912023,3.871201,0.04082199,7.783224,3.912023,3.871201,0,1,0,0.7416,1,1.1396,LESS
11,150,174,24,324,150,174,5.010635,5.159055,0.14842,10.16969,5.010635,5.159055,0,0,1,0.6081,2,0.5877,LESS
11,44,50,6,94,44,50,3.78419,3.912023,0.1278334,7.696213,3.78419,3.912023,0,0,1,0.646,1,0.6328,LESS
11,50,44,6,94,44,50,3.912023,3.78419,0.1278334,7.696213,3.78419,3.912023,1,1,1,0.5866,1,1.2705,LESS
11,40,50,10,90,40,50,3.688879,3.912023,0.2231436,7.600902,3.688879,3.912023,0,0,1,0.5585,3,1.2107,LESS
11,100,98,2,198,98,100,4.60517,4.584967,0.02020271,9.190138,4.584967,4.60517,1,1,1,1.4258,1,0.7856,LESS
11,126,150,24,276,126,150,4.836282,5.010635,0.1743534,9.846917,4.836282,5.010635,0,0,1,0.5847,1,1.0153,LESS
11,59,50,9,109,59,50,4.077537,3.912023,0.1655144,7.98956,4.077537,3.912023,0,1,0,0.7799,1,0.6707,LESS
11,150,129,21,279,129,150,5.010635,4.859812,0.1508229,9.870448,4.859812,5.010635,1,1,1,0.6881,4,0.7063,LESS
11,123,150,27,273,123,150,4.812184,5.010635,0.1984509,9.82282,4.812184,5.010635,0,0,1,0.9978,1,0.7642,LESS
11,50,49,1,99,49,50,3.912023,3.89182,0.02020271,7.803843,3.89182,3.912023,1,1,1,0.6116,4,0.8095,LESS
11,120,100,20,220,100,120,4.787492,4.60517,0.1823216,9.392662,4.60517,4.787492,1,1,1,1.0257,1,1.1138,LESS
11,50,48,2,98,48,50,3.912023,3.871201,0.04082199,7.783224,3.871201,3.912023,1,1,1,1.8424,1,0.5388,LESS
11,150,123,27,273,150,123,5.010635,4.812184,0.1984509,9.82282,5.010635,4.812184,0,1,0,0.8042,1,0.4884,LESS
11,174,150,24,324,174,150,5.159055,5.010635,0.14842,10.16969,5.159055,5.010635,0,1,0,0.7382,2,1.0424,LESS
11,50,41,9,91,41,50,3.912023,3.713572,0.1984509,7.625595,3.713572,3.912023,1,1,1,1.2137,3,1.0149,LESS
11,153,150,3,303,150,153,5.030438,5.010635,0.01980263,10.04107,5.010635,5.030438,1,1,1,1.3731,1,0.6499,LESS
11,54,50,4,104,50,54,3.988984,3.912023,0.07696104,7.901007,3.912023,3.988984,1,1,1,1.8687,1,2.164,LESS
11,100,108,8,208,100,108,4.60517,4.682131,0.07696104,9.287301,4.60517,4.682131,0,0,1,1.6862,1,0.3645,LESS
11,100,104,4,204,104,100,4.60517,4.644391,0.03922071,9.249561,4.644391,4.60517,1,0,0,1.0486,1,0.4079,LESS
11,56,50,6,106,56,50,4.025352,3.912023,0.1133287,7.937375,4.025352,3.912023,0,1,0,0.9619,1,0.5044,LESS
11,141,150,9,291,141,150,4.94876,5.010635,0.0618754,9.959395,4.94876,5.010635,0,0,1,2.4955,1,0.4041,LESS
11,120,150,30,270,120,150,4.787492,5.010635,0.2231436,9.798127,4.787492,5.010635,0,0,1,0.6628,1,0.3649,LESS
11,177,150,27,327,150,177,5.17615,5.010635,0.1655144,10.18679,5.010635,5.17615,1,1,1,0.8904,3,0.7222,LESS
11,129,150,21,279,129,150,4.859812,5.010635,0.1508229,9.870448,4.859812,5.010635,0,0,1,0.8039,4,1.0322,LESS
11,150,171,21,321,150,171,5.010635,5.141664,0.1310283,10.1523,5.010635,5.141664,0,0,1,1.4464,1,0.5507,LESS
11,180,150,30,330,150,180,5.192957,5.010635,0.1823216,10.20359,5.010635,5.192957,1,1,1,0.5931,4,0.535,LESS
11,165,150,15,315,165,150,5.105945,5.010635,0.09531018,10.11658,5.105945,5.010635,0,1,0,0.7049,4,0.448,LESS
11,100,96,4,196,100,96,4.60517,4.564348,0.04082199,9.169518,4.60517,4.564348,0,1,0,0.8188,3,0.7318,LESS
11,110,100,10,210,100,110,4.70048,4.60517,0.09531018,9.305651,4.60517,4.70048,1,1,1,0.688,4,1.068,LESS
11,171,150,21,321,150,171,5.141664,5.010635,0.1310283,10.1523,5.010635,5.141664,1,1,1,0.6821,2,0.8062,LESS
11,132,150,18,282,132,150,4.882802,5.010635,0.1278334,9.893437,4.882802,5.010635,0,0,1,0.6928,3,0.7314,LESS
11,80,100,20,180,80,100,4.382027,4.60517,0.2231436,8.987197,4.382027,4.60517,0,0,1,0.5073,4,0.5926,LESS
11,104,100,4,204,100,104,4.644391,4.60517,0.03922071,9.249561,4.60517,4.644391,1,1,1,0.5687,2,0.9245,LESS
11,150,132,18,282,150,132,5.010635,4.882802,0.1278334,9.893437,5.010635,4.882802,0,1,0,1.8467,1,0.4648,LESS
11,100,98,2,198,100,98,4.60517,4.584967,0.02020271,9.190138,4.60517,4.584967,0,1,0,0.8123,1,0.4562,LESS
11,55,50,5,105,55,50,4.007333,3.912023,0.09531018,7.919356,4.007333,3.912023,0,1,0,1.962,2,1.1889,LESS
11,100,120,20,220,100,120,4.60517,4.787492,0.1823216,9.392662,4.60517,4.787492,0,0,1,0.5655,3,0.608,LESS
11,50,54,4,104,50,54,3.912023,3.988984,0.07696104,7.901007,3.912023,3.988984,0,0,1,0.6205,2,1.3996,LESS
11,96,100,4,196,100,96,4.564348,4.60517,0.04082199,9.169518,4.60517,4.564348,1,0,0,1.0353,1,0.6981,LESS
11,58,50,8,108,58,50,4.060443,3.912023,0.14842,7.972466,4.060443,3.912023,0,1,0,0.831,1,0.4994,LESS
11,180,150,30,330,150,180,5.192957,5.010635,0.1823216,10.20359,5.010635,5.192957,1,1,1,0.7952,4,0.933,LESS
11,84,100,16,184,84,100,4.430817,4.60517,0.1743534,9.035987,4.430817,4.60517,0,0,1,0.6928,2,0.8849,LESS
11,100,114,14,214,100,114,4.60517,4.736198,0.1310283,9.341369,4.60517,4.736198,0,0,1,0.5628,3,0.8489,LESS
11,98,100,2,198,100,98,4.584967,4.60517,0.02020271,9.190138,4.60517,4.584967,1,0,0,0.9487,2,0.699,LESS
11,106,100,6,206,100,106,4.663439,4.60517,0.05826891,9.268609,4.60517,4.663439,1,1,1,0.5534,4,1.1147,LESS
11,100,80,20,180,80,100,4.60517,4.382027,0.2231436,8.987197,4.382027,4.60517,1,1,1,0.6694,4,0.586,LESS
11,100,118,18,218,100,118,4.60517,4.770685,0.1655144,9.375855,4.60517,4.770685,0,0,1,1.1217,1,0.9483,LESS
11,114,100,14,214,100,114,4.736198,4.60517,0.1310283,9.341369,4.60517,4.736198,1,1,1,0.5512,2,0.9334,LESS
11,50,54,4,104,50,54,3.912023,3.988984,0.07696104,7.901007,3.912023,3.988984,0,0,1,0.6988,4,0.4558,LESS
11,50,59,9,109,59,50,3.912023,4.077537,0.1655144,7.98956,4.077537,3.912023,1,0,0,2.2347,1,0.4702,LESS
11,150,156,6,306,156,150,5.010635,5.049856,0.03922071,10.06049,5.049856,5.010635,1,0,0,0.5968,1,0.6491,LESS
11,52,50,2,102,52,50,3.951244,3.912023,0.03922071,7.863267,3.951244,3.912023,0,1,0,0.6955,1,1.0237,LESS
11,51,50,1,101,51,50,3.931826,3.912023,0.01980263,7.843849,3.931826,3.912023,0,1,0,0.884,1,0.8993,LESS
11,135,150,15,285,150,135,4.905275,5.010635,0.1053605,9.91591,5.010635,4.905275,1,0,0,0.7284,1,1.3158,LESS
11,46,50,4,96,46,50,3.828641,3.912023,0.08338161,7.740664,3.828641,3.912023,0,0,1,0.7066,4,0.5851,LESS
11,100,92,8,192,92,100,4.60517,4.521789,0.08338161,9.126959,4.521789,4.60517,1,1,1,0.7453,1,0.6498,LESS
11,50,47,3,97,47,50,3.912023,3.850148,0.0618754,7.762171,3.850148,3.912023,1,1,1,0.7366,1,0.5813,LESS
11,135,150,15,285,135,150,4.905275,5.010635,0.1053605,9.91591,4.905275,5.010635,0,0,1,0.7777,1,0.5718,LESS
11,150,132,18,282,132,150,5.010635,4.882802,0.1278334,9.893437,4.882802,5.010635,1,1,1,0.5473,2,0.9021,LESS
11,100,88,12,188,88,100,4.60517,4.477337,0.1278334,9.082507,4.477337,4.60517,1,1,1,0.4983,4,1.0772,LESS
11,50,59,9,109,59,50,3.912023,4.077537,0.1655144,7.98956,4.077537,3.912023,1,0,0,0.566,1,1.1039,LESS
11,50,44,6,94,50,44,3.912023,3.78419,0.1278334,7.696213,3.912023,3.78419,0,1,0,0.9555,1,0.4656,LESS
11,50,56,6,106,50,56,3.912023,4.025352,0.1133287,7.937375,3.912023,4.025352,0,0,1,0.6333,2,0.9987,LESS
11,92,100,8,192,92,100,4.521789,4.60517,0.08338161,9.126959,4.521789,4.60517,0,0,1,0.7244,1,0.6642,LESS
11,102,100,2,202,100,102,4.624973,4.60517,0.01980263,9.230143,4.60517,4.624973,1,1,1,0.5346,2,0.6746,LESS
11,100,88,12,188,88,100,4.60517,4.477337,0.1278334,9.082507,4.477337,4.60517,1,1,1,0.6593,1,0.712,LESS
11,41,50,9,91,41,50,3.713572,3.912023,0.1984509,7.625595,3.713572,3.912023,0,0,1,0.7989,4,0.8363,LESS
11,50,56,6,106,50,56,3.912023,4.025352,0.1133287,7.937375,3.912023,4.025352,0,0,1,0.7354,2,1.0491,LESS
11,100,116,16,216,116,100,4.60517,4.75359,0.14842,9.35876,4.75359,4.60517,1,0,0,0.9419,1,0.7246,LESS
11,150,141,9,291,150,141,5.010635,4.94876,0.0618754,9.959395,5.010635,4.94876,0,1,0,1.7167,1,0.3331,LESS
11,150,153,3,303,153,150,5.010635,5.030438,0.01980263,10.04107,5.030438,5.010635,1,0,0,0.558,2,0.7815,LESS
11,50,47,3,97,50,47,3.912023,3.850148,0.0618754,7.762171,3.912023,3.850148,0,1,0,0.9446,2,0.9646,LESS
11,150,153,3,303,153,150,5.010635,5.030438,0.01980263,10.04107,5.030438,5.010635,1,0,0,0.5523,1,0.5196,LESS
11,98,100,2,198,100,98,4.584967,4.60517,0.02020271,9.190138,4.60517,4.584967,1,0,0,0.587,1,0.8828,LESS
11,53,50,3,103,53,50,3.970292,3.912023,0.05826891,7.882315,3.970292,3.912023,0,1,0,0.6433,2,0.5823,LESS
11,96,100,4,196,100,96,4.564348,4.60517,0.04082199,9.169518,4.60517,4.564348,1,0,0,0.5244,1,1.0094,LESS
11,110,100,10,210,100,110,4.70048,4.60517,0.09531018,9.305651,4.60517,4.70048,1,1,1,0.5341,3,0.8012,LESS
11,90,100,10,190,90,100,4.49981,4.60517,0.1053605,9.10498,4.49981,4.60517,0,0,1,0.5508,2,1.116,LESS
11,48,50,2,98,48,50,3.871201,3.912023,0.04082199,7.783224,3.871201,3.912023,0,0,1,0.6184,3,1.0138,LESS
11,59,50,9,109,50,59,4.077537,3.912023,0.1655144,7.98956,3.912023,4.077537,1,1,1,1.0672,2,0.5865,LESS
11,40,50,10,90,40,50,3.688879,3.912023,0.2231436,7.600902,3.688879,3.912023,0,0,1,0.7709,2,1.0151,LESS
11,43,50,7,93,43,50,3.7612,3.912023,0.1508229,7.673223,3.7612,3.912023,0,0,1,1.0542,2,0.7019,LESS
11,50,49,1,99,50,49,3.912023,3.89182,0.02020271,7.803843,3.912023,3.89182,0,1,0,1.0251,2,0.8151,LESS
11,46,50,4,96,46,50,3.828641,3.912023,0.08338161,7.740664,3.828641,3.912023,0,0,1,0.7083,2,1.3159,LESS
11,47,50,3,97,47,50,3.850148,3.912023,0.0618754,7.762171,3.850148,3.912023,0,0,1,0.6936,3,0.6325,LESS
11,150,180,30,330,150,180,5.010635,5.192957,0.1823216,10.20359,5.010635,5.192957,0,0,1,0.7005,2,0.6337,LESS
11,50,57,7,107,50,57,3.912023,4.043051,0.1310283,7.955074,3.912023,4.043051,0,0,1,0.7738,1,1.0901,LESS
11,90,100,10,190,90,100,4.49981,4.60517,0.1053605,9.10498,4.49981,4.60517,0,0,1,0.6254,2,0.7489,LESS
11,41,50,9,91,41,50,3.713572,3.912023,0.1984509,7.625595,3.713572,3.912023,0,0,1,0.9832,2,0.7332,LESS
11,144,150,6,294,150,144,4.969813,5.010635,0.04082199,9.980449,5.010635,4.969813,1,0,0,0.677,3,0.7566,LESS
11,147,150,3,297,147,150,4.990433,5.010635,0.02020271,10.00107,4.990433,5.010635,0,0,1,0.9356,2,0.5318,LESS
11,54,50,4,104,50,54,3.988984,3.912023,0.07696104,7.901007,3.912023,3.988984,1,1,1,0.5352,3,0.9368,LESS
11,114,100,14,214,100,114,4.736198,4.60517,0.1310283,9.341369,4.60517,4.736198,1,1,1,0.5692,2,0.7381,LESS
11,150,135,15,285,135,150,5.010635,4.905275,0.1053605,9.91591,4.905275,5.010635,1,1,1,0.5547,3,0.6839,LESS
11,100,106,6,206,100,106,4.60517,4.663439,0.05826891,9.268609,4.60517,4.663439,0,0,1,0.4989,4,0.8933,LESS
11,150,135,15,285,135,150,5.010635,4.905275,0.1053605,9.91591,4.905275,5.010635,1,1,1,0.7733,1,0.9656,LESS
11,50,51,1,101,50,51,3.912023,3.931826,0.01980263,7.843849,3.912023,3.931826,0,0,1,0.5145,4,0.5702,LESS
11,150,177,27,327,177,150,5.010635,5.17615,0.1655144,10.18679,5.17615,5.010635,1,0,0,1.5541,1,0.7724,LESS
11,94,100,6,194,100,94,4.543295,4.60517,0.0618754,9.148465,4.60517,4.543295,1,0,0,0.6459,1,2.1014,LESS
11,100,82,18,182,82,100,4.60517,4.406719,0.1984509,9.011889,4.406719,4.60517,1,1,1,0.5211,4,0.875,LESS
11,100,110,10,210,110,100,4.60517,4.70048,0.09531018,9.305651,4.70048,4.60517,1,0,0,0.5471,1,1.0587,LESS
11,156,150,6,306,150,156,5.049856,5.010635,0.03922071,10.06049,5.010635,5.049856,1,1,1,2.03,1,0.3995,LESS
11,42,50,8,92,42,50,3.73767,3.912023,0.1743534,7.649693,3.73767,3.912023,0,0,1,0.547,4,1.1095,LESS
11,100,90,10,190,90,100,4.60517,4.49981,0.1053605,9.10498,4.49981,4.60517,1,1,1,1.4889,1,0.3818,LESS
11,108,100,8,208,100,108,4.682131,4.60517,0.07696104,9.287301,4.60517,4.682131,1,1,1,0.6031,2,0.8815,LESS
11,50,58,8,108,50,58,3.912023,4.060443,0.14842,7.972466,3.912023,4.060443,0,0,1,0.6696,2,0.8491,LESS
11,150,180,30,330,150,180,5.010635,5.192957,0.1823216,10.20359,5.010635,5.192957,0,0,1,0.5662,1,0.6499,LESS
11,50,58,8,108,50,58,3.912023,4.060443,0.14842,7.972466,3.912023,4.060443,0,0,1,0.7769,3,0.6657,LESS
11,50,42,8,92,42,50,3.912023,3.73767,0.1743534,7.649693,3.73767,3.912023,1,1,1,0.6468,1,1.0968,LESS
11,45,50,5,95,45,50,3.806662,3.912023,0.1053605,7.718685,3.806662,3.912023,0,0,1,0.5759,1,0.8489,LESS
11,49,50,1,99,49,50,3.89182,3.912023,0.02020271,7.803843,3.89182,3.912023,0,0,1,2.8245,1,0.469,LESS
11,150,120,30,270,120,150,5.010635,4.787492,0.2231436,9.798127,4.787492,5.010635,1,1,1,0.6101,3,0.7826,LESS
11,92,100,8,192,92,100,4.521789,4.60517,0.08338161,9.126959,4.521789,4.60517,0,0,1,1.0632,1,0.7657,LESS
11,49,50,1,99,49,50,3.89182,3.912023,0.02020271,7.803843,3.89182,3.912023,0,0,1,0.6495,3,0.923,LESS
11,150,126,24,276,126,150,5.010635,4.836282,0.1743534,9.846917,4.836282,5.010635,1,1,1,0.5779,3,0.7923,LESS
11,156,150,6,306,156,150,5.049856,5.010635,0.03922071,10.06049,5.049856,5.010635,0,1,0,0.9778,2,1.08,LESS
11,100,114,14,214,100,114,4.60517,4.736198,0.1310283,9.341369,4.60517,4.736198,0,0,1,0.6961,2,0.616,LESS
11,162,150,12,312,150,162,5.087596,5.010635,0.07696104,10.09823,5.010635,5.087596,1,1,1,1.0694,2,0.635,LESS
11,55,50,5,105,55,50,4.007333,3.912023,0.09531018,7.919356,4.007333,3.912023,0,1,0,0.719,4,0.5846,LESS
11,43,50,7,93,43,50,3.7612,3.912023,0.1508229,7.673223,3.7612,3.912023,0,0,1,0.5201,1,1.0445,LESS
11,100,102,2,202,102,100,4.60517,4.624973,0.01980263,9.230143,4.624973,4.60517,1,0,0,0.6267,2,0.8481,LESS
11,150,138,12,288,138,150,5.010635,4.927254,0.08338161,9.937889,4.927254,5.010635,1,1,1,0.6177,2,0.7566,LESS
11,112,100,12,212,100,112,4.718499,4.60517,0.1133287,9.323669,4.60517,4.718499,1,1,1,0.7764,2,0.7351,LESS
11,50,60,10,110,50,60,3.912023,4.094345,0.1823216,8.006368,3.912023,4.094345,0,0,1,0.5201,4,0.5755,LESS
11,100,120,20,220,100,120,4.60517,4.787492,0.1823216,9.392662,4.60517,4.787492,0,0,1,0.7694,1,1.2053,LESS
11,50,57,7,107,50,57,3.912023,4.043051,0.1310283,7.955074,3.912023,4.043051,0,0,1,0.7478,2,1.3348,LESS
11,60,50,10,110,50,60,4.094345,3.912023,0.1823216,8.006368,3.912023,4.094345,1,1,1,0.925,2,0.5343,LESS
11,50,60,10,110,50,60,3.912023,4.094345,0.1823216,8.006368,3.912023,4.094345,0,0,1,0.594,1,0.8523,LESS
11,82,100,18,182,82,100,4.406719,4.60517,0.1984509,9.011889,4.406719,4.60517,0,0,1,0.6408,1,0.947,LESS
11,47,50,3,97,50,47,3.850148,3.912023,0.0618754,7.762171,3.912023,3.850148,1,0,0,0.7249,1,0.7824,LESS
11,45,50,5,95,45,50,3.806662,3.912023,0.1053605,7.718685,3.806662,3.912023,0,0,1,0.5389,4,0.5267,LESS
11,100,112,12,212,112,100,4.60517,4.718499,0.1133287,9.323669,4.718499,4.60517,1,0,0,1.4508,1,0.4664,LESS
11,100,118,18,218,100,118,4.60517,4.770685,0.1655144,9.375855,4.60517,4.770685,0,0,1,1.1145,2,1.2825,LESS
11,50,52,2,102,52,50,3.912023,3.951244,0.03922071,7.863267,3.951244,3.912023,1,0,0,2.1482,2,0.6814,LESS
11,168,150,18,318,150,168,5.123964,5.010635,0.1133287,10.1346,5.010635,5.123964,1,1,1,1.3377,1,0.5526,LESS
11,118,100,18,218,100,118,4.770685,4.60517,0.1655144,9.375855,4.60517,4.770685,1,1,1,0.81,1,1.056,LESS
11,50,51,1,101,50,51,3.912023,3.931826,0.01980263,7.843849,3.912023,3.931826,0,0,1,1.0736,3,0.5472,LESS
11,86,100,14,186,86,100,4.454347,4.60517,0.1508229,9.059517,4.454347,4.60517,0,0,1,1.059,1,1.448,LESS
11,82,100,18,182,100,82,4.406719,4.60517,0.1984509,9.011889,4.60517,4.406719,1,0,0,1.9199,2,0.6658,LESS
11,150,168,18,318,150,168,5.010635,5.123964,0.1133287,10.1346,5.010635,5.123964,0,0,1,1.0652,1,1.0677,LESS
11,50,53,3,103,53,50,3.912023,3.970292,0.05826891,7.882315,3.970292,3.912023,1,0,0,2.1291,1,0.3585,LESS
11,150,174,24,324,150,174,5.010635,5.159055,0.14842,10.16969,5.010635,5.159055,0,0,1,1.1328,1,1.3549,LESS
11,60,50,10,110,50,60,4.094345,3.912023,0.1823216,8.006368,3.912023,4.094345,1,1,1,1.7836,1,0.6696,LESS
11,100,108,8,208,108,100,4.60517,4.682131,0.07696104,9.287301,4.682131,4.60517,1,0,0,0.9821,1,0.6392,LESS
11,53,50,3,103,53,50,3.970292,3.912023,0.05826891,7.882315,3.970292,3.912023,0,1,0,1.1511,1,0.5651,LESS
11,150,156,6,306,156,150,5.010635,5.049856,0.03922071,10.06049,5.049856,5.010635,1,0,0,0.9532,3,0.8554,LESS
11,162,150,12,312,150,162,5.087596,5.010635,0.07696104,10.09823,5.010635,5.087596,1,1,1,0.677,1,1.5328,LESS
11,88,100,12,188,88,100,4.477337,4.60517,0.1278334,9.082507,4.477337,4.60517,0,0,1,0.5018,1,0.6172,LESS
11,94,100,6,194,94,100,4.543295,4.60517,0.0618754,9.148465,4.543295,4.60517,0,0,1,0.5424,3,0.8418,LESS
11,100,86,14,186,86,100,4.60517,4.454347,0.1508229,9.059517,4.454347,4.60517,1,1,1,1.038,2,0.8407,LESS
11,116,100,16,216,116,100,4.75359,4.60517,0.14842,9.35876,4.75359,4.60517,0,1,0,1.2223,2,0.782,LESS
11,153,150,3,303,150,153,5.030438,5.010635,0.01980263,10.04107,5.010635,5.030438,1,1,1,0.5169,2,1.3243,LESS
11,50,43,7,93,43,50,3.912023,3.7612,0.1508229,7.673223,3.7612,3.912023,1,1,1,0.7459,4,0.5735,LESS
11,141,150,9,291,141,150,4.94876,5.010635,0.0618754,9.959395,4.94876,5.010635,0,0,1,1.046,2,0.831,LESS
11,50,45,5,95,50,45,3.912023,3.806662,0.1053605,7.718685,3.912023,3.806662,0,1,0,0.6626,4,0.7043,LESS
11,147,150,3,297,147,150,4.990433,5.010635,0.02020271,10.00107,4.990433,5.010635,0,0,1,2.3205,1,0.5971,LESS
11,84,100,16,184,100,84,4.430817,4.60517,0.1743534,9.035987,4.60517,4.430817,1,0,0,1.6433,1,0.5554,LESS
11,58,50,8,108,50,58,4.060443,3.912023,0.14842,7.972466,3.912023,4.060443,1,1,1,0.6511,4,0.5825,LESS
11,100,104,4,204,100,104,4.60517,4.644391,0.03922071,9.249561,4.60517,4.644391,0,0,1,1.2844,2,1.1731,LESS
11,150,168,18,318,168,150,5.010635,5.123964,0.1133287,10.1346,5.123964,5.010635,1,0,0,1.6693,1,1.1338,LESS
11,150,123,27,273,123,150,5.010635,4.812184,0.1984509,9.82282,4.812184,5.010635,1,1,1,0.5406,1,0.6246,LESS
11,159,150,9,309,150,159,5.068904,5.010635,0.05826891,10.07954,5.010635,5.068904,1,1,1,0.9119,1,0.5369,LESS
11,150,120,30,270,120,150,5.010635,4.787492,0.2231436,9.798127,4.787492,5.010635,1,1,1,0.5683,4,0.4684,LESS
11,100,94,6,194,94,100,4.60517,4.543295,0.0618754,9.148465,4.543295,4.60517,1,1,1,1.1063,2,0.6478,LESS
11,118,100,18,218,100,118,4.770685,4.60517,0.1655144,9.375855,4.60517,4.770685,1,1,1,0.5782,1,0.784,LESS
11,138,150,12,288,138,150,4.927254,5.010635,0.08338161,9.937889,4.927254,5.010635,0,0,1,0.9145,1,0.6684,LESS
11,100,106,6,206,100,106,4.60517,4.663439,0.05826891,9.268609,4.60517,4.663439,0,0,1,0.6955,1,0.6046,LESS
11,150,144,6,294,144,150,5.010635,4.969813,0.04082199,9.980449,4.969813,5.010635,1,1,1,0.5529,3,0.8495,LESS
11,100,82,18,182,100,82,4.60517,4.406719,0.1984509,9.011889,4.60517,4.406719,0,1,0,0.7171,3,1.299,LESS
11,174,150,24,324,150,174,5.159055,5.010635,0.14842,10.16969,5.010635,5.159055,1,1,1,0.5322,4,0.9052,LESS
11,100,112,12,212,100,112,4.60517,4.718499,0.1133287,9.323669,4.60517,4.718499,0,0,1,0.6087,4,0.4189,LESS
11,42,50,8,92,42,50,3.73767,3.912023,0.1743534,7.649693,3.73767,3.912023,0,0,1,0.9529,3,1.2497,LESS
11,100,90,10,190,90,100,4.60517,4.49981,0.1053605,9.10498,4.49981,4.60517,1,1,1,0.507,2,1.2583,LESS
11,100,110,10,210,100,110,4.60517,4.70048,0.09531018,9.305651,4.60517,4.70048,0,0,1,1.41,2,0.6235,LESS
11,100,92,8,192,92,100,4.60517,4.521789,0.08338161,9.126959,4.521789,4.60517,1,1,1,0.5981,2,0.4656,LESS
11,56,50,6,106,50,56,4.025352,3.912023,0.1133287,7.937375,3.912023,4.025352,1,1,1,1.05,3,0.5998,LESS
11,144,150,6,294,144,150,4.969813,5.010635,0.04082199,9.980449,4.969813,5.010635,0,0,1,2.3845,1,0.6378,LESS
11,100,94,6,194,94,100,4.60517,4.543295,0.0618754,9.148465,4.543295,4.60517,1,1,1,0.5781,4,0.6816,LESS
11,150,162,12,312,150,162,5.010635,5.087596,0.07696104,10.09823,5.010635,5.087596,0,0,1,0.969,2,1.1152,LESS
11,57,50,7,107,50,57,4.043051,3.912023,0.1310283,7.955074,3.912023,4.043051,1,1,1,1.0954,1,0.7819,LESS
11,48,50,2,98,50,48,3.871201,3.912023,0.04082199,7.783224,3.912023,3.871201,1,0,0,1.3378,1,1.5995,LESS
11,132,150,18,282,150,132,4.882802,5.010635,0.1278334,9.893437,5.010635,4.882802,1,0,0,1.1573,1,0.8012,LESS
11,120,100,20,220,100,120,4.787492,4.60517,0.1823216,9.392662,4.60517,4.787492,1,1,1,0.6603,4,0.5653,LESS
11,100,102,2,202,100,102,4.60517,4.624973,0.01980263,9.230143,4.60517,4.624973,0,0,1,0.6159,4,0.4498,LESS
11,88,100,12,188,88,100,4.477337,4.60517,0.1278334,9.082507,4.477337,4.60517,0,0,1,0.696,3,1.2655,LESS
11,50,45,5,95,50,45,3.912023,3.806662,0.1053605,7.718685,3.912023,3.806662,0,1,0,0.95,2,0.7211,LESS
11,150,147,3,297,147,150,5.010635,4.990433,0.02020271,10.00107,4.990433,5.010635,1,1,1,0.845,2,0.78,LESS
11,44,50,6,94,44,50,3.78419,3.912023,0.1278334,7.696213,3.78419,3.912023,0,0,1,0.9797,3,0.7807,LESS
11,150,165,15,315,150,165,5.010635,5.105945,0.09531018,10.11658,5.010635,5.105945,0,0,1,0.6203,3,0.5339,LESS
11,100,84,16,184,84,100,4.60517,4.430817,0.1743534,9.035987,4.430817,4.60517,1,1,1,0.8855,1,1.0853,LESS
11,120,150,30,270,120,150,4.787492,5.010635,0.2231436,9.798127,4.787492,5.010635,0,0,1,0.56,2,0.9221,LESS
11,50,40,10,90,40,50,3.912023,3.688879,0.2231436,7.600902,3.688879,3.912023,1,1,1,1.4457,1,0.8052,LESS
11,126,150,24,276,126,150,4.836282,5.010635,0.1743534,9.846917,4.836282,5.010635,0,0,1,1.0235,3,0.5327,LESS
11,50,41,9,91,41,50,3.912023,3.713572,0.1984509,7.625595,3.713572,3.912023,1,1,1,0.6232,4,0.4653,LESS
11,100,96,4,196,96,100,4.60517,4.564348,0.04082199,9.169518,4.564348,4.60517,1,1,1,2.1053,1,0.5485,LESS
11,50,55,5,105,50,55,3.912023,4.007333,0.09531018,7.919356,3.912023,4.007333,0,0,1,0.6467,4,0.8914,LESS
11,100,84,16,184,84,100,4.60517,4.430817,0.1743534,9.035987,4.430817,4.60517,1,1,1,0.7466,1,1.1322,LESS
11,50,43,7,93,50,43,3.912023,3.7612,0.1508229,7.673223,3.912023,3.7612,0,1,0,0.6769,3,0.6401,LESS
11,106,100,6,206,100,106,4.663439,4.60517,0.05826891,9.268609,4.60517,4.663439,1,1,1,0.6524,1,1.2236,LESS
11,150,165,15,315,165,150,5.010635,5.105945,0.09531018,10.11658,5.105945,5.010635,1,0,0,1.0009,3,0.8649,LESS
11,171,150,21,321,171,150,5.141664,5.010635,0.1310283,10.1523,5.141664,5.010635,0,1,0,3.1203,1,0.1644,LESS
11,138,150,12,288,138,150,4.927254,5.010635,0.08338161,9.937889,4.927254,5.010635,0,0,1,1.0151,2,0.9665,LESS
11,129,150,21,279,150,129,4.859812,5.010635,0.1508229,9.870448,5.010635,4.859812,1,0,0,0.7333,3,0.6474,LESS
11,50,46,4,96,50,46,3.912023,3.828641,0.08338161,7.740664,3.912023,3.828641,0,1,0,2.0799,1,0.699,LESS
11,150,126,24,276,126,150,5.010635,4.836282,0.1743534,9.846917,4.836282,5.010635,1,1,1,0.6087,3,0.6648,LESS
11,150,138,12,288,138,150,5.010635,4.927254,0.08338161,9.937889,4.927254,5.010635,1,1,1,2.0462,1,0.4187,LESS
11,150,129,21,279,129,150,5.010635,4.859812,0.1508229,9.870448,4.859812,5.010635,1,1,1,0.5836,3,0.5488,LESS
11,50,42,8,92,50,42,3.912023,3.73767,0.1743534,7.649693,3.912023,3.73767,0,1,0,1.8313,1,1.0418,LESS
11,159,150,9,309,150,159,5.068904,5.010635,0.05826891,10.07954,5.010635,5.068904,1,1,1,0.6354,2,1.2495,LESS
11,100,86,14,186,86,100,4.60517,4.454347,0.1508229,9.059517,4.454347,4.60517,1,1,1,1.447,2,0.7153,LESS
11,86,100,14,186,86,100,4.454347,4.60517,0.1508229,9.059517,4.454347,4.60517,0,0,1,0.972,3,0.7928,LESS
11,102,100,2,202,100,102,4.624973,4.60517,0.01980263,9.230143,4.60517,4.624973,1,1,1,0.7842,2,0.8651,LESS
11,57,50,7,107,57,50,4.043051,3.912023,0.1310283,7.955074,4.043051,3.912023,0,1,0,0.9998,3,0.5649,LESS
11,50,55,5,105,50,55,3.912023,4.007333,0.09531018,7.919356,3.912023,4.007333,0,0,1,0.9717,1,0.8729,LESS
11,104,100,4,204,100,104,4.644391,4.60517,0.03922071,9.249561,4.60517,4.644391,1,1,1,0.6559,3,0.5343,LESS
11,52,50,2,102,52,50,3.951244,3.912023,0.03922071,7.863267,3.951244,3.912023,0,1,0,2.0011,1,1.5325,LESS
11,150,141,9,291,141,150,5.010635,4.94876,0.0618754,9.959395,4.94876,5.010635,1,1,1,0.7322,4,0.4856,LESS
11,50,40,10,90,40,50,3.912023,3.688879,0.2231436,7.600902,3.688879,3.912023,1,1,1,1.0085,4,0.5988,LESS
11,51,50,1,101,51,50,3.931826,3.912023,0.01980263,7.843849,3.931826,3.912023,0,1,0,0.6102,3,1.5507,LESS
11,150,177,27,327,150,177,5.010635,5.17615,0.1655144,10.18679,5.010635,5.17615,0,0,1,1.7057,1,0.5657,LESS
11,165,150,15,315,150,165,5.105945,5.010635,0.09531018,10.11658,5.010635,5.105945,1,1,1,0.5728,4,1.015,LESS
11,100,80,20,180,80,100,4.60517,4.382027,0.2231436,8.987197,4.382027,4.60517,1,1,1,0.6663,4,0.6545,LESS
12,50,45,5,95,45,50,3.912023,3.806662,0.1053605,7.718685,3.806662,3.912023,1,1,1,0.8782,4,0.6133,LESS
12,118,100,18,218,100,118,4.770685,4.60517,0.1655144,9.375855,4.60517,4.770685,1,1,1,0.8875,3,0.6657,LESS
12,150,168,18,318,150,168,5.010635,5.123964,0.1133287,10.1346,5.010635,5.123964,0,0,1,0.7252,4,0.586,LESS
12,52,50,2,102,52,50,3.951244,3.912023,0.03922071,7.863267,3.951244,3.912023,0,1,0,0.7779,4,0.3514,LESS
12,150,165,15,315,150,165,5.010635,5.105945,0.09531018,10.11658,5.010635,5.105945,0,0,1,0.8398,4,0.4325,LESS
12,150,159,9,309,150,159,5.010635,5.068904,0.05826891,10.07954,5.010635,5.068904,0,0,1,0.8845,3,0.549,LESS
12,100,94,6,194,100,94,4.60517,4.543295,0.0618754,9.148465,4.60517,4.543295,0,1,0,0.6798,4,0.7447,LESS
12,165,150,15,315,150,165,5.105945,5.010635,0.09531018,10.11658,5.010635,5.105945,1,1,1,1.4077,2,1.4639,LESS
12,48,50,2,98,48,50,3.871201,3.912023,0.04082199,7.783224,3.871201,3.912023,0,0,1,0.7123,4,0.6808,LESS
12,52,50,2,102,52,50,3.951244,3.912023,0.03922071,7.863267,3.951244,3.912023,0,1,0,0.7146,4,0.3882,LESS
12,100,80,20,180,100,80,4.60517,4.382027,0.2231436,8.987197,4.60517,4.382027,0,1,0,0.8887,3,0.6797,LESS
12,144,150,6,294,144,150,4.969813,5.010635,0.04082199,9.980449,4.969813,5.010635,0,0,1,0.8645,4,0.4973,LESS
12,46,50,4,96,46,50,3.828641,3.912023,0.08338161,7.740664,3.828641,3.912023,0,0,1,0.9338,4,0.3684,LESS
12,135,150,15,285,135,150,4.905275,5.010635,0.1053605,9.91591,4.905275,5.010635,0,0,1,0.8345,4,0.3509,LESS
12,50,40,10,90,50,40,3.912023,3.688879,0.2231436,7.600902,3.912023,3.688879,0,1,0,0.7128,4,0.396,LESS
12,50,42,8,92,50,42,3.912023,3.73767,0.1743534,7.649693,3.912023,3.73767,0,1,0,0.8145,2,2.0599,LESS
12,104,100,4,204,104,100,4.644391,4.60517,0.03922071,9.249561,4.644391,4.60517,0,1,0,0.9418,3,0.5762,LESS
12,120,100,20,220,100,120,4.787492,4.60517,0.1823216,9.392662,4.60517,4.787492,1,1,1,1.0888,4,0.5553,LESS
12,50,59,9,109,50,59,3.912023,4.077537,0.1655144,7.98956,3.912023,4.077537,0,0,1,0.8979,4,0.3273,LESS
12,84,100,16,184,84,100,4.430817,4.60517,0.1743534,9.035987,4.430817,4.60517,0,0,1,0.9279,4,0.3485,LESS
12,100,90,10,190,100,90,4.60517,4.49981,0.1053605,9.10498,4.60517,4.49981,0,1,0,0.9209,3,0.3589,LESS
12,156,150,6,306,156,150,5.049856,5.010635,0.03922071,10.06049,5.049856,5.010635,0,1,0,1.19,2,1.4072,LESS
12,126,150,24,276,126,150,4.836282,5.010635,0.1743534,9.846917,4.836282,5.010635,0,0,1,0.9171,2,0.5422,LESS
12,88,100,12,188,88,100,4.477337,4.60517,0.1278334,9.082507,4.477337,4.60517,0,0,1,0.8961,4,0.4343,LESS
12,150,126,24,276,126,150,5.010635,4.836282,0.1743534,9.846917,4.836282,5.010635,1,1,1,1.2728,1,0.7953,LESS
12,120,150,30,270,120,150,4.787492,5.010635,0.2231436,9.798127,4.787492,5.010635,0,0,1,1.219,2,2.0034,LESS
12,48,50,2,98,48,50,3.871201,3.912023,0.04082199,7.783224,3.871201,3.912023,0,0,1,1.0546,4,0.4868,LESS
12,53,50,3,103,53,50,3.970292,3.912023,0.05826891,7.882315,3.970292,3.912023,0,1,0,0.9298,4,0.346,LESS
12,100,106,6,206,100,106,4.60517,4.663439,0.05826891,9.268609,4.60517,4.663439,0,0,1,0.8937,4,0.3088,LESS
12,98,100,2,198,98,100,4.584967,4.60517,0.02020271,9.190138,4.584967,4.60517,0,0,1,0.6853,4,0.3044,LESS
12,92,100,8,192,92,100,4.521789,4.60517,0.08338161,9.126959,4.521789,4.60517,0,0,1,0.7437,4,0.2885,LESS
12,150,135,15,285,150,135,5.010635,4.905275,0.1053605,9.91591,5.010635,4.905275,0,1,0,0.7972,3,0.4784,LESS
12,50,46,4,96,46,50,3.912023,3.828641,0.08338161,7.740664,3.828641,3.912023,1,1,1,1.3666,2,0.668,LESS
12,150,144,6,294,150,144,5.010635,4.969813,0.04082199,9.980449,5.010635,4.969813,0,1,0,0.8564,4,0.304,LESS
12,47,50,3,97,47,50,3.850148,3.912023,0.0618754,7.762171,3.850148,3.912023,0,0,1,0.854,4,0.3084,LESS
12,100,106,6,206,100,106,4.60517,4.663439,0.05826891,9.268609,4.60517,4.663439,0,0,1,0.6602,4,0.2918,LESS
12,150,162,12,312,150,162,5.010635,5.087596,0.07696104,10.09823,5.010635,5.087596,0,0,1,0.8127,4,0.4213,LESS
12,100,118,18,218,100,118,4.60517,4.770685,0.1655144,9.375855,4.60517,4.770685,0,0,1,0.8135,4,0.2387,LESS
12,116,100,16,216,100,116,4.75359,4.60517,0.14842,9.35876,4.60517,4.75359,1,1,1,1.269,1,1.7237,LESS
12,129,150,21,279,129,150,4.859812,5.010635,0.1508229,9.870448,4.859812,5.010635,0,0,1,1.7042,2,1.7807,LESS
12,110,100,10,210,100,110,4.70048,4.60517,0.09531018,9.305651,4.60517,4.70048,1,1,1,1.1714,2,0.9467,LESS
12,106,100,6,206,100,106,4.663439,4.60517,0.05826891,9.268609,4.60517,4.663439,1,1,1,1.6654,2,1.1738,LESS
12,100,102,2,202,100,102,4.60517,4.624973,0.01980263,9.230143,4.60517,4.624973,0,0,1,1.0327,2,0.4388,LESS
12,168,150,18,318,150,168,5.123964,5.010635,0.1133287,10.1346,5.010635,5.123964,1,1,1,0.9176,4,1.8145,LESS
12,150,120,30,270,120,150,5.010635,4.787492,0.2231436,9.798127,4.787492,5.010635,1,1,1,0.8831,4,0.2931,LESS
12,100,110,10,210,100,110,4.60517,4.70048,0.09531018,9.305651,4.60517,4.70048,0,0,1,0.6815,4,0.3013,LESS
12,92,100,8,192,92,100,4.521789,4.60517,0.08338161,9.126959,4.521789,4.60517,0,0,1,1.6549,2,1.1844,LESS
12,100,82,18,182,82,100,4.60517,4.406719,0.1984509,9.011889,4.406719,4.60517,1,1,1,1.0446,3,0.488,LESS
12,50,52,2,102,50,52,3.912023,3.951244,0.03922071,7.863267,3.912023,3.951244,0,0,1,0.8456,4,0.2543,LESS
12,150,177,27,327,150,177,5.010635,5.17615,0.1655144,10.18679,5.010635,5.17615,0,0,1,0.8564,4,0.1915,LESS
12,100,90,10,190,100,90,4.60517,4.49981,0.1053605,9.10498,4.60517,4.49981,0,1,0,0.8363,4,0.2241,LESS
12,147,150,3,297,147,150,4.990433,5.010635,0.02020271,10.00107,4.990433,5.010635,0,0,1,0.6251,3,2.9009,LESS
12,84,100,16,184,84,100,4.430817,4.60517,0.1743534,9.035987,4.430817,4.60517,0,0,1,0.5346,4,0.3844,LESS
12,153,150,3,303,153,150,5.030438,5.010635,0.01980263,10.04107,5.030438,5.010635,0,1,0,0.6425,3,0.9036,LESS
12,49,50,1,99,49,50,3.89182,3.912023,0.02020271,7.803843,3.89182,3.912023,0,0,1,0.598,4,0.3213,LESS
12,174,150,24,324,150,174,5.159055,5.010635,0.14842,10.16969,5.010635,5.159055,1,1,1,0.8133,4,0.3016,LESS
12,50,43,7,93,43,50,3.912023,3.7612,0.1508229,7.673223,3.7612,3.912023,1,1,1,2.1551,2,1.1568,LESS
12,108,100,8,208,100,108,4.682131,4.60517,0.07696104,9.287301,4.60517,4.682131,1,1,1,1.1002,1,0.4882,LESS
12,50,56,6,106,50,56,3.912023,4.025352,0.1133287,7.937375,3.912023,4.025352,0,0,1,0.8838,4,0.2796,LESS
12,150,129,21,279,129,150,5.010635,4.859812,0.1508229,9.870448,4.859812,5.010635,1,1,1,0.8185,3,0.956,LESS
12,50,40,10,90,50,40,3.912023,3.688879,0.2231436,7.600902,3.912023,3.688879,0,1,0,0.832,4,0.2966,LESS
12,50,57,7,107,50,57,3.912023,4.043051,0.1310283,7.955074,3.912023,4.043051,0,0,1,0.9866,3,0.3623,LESS
12,50,45,5,95,45,50,3.912023,3.806662,0.1053605,7.718685,3.806662,3.912023,1,1,1,1.5807,1,0.6133,LESS
12,171,150,21,321,150,171,5.141664,5.010635,0.1310283,10.1523,5.010635,5.141664,1,1,1,0.9376,3,0.9356,LESS
12,56,50,6,106,50,56,4.025352,3.912023,0.1133287,7.937375,3.912023,4.025352,1,1,1,1.7966,1,1.0662,LESS
12,100,88,12,188,88,100,4.60517,4.477337,0.1278334,9.082507,4.477337,4.60517,1,1,1,1.5752,1,0.8062,LESS
12,43,50,7,93,43,50,3.7612,3.912023,0.1508229,7.673223,3.7612,3.912023,0,0,1,0.8874,4,0.3131,LESS
12,102,100,2,202,102,100,4.624973,4.60517,0.01980263,9.230143,4.624973,4.60517,0,1,0,0.8419,4,0.4511,LESS
12,156,150,6,306,150,156,5.049856,5.010635,0.03922071,10.06049,5.010635,5.049856,1,1,1,1.0031,2,0.8354,LESS
12,90,100,10,190,100,90,4.49981,4.60517,0.1053605,9.10498,4.60517,4.49981,1,0,0,1.3986,1,0.5342,LESS
12,96,100,4,196,96,100,4.564348,4.60517,0.04082199,9.169518,4.564348,4.60517,0,0,1,1.109,1,0.3094,LESS
12,100,92,8,192,92,100,4.60517,4.521789,0.08338161,9.126959,4.521789,4.60517,1,1,1,1.2043,1,0.3014,LESS
12,96,100,4,196,96,100,4.564348,4.60517,0.04082199,9.169518,4.564348,4.60517,0,0,1,1.0824,4,0.3677,LESS
12,141,150,9,291,141,150,4.94876,5.010635,0.0618754,9.959395,4.94876,5.010635,0,0,1,1.8245,2,0.7897,LESS
12,45,50,5,95,45,50,3.806662,3.912023,0.1053605,7.718685,3.806662,3.912023,0,0,1,0.8944,4,0.304,LESS
12,132,150,18,282,132,150,4.882802,5.010635,0.1278334,9.893437,4.882802,5.010635,0,0,1,1.4369,2,0.9687,LESS
12,88,100,12,188,88,100,4.477337,4.60517,0.1278334,9.082507,4.477337,4.60517,0,0,1,1.2832,2,0.7684,LESS
12,100,108,8,208,100,108,4.60517,4.682131,0.07696104,9.287301,4.60517,4.682131,0,0,1,1.2252,2,0.6199,LESS
12,112,100,12,212,112,100,4.718499,4.60517,0.1133287,9.323669,4.718499,4.60517,0,1,0,1.0474,2,0.4747,LESS
12,82,100,18,182,82,100,4.406719,4.60517,0.1984509,9.011889,4.406719,4.60517,0,0,1,0.9926,2,0.467,LESS
12,159,150,9,309,150,159,5.068904,5.010635,0.05826891,10.07954,5.010635,5.068904,1,1,1,1.2976,2,0.6043,LESS
12,114,100,14,214,100,114,4.736198,4.60517,0.1310283,9.341369,4.60517,4.736198,1,1,1,0.981,2,0.4347,LESS
12,40,50,10,90,40,50,3.688879,3.912023,0.2231436,7.600902,3.688879,3.912023,0,0,1,0.8362,4,0.3129,LESS
12,90,100,10,190,90,100,4.49981,4.60517,0.1053605,9.10498,4.49981,4.60517,0,0,1,1.2059,2,1.1605,LESS
12,56,50,6,106,50,56,4.025352,3.912023,0.1133287,7.937375,3.912023,4.025352,1,1,1,1.5054,2,0.3872,LESS
12,50,49,1,99,50,49,3.912023,3.89182,0.02020271,7.803843,3.912023,3.89182,0,1,0,0.8623,4,0.2685,LESS
12,150,168,18,318,150,168,5.010635,5.123964,0.1133287,10.1346,5.010635,5.123964,0,0,1,1.1023,2,0.4397,LESS
12,177,150,27,327,150,177,5.17615,5.010635,0.1655144,10.18679,5.010635,5.17615,1,1,1,0.8965,3,0.7965,LESS
12,100,86,14,186,86,100,4.60517,4.454347,0.1508229,9.059517,4.454347,4.60517,1,1,1,1.4769,2,0.5798,LESS
12,60,50,10,110,60,50,4.094345,3.912023,0.1823216,8.006368,4.094345,3.912023,0,1,0,1.1565,2,0.4529,LESS
12,50,51,1,101,50,51,3.912023,3.931826,0.01980263,7.843849,3.912023,3.931826,0,0,1,0.9217,3,0.7852,LESS
12,150,132,18,282,132,150,5.010635,4.882802,0.1278334,9.893437,4.882802,5.010635,1,1,1,0.8671,4,0.4757,LESS
12,50,47,3,97,47,50,3.912023,3.850148,0.0618754,7.762171,3.850148,3.912023,1,1,1,1.2171,2,1.0069,LESS
12,150,156,6,306,150,156,5.010635,5.049856,0.03922071,10.06049,5.010635,5.049856,0,0,1,0.9499,2,0.4892,LESS
12,80,100,20,180,80,100,4.382027,4.60517,0.2231436,8.987197,4.382027,4.60517,0,0,1,1.1506,2,0.3854,LESS
12,165,150,15,315,150,165,5.105945,5.010635,0.09531018,10.11658,5.010635,5.105945,1,1,1,0.8297,4,0.7467,LESS
12,150,147,3,297,150,147,5.010635,4.990433,0.02020271,10.00107,5.010635,4.990433,0,1,0,0.899,3,0.4727,LESS
12,162,150,12,312,150,162,5.087596,5.010635,0.07696104,10.09823,5.010635,5.087596,1,1,1,1.0519,2,0.358,LESS
12,100,114,14,214,100,114,4.60517,4.736198,0.1310283,9.341369,4.60517,4.736198,0,0,1,0.8454,4,0.2509,LESS
12,150,171,21,321,150,171,5.010635,5.141664,0.1310283,10.1523,5.010635,5.141664,0,0,1,0.6275,4,0.3009,LESS
12,150,153,3,303,150,153,5.010635,5.030438,0.01980263,10.04107,5.010635,5.030438,0,0,1,1.7154,2,0.4682,LESS
12,150,171,21,321,150,171,5.010635,5.141664,0.1310283,10.1523,5.010635,5.141664,0,0,1,1.0566,2,0.5045,LESS
12,120,150,30,270,120,150,4.787492,5.010635,0.2231436,9.798127,4.787492,5.010635,0,0,1,0.891,4,0.2532,LESS
12,100,92,8,192,100,92,4.60517,4.521789,0.08338161,9.126959,4.60517,4.521789,0,1,0,1.0423,4,0.8184,LESS
12,100,94,6,194,100,94,4.60517,4.543295,0.0618754,9.148465,4.60517,4.543295,0,1,0,1.1993,4,0.4463,LESS
12,100,104,4,204,100,104,4.60517,4.644391,0.03922071,9.249561,4.60517,4.644391,0,0,1,0.8008,4,0.3341,LESS
12,100,118,18,218,100,118,4.60517,4.770685,0.1655144,9.375855,4.60517,4.770685,0,0,1,0.6376,4,0.2743,LESS
12,50,56,6,106,50,56,3.912023,4.025352,0.1133287,7.937375,3.912023,4.025352,0,0,1,0.8634,4,0.2176,LESS
12,100,80,20,180,80,100,4.60517,4.382027,0.2231436,8.987197,4.382027,4.60517,1,1,1,1.3316,3,0.3971,LESS
12,43,50,7,93,43,50,3.7612,3.912023,0.1508229,7.673223,3.7612,3.912023,0,0,1,0.8746,4,0.2211,LESS
12,106,100,6,206,106,100,4.663439,4.60517,0.05826891,9.268609,4.663439,4.60517,0,1,0,1.5095,1,0.568,LESS
12,135,150,15,285,135,150,4.905275,5.010635,0.1053605,9.91591,4.905275,5.010635,0,0,1,1.039,1,0.3716,LESS
12,51,50,1,101,51,50,3.931826,3.912023,0.01980263,7.843849,3.931826,3.912023,0,1,0,0.9191,2,0.4973,LESS
12,50,53,3,103,53,50,3.912023,3.970292,0.05826891,7.882315,3.970292,3.912023,1,0,0,0.9448,2,0.8012,LESS
12,100,104,4,204,100,104,4.60517,4.644391,0.03922071,9.249561,4.60517,4.644391,0,0,1,1.115,1,0.627,LESS
12,116,100,16,216,100,116,4.75359,4.60517,0.14842,9.35876,4.60517,4.75359,1,1,1,0.9101,3,1.7977,LESS
12,50,46,4,96,46,50,3.912023,3.828641,0.08338161,7.740664,3.828641,3.912023,1,1,1,1.1447,2,1.1827,LESS
12,100,110,10,210,110,100,4.60517,4.70048,0.09531018,9.305651,4.70048,4.60517,1,0,0,1.8498,2,0.5018,LESS
12,59,50,9,109,59,50,4.077537,3.912023,0.1655144,7.98956,4.077537,3.912023,0,1,0,0.8669,4,0.2285,LESS
12,150,180,30,330,150,180,5.010635,5.192957,0.1823216,10.20359,5.010635,5.192957,0,0,1,1.2115,3,0.5846,LESS
12,100,86,14,186,100,86,4.60517,4.454347,0.1508229,9.059517,4.60517,4.454347,0,1,0,0.9671,2,0.8197,LESS
12,50,44,6,94,50,44,3.912023,3.78419,0.1278334,7.696213,3.912023,3.78419,0,1,0,0.8572,4,0.3796,LESS
12,150,138,12,288,150,138,5.010635,4.927254,0.08338161,9.937889,5.010635,4.927254,0,1,0,0.8425,2,0.4515,LESS
12,102,100,2,202,102,100,4.624973,4.60517,0.01980263,9.230143,4.624973,4.60517,0,1,0,0.8468,2,0.518,LESS
12,55,50,5,105,55,50,4.007333,3.912023,0.09531018,7.919356,4.007333,3.912023,0,1,0,0.6756,4,0.3183,LESS
12,54,50,4,104,54,50,3.988984,3.912023,0.07696104,7.901007,3.988984,3.912023,0,1,0,0.7494,4,0.3187,LESS
12,51,50,1,101,51,50,3.931826,3.912023,0.01980263,7.843849,3.931826,3.912023,0,1,0,0.8009,3,0.6634,LESS
12,42,50,8,92,42,50,3.73767,3.912023,0.1743534,7.649693,3.73767,3.912023,0,0,1,0.834,4,0.2683,LESS
12,82,100,18,182,82,100,4.406719,4.60517,0.1984509,9.011889,4.406719,4.60517,0,0,1,0.6537,4,0.3699,LESS
12,57,50,7,107,57,50,4.043051,3.912023,0.1310283,7.955074,4.043051,3.912023,0,1,0,0.8351,3,0.4349,LESS
12,150,123,27,273,123,150,5.010635,4.812184,0.1984509,9.82282,4.812184,5.010635,1,1,1,0.8762,2,0.6378,LESS
12,168,150,18,318,150,168,5.123964,5.010635,0.1133287,10.1346,5.010635,5.123964,1,1,1,1.0186,3,1.1524,LESS
12,118,100,18,218,118,100,4.770685,4.60517,0.1655144,9.375855,4.770685,4.60517,0,1,0,0.9147,2,0.5299,LESS
12,150,156,6,306,150,156,5.010635,5.049856,0.03922071,10.06049,5.010635,5.049856,0,0,1,1.1468,1,0.7409,LESS
12,50,48,2,98,50,48,3.912023,3.871201,0.04082199,7.783224,3.912023,3.871201,0,1,0,1.1422,2,0.9394,LESS
12,110,100,10,210,110,100,4.70048,4.60517,0.09531018,9.305651,4.70048,4.60517,0,1,0,0.957,2,0.335,LESS
12,58,50,8,108,58,50,4.060443,3.912023,0.14842,7.972466,4.060443,3.912023,0,1,0,0.7838,2,0.5622,LESS
12,50,48,2,98,50,48,3.912023,3.871201,0.04082199,7.783224,3.912023,3.871201,0,1,0,0.9115,2,0.5753,LESS
12,100,96,4,196,100,96,4.60517,4.564348,0.04082199,9.169518,4.60517,4.564348,0,1,0,0.7983,3,0.3631,LESS
12,44,50,6,94,44,50,3.78419,3.912023,0.1278334,7.696213,3.78419,3.912023,0,0,1,1.2121,4,0.2628,LESS
12,100,120,20,220,100,120,4.60517,4.787492,0.1823216,9.392662,4.60517,4.787492,0,0,1,0.8446,3,0.4208,LESS
12,41,50,9,91,41,50,3.713572,3.912023,0.1984509,7.625595,3.713572,3.912023,0,0,1,0.7718,4,0.2715,LESS
12,53,50,3,103,53,50,3.970292,3.912023,0.05826891,7.882315,3.970292,3.912023,0,1,0,0.6785,4,0.2536,LESS
12,100,84,16,184,84,100,4.60517,4.430817,0.1743534,9.035987,4.430817,4.60517,1,1,1,1.1495,2,0.7843,LESS
12,150,123,27,273,123,150,5.010635,4.812184,0.1984509,9.82282,4.812184,5.010635,1,1,1,1.0813,1,0.7849,LESS
12,46,50,4,96,46,50,3.828641,3.912023,0.08338161,7.740664,3.828641,3.912023,0,0,1,0.8796,4,0.2299,LESS
12,100,84,16,184,84,100,4.60517,4.430817,0.1743534,9.035987,4.430817,4.60517,1,1,1,0.8865,4,0.3151,LESS
12,180,150,30,330,150,180,5.192957,5.010635,0.1823216,10.20359,5.010635,5.192957,1,1,1,0.9908,2,0.6968,LESS
12,138,150,12,288,138,150,4.927254,5.010635,0.08338161,9.937889,4.927254,5.010635,0,0,1,1.0768,1,0.8253,LESS
12,150,180,30,330,150,180,5.010635,5.192957,0.1823216,10.20359,5.010635,5.192957,0,0,1,1.3342,2,0.4756,LESS
12,100,98,2,198,100,98,4.60517,4.584967,0.02020271,9.190138,4.60517,4.584967,0,1,0,1.2599,1,0.5346,LESS
12,123,150,27,273,123,150,4.812184,5.010635,0.1984509,9.82282,4.812184,5.010635,0,0,1,0.7269,3,0.5778,LESS
12,50,59,9,109,50,59,3.912023,4.077537,0.1655144,7.98956,3.912023,4.077537,0,0,1,0.797,4,0.2507,LESS
12,41,50,9,91,41,50,3.713572,3.912023,0.1984509,7.625595,3.713572,3.912023,0,0,1,0.7198,4,0.2312,LESS
12,104,100,4,204,100,104,4.644391,4.60517,0.03922071,9.249561,4.60517,4.644391,1,1,1,1.0547,2,0.7133,LESS
12,150,132,18,282,132,150,5.010635,4.882802,0.1278334,9.893437,4.882802,5.010635,1,1,1,2.0926,1,0.6185,LESS
12,50,49,1,99,50,49,3.912023,3.89182,0.02020271,7.803843,3.912023,3.89182,0,1,0,1.6948,3,1.2408,LESS
12,50,54,4,104,50,54,3.912023,3.988984,0.07696104,7.901007,3.912023,3.988984,0,0,1,1.486,4,0.6147,LESS
12,50,42,8,92,42,50,3.912023,3.73767,0.1743534,7.649693,3.73767,3.912023,1,1,1,1.3806,1,1.5141,LESS
12,150,162,12,312,150,162,5.010635,5.087596,0.07696104,10.09823,5.010635,5.087596,0,0,1,1.325,1,0.9911,LESS
12,150,177,27,327,150,177,5.010635,5.17615,0.1655144,10.18679,5.010635,5.17615,0,0,1,1.0184,2,0.6846,LESS
12,50,41,9,91,50,41,3.912023,3.713572,0.1984509,7.625595,3.912023,3.713572,0,1,0,0.8739,4,0.4064,LESS
12,100,114,14,214,100,114,4.60517,4.736198,0.1310283,9.341369,4.60517,4.736198,0,0,1,0.7492,2,0.8629,LESS
12,50,54,4,104,50,54,3.912023,3.988984,0.07696104,7.901007,3.912023,3.988984,0,0,1,0.7736,4,0.2842,LESS
12,40,50,10,90,40,50,3.688879,3.912023,0.2231436,7.600902,3.688879,3.912023,0,0,1,0.5461,4,0.1978,LESS
12,123,150,27,273,123,150,4.812184,5.010635,0.1984509,9.82282,4.812184,5.010635,0,0,1,1.1328,1,1.2237,LESS
12,50,58,8,108,50,58,3.912023,4.060443,0.14842,7.972466,3.912023,4.060443,0,0,1,1.2989,3,0.5203,LESS
12,153,150,3,303,150,153,5.030438,5.010635,0.01980263,10.04107,5.010635,5.030438,1,1,1,0.928,1,1.152,LESS
12,150,165,15,315,150,165,5.010635,5.105945,0.09531018,10.11658,5.010635,5.105945,0,0,1,0.8999,1,0.4459,LESS
12,45,50,5,95,45,50,3.806662,3.912023,0.1053605,7.718685,3.806662,3.912023,0,0,1,0.7251,4,0.1961,LESS
12,58,50,8,108,58,50,4.060443,3.912023,0.14842,7.972466,4.060443,3.912023,0,1,0,0.8791,3,1.4407,LESS
12,120,100,20,220,100,120,4.787492,4.60517,0.1823216,9.392662,4.60517,4.787492,1,1,1,0.9071,3,1.2761,LESS
12,150,159,9,309,150,159,5.010635,5.068904,0.05826891,10.07954,5.010635,5.068904,0,0,1,0.7441,2,0.6133,LESS
12,50,58,8,108,50,58,3.912023,4.060443,0.14842,7.972466,3.912023,4.060443,0,0,1,0.6968,4,0.2185,LESS
12,100,112,12,212,100,112,4.60517,4.718499,0.1133287,9.323669,4.60517,4.718499,0,0,1,1.2476,2,0.5412,LESS
12,59,50,9,109,59,50,4.077537,3.912023,0.1655144,7.98956,4.077537,3.912023,0,1,0,0.6886,4,0.2174,LESS
12,100,98,2,198,100,98,4.60517,4.584967,0.02020271,9.190138,4.60517,4.584967,0,1,0,1.1081,2,1.124,LESS
12,49,50,1,99,49,50,3.89182,3.912023,0.02020271,7.803843,3.89182,3.912023,0,0,1,0.7067,4,0.2298,LESS
12,42,50,8,92,42,50,3.73767,3.912023,0.1743534,7.649693,3.73767,3.912023,0,0,1,0.5806,4,0.2043,LESS
12,150,174,24,324,150,174,5.010635,5.159055,0.14842,10.16969,5.010635,5.159055,0,0,1,0.8962,2,1.3385,LESS
12,150,120,30,270,120,150,5.010635,4.787492,0.2231436,9.798127,4.787492,5.010635,1,1,1,0.8191,4,0.4721,LESS
12,114,100,14,214,100,114,4.736198,4.60517,0.1310283,9.341369,4.60517,4.736198,1,1,1,1.5955,2,0.5534,LESS
12,141,150,9,291,141,150,4.94876,5.010635,0.0618754,9.959395,4.94876,5.010635,0,0,1,0.9053,2,0.6734,LESS
12,50,44,6,94,50,44,3.912023,3.78419,0.1278334,7.696213,3.912023,3.78419,0,1,0,1.1704,2,1.6501,LESS
12,94,100,6,194,94,100,4.543295,4.60517,0.0618754,9.148465,4.543295,4.60517,0,0,1,1.5416,1,0.3586,LESS
12,150,147,3,297,147,150,5.010635,4.990433,0.02020271,10.00107,4.990433,5.010635,1,1,1,0.9587,1,0.591,LESS
12,150,138,12,288,138,150,5.010635,4.927254,0.08338161,9.937889,4.927254,5.010635,1,1,1,1.0515,1,0.3747,LESS
12,150,153,3,303,150,153,5.010635,5.030438,0.01980263,10.04107,5.010635,5.030438,0,0,1,1.0841,1,0.5252,LESS
12,150,126,24,276,126,150,5.010635,4.836282,0.1743534,9.846917,4.836282,5.010635,1,1,1,0.9152,2,0.5449,LESS
12,100,82,18,182,82,100,4.60517,4.406719,0.1984509,9.011889,4.406719,4.60517,1,1,1,1.1891,2,0.8017,LESS
12,132,150,18,282,132,150,4.882802,5.010635,0.1278334,9.893437,4.882802,5.010635,0,0,1,1.2241,2,0.4302,LESS
12,174,150,24,324,150,174,5.159055,5.010635,0.14842,10.16969,5.010635,5.159055,1,1,1,0.9126,3,0.6635,LESS
12,55,50,5,105,55,50,4.007333,3.912023,0.09531018,7.919356,4.007333,3.912023,0,1,0,0.8615,4,0.2019,LESS
12,50,53,3,103,50,53,3.912023,3.970292,0.05826891,7.882315,3.912023,3.970292,0,0,1,1.1289,4,0.163,LESS
12,150,144,6,294,144,150,5.010635,4.969813,0.04082199,9.980449,4.969813,5.010635,1,1,1,0.8348,3,0.5577,LESS
12,100,120,20,220,100,120,4.60517,4.787492,0.1823216,9.392662,4.60517,4.787492,0,0,1,0.9993,2,1.3083,LESS
12,100,88,12,188,88,100,4.60517,4.477337,0.1278334,9.082507,4.477337,4.60517,1,1,1,1.4742,1,0.4302,LESS
12,50,43,7,93,50,43,3.912023,3.7612,0.1508229,7.673223,3.912023,3.7612,0,1,0,1.7437,3,0.5859,LESS
12,100,116,16,216,100,116,4.60517,4.75359,0.14842,9.35876,4.60517,4.75359,0,0,1,0.9349,4,0.5549,LESS
12,112,100,12,212,100,112,4.718499,4.60517,0.1133287,9.323669,4.60517,4.718499,1,1,1,1.4705,2,0.9021,LESS
12,171,150,21,321,150,171,5.141664,5.010635,0.1310283,10.1523,5.010635,5.141664,1,1,1,1.3474,1,1.5543,LESS
12,150,135,15,285,135,150,5.010635,4.905275,0.1053605,9.91591,4.905275,5.010635,1,1,1,0.8628,2,1.0086,LESS
12,100,96,4,196,96,100,4.60517,4.564348,0.04082199,9.169518,4.564348,4.60517,1,1,1,1.2061,1,0.557,LESS
12,60,50,10,110,60,50,4.094345,3.912023,0.1823216,8.006368,4.094345,3.912023,0,1,0,1.0741,2,0.5312,LESS
12,50,60,10,110,50,60,3.912023,4.094345,0.1823216,8.006368,3.912023,4.094345,0,0,1,0.8335,4,0.6184,LESS
12,50,57,7,107,50,57,3.912023,4.043051,0.1310283,7.955074,3.912023,4.043051,0,0,1,0.8223,4,0.3558,LESS
12,147,150,3,297,150,147,4.990433,5.010635,0.02020271,10.00107,5.010635,4.990433,1,0,0,1.9991,1,0.6419,LESS
12,150,141,9,291,141,150,5.010635,4.94876,0.0618754,9.959395,4.94876,5.010635,1,1,1,1.7666,1,0.4011,LESS
12,150,141,9,291,141,150,5.010635,4.94876,0.0618754,9.959395,4.94876,5.010635,1,1,1,0.8659,2,1.3021,LESS
12,50,55,5,105,55,50,3.912023,4.007333,0.09531018,7.919356,4.007333,3.912023,1,0,0,0.8685,4,0.3866,LESS
12,86,100,14,186,86,100,4.454347,4.60517,0.1508229,9.059517,4.454347,4.60517,0,0,1,1.0657,3,0.6351,LESS
12,54,50,4,104,54,50,3.988984,3.912023,0.07696104,7.901007,3.988984,3.912023,0,1,0,0.7197,4,0.2231,LESS
12,150,129,21,279,129,150,5.010635,4.859812,0.1508229,9.870448,4.859812,5.010635,1,1,1,0.8616,3,0.8541,LESS
12,80,100,20,180,80,100,4.382027,4.60517,0.2231436,8.987197,4.382027,4.60517,0,0,1,0.7336,4,0.2049,LESS
12,100,112,12,212,100,112,4.60517,4.718499,0.1133287,9.323669,4.60517,4.718499,0,0,1,0.9438,3,0.5657,LESS
12,50,41,9,91,41,50,3.912023,3.713572,0.1984509,7.625595,3.713572,3.912023,1,1,1,1.7109,2,0.4362,LESS
12,50,52,2,102,50,52,3.912023,3.951244,0.03922071,7.863267,3.912023,3.951244,0,0,1,0.6958,4,0.2983,LESS
12,50,60,10,110,50,60,3.912023,4.094345,0.1823216,8.006368,3.912023,4.094345,0,0,1,1.2919,4,0.3281,LESS
12,180,150,30,330,150,180,5.192957,5.010635,0.1823216,10.20359,5.010635,5.192957,1,1,1,1.067,3,0.8868,LESS
12,47,50,3,97,47,50,3.850148,3.912023,0.0618754,7.762171,3.850148,3.912023,0,0,1,1.128,4,0.2907,LESS
12,129,150,21,279,129,150,4.859812,5.010635,0.1508229,9.870448,4.859812,5.010635,0,0,1,0.8877,4,0.326,LESS
12,57,50,7,107,57,50,4.043051,3.912023,0.1310283,7.955074,4.043051,3.912023,0,1,0,1.8328,2,2.0484,LESS
12,86,100,14,186,86,100,4.454347,4.60517,0.1508229,9.059517,4.454347,4.60517,0,0,1,0.8614,4,0.2287,LESS
12,177,150,27,327,150,177,5.17615,5.010635,0.1655144,10.18679,5.010635,5.17615,1,1,1,1.0259,3,0.4009,LESS
12,50,51,1,101,50,51,3.912023,3.931826,0.01980263,7.843849,3.912023,3.931826,0,0,1,0.8476,4,0.4181,LESS
12,138,150,12,288,138,150,4.927254,5.010635,0.08338161,9.937889,4.927254,5.010635,0,0,1,1.2541,1,1.0685,LESS
12,150,174,24,324,150,174,5.010635,5.159055,0.14842,10.16969,5.010635,5.159055,0,0,1,1.6894,1,0.4406,LESS
12,126,150,24,276,126,150,4.836282,5.010635,0.1743534,9.846917,4.836282,5.010635,0,0,1,1.5362,3,0.9687,LESS
12,100,102,2,202,100,102,4.60517,4.624973,0.01980263,9.230143,4.60517,4.624973,0,0,1,1.5493,2,1.6886,LESS
12,94,100,6,194,94,100,4.543295,4.60517,0.0618754,9.148465,4.543295,4.60517,0,0,1,0.8729,2,0.426,LESS
12,50,47,3,97,50,47,3.912023,3.850148,0.0618754,7.762171,3.912023,3.850148,0,1,0,1.0741,2,0.9245,LESS
12,108,100,8,208,100,108,4.682131,4.60517,0.07696104,9.287301,4.60517,4.682131,1,1,1,1.7231,2,0.336,LESS
12,44,50,6,94,44,50,3.78419,3.912023,0.1278334,7.696213,3.78419,3.912023,0,0,1,0.8554,4,0.272,LESS
12,159,150,9,309,150,159,5.068904,5.010635,0.05826891,10.07954,5.010635,5.068904,1,1,1,0.9338,2,0.7208,LESS
12,100,108,8,208,100,108,4.60517,4.682131,0.07696104,9.287301,4.60517,4.682131,0,0,1,0.8764,3,1.7646,LESS
12,144,150,6,294,150,144,4.969813,5.010635,0.04082199,9.980449,5.010635,4.969813,1,0,0,1.1712,2,0.4073,LESS
12,50,55,5,105,50,55,3.912023,4.007333,0.09531018,7.919356,3.912023,4.007333,0,0,1,0.8338,4,0.2304,LESS
12,100,116,16,216,100,116,4.60517,4.75359,0.14842,9.35876,4.60517,4.75359,0,0,1,0.8934,1,0.5225,LESS
12,162,150,12,312,150,162,5.087596,5.010635,0.07696104,10.09823,5.010635,5.087596,1,1,1,0.9892,2,0.8553,LESS
12,98,100,2,198,98,100,4.584967,4.60517,0.02020271,9.190138,4.584967,4.60517,0,0,1,1.7283,3,0.4682,LESS
13,150,168,18,318,150,168,5.010635,5.123964,0.1133287,10.1346,5.010635,5.123964,0,0,1,1.6772,1,1.4671,LESS
13,150,126,24,276,126,150,5.010635,4.836282,0.1743534,9.846917,4.836282,5.010635,1,1,1,1.1678,4,2.8968,LESS
13,118,100,18,218,100,118,4.770685,4.60517,0.1655144,9.375855,4.60517,4.770685,1,1,1,1.2405,3,1.1799,LESS
13,106,100,6,206,100,106,4.663439,4.60517,0.05826891,9.268609,4.60517,4.663439,1,1,1,1.1305,4,0.9234,LESS
13,49,50,1,99,49,50,3.89182,3.912023,0.02020271,7.803843,3.89182,3.912023,0,0,1,1.4176,3,2.1628,LESS
13,150,171,21,321,150,171,5.010635,5.141664,0.1310283,10.1523,5.010635,5.141664,0,0,1,1.6103,2,0.8635,LESS
13,150,174,24,324,174,150,5.010635,5.159055,0.14842,10.16969,5.159055,5.010635,1,0,0,1.7746,1,0.5287,LESS
13,150,162,12,312,162,150,5.010635,5.087596,0.07696104,10.09823,5.087596,5.010635,1,0,0,1.2088,2,0.9321,LESS
13,100,94,6,194,100,94,4.60517,4.543295,0.0618754,9.148465,4.60517,4.543295,0,1,0,1.3038,2,1.429,LESS
13,50,51,1,101,50,51,3.912023,3.931826,0.01980263,7.843849,3.912023,3.931826,0,0,1,1.7936,3,1.0821,LESS
13,153,150,3,303,150,153,5.030438,5.010635,0.01980263,10.04107,5.010635,5.030438,1,1,1,1.1518,2,1.5533,LESS
13,100,96,4,196,96,100,4.60517,4.564348,0.04082199,9.169518,4.564348,4.60517,1,1,1,1.249,4,0.7825,LESS
13,54,50,4,104,50,54,3.988984,3.912023,0.07696104,7.901007,3.912023,3.988984,1,1,1,1.1543,4,0.8788,LESS
13,106,100,6,206,106,100,4.663439,4.60517,0.05826891,9.268609,4.663439,4.60517,0,1,0,1.7015,1,0.6295,LESS
13,100,106,6,206,100,106,4.60517,4.663439,0.05826891,9.268609,4.60517,4.663439,0,0,1,1.8853,1,0.6341,LESS
13,150,132,18,282,132,150,5.010635,4.882802,0.1278334,9.893437,4.882802,5.010635,1,1,1,1.7609,1,1.1326,LESS
13,147,150,3,297,150,147,4.990433,5.010635,0.02020271,10.00107,5.010635,4.990433,1,0,0,1.6344,2,1.4164,LESS
13,165,150,15,315,150,165,5.105945,5.010635,0.09531018,10.11658,5.010635,5.105945,1,1,1,1.4484,3,0.6085,LESS
13,50,59,9,109,50,59,3.912023,4.077537,0.1655144,7.98956,3.912023,4.077537,0,0,1,1.4386,4,0.6123,LESS
13,100,80,20,180,80,100,4.60517,4.382027,0.2231436,8.987197,4.382027,4.60517,1,1,1,1.404,2,0.6663,LESS
13,100,108,8,208,108,100,4.60517,4.682131,0.07696104,9.287301,4.682131,4.60517,1,0,0,1.2253,4,0.718,LESS
13,100,96,4,196,100,96,4.60517,4.564348,0.04082199,9.169518,4.60517,4.564348,0,1,0,1.7557,2,0.8646,LESS
13,123,150,27,273,123,150,4.812184,5.010635,0.1984509,9.82282,4.812184,5.010635,0,0,1,1.2393,4,1.0478,LESS
13,57,50,7,107,50,57,4.043051,3.912023,0.1310283,7.955074,3.912023,4.043051,1,1,1,1.1361,4,0.5945,LESS
13,56,50,6,106,50,56,4.025352,3.912023,0.1133287,7.937375,3.912023,4.025352,1,1,1,1.3478,3,1.099,LESS
13,150,162,12,312,162,150,5.010635,5.087596,0.07696104,10.09823,5.087596,5.010635,1,0,0,1.4953,3,0.7499,LESS
13,50,58,8,108,50,58,3.912023,4.060443,0.14842,7.972466,3.912023,4.060443,0,0,1,1.298,4,0.8287,LESS
13,100,114,14,214,100,114,4.60517,4.736198,0.1310283,9.341369,4.60517,4.736198,0,0,1,1.3367,2,0.8115,LESS
13,150,135,15,285,135,150,5.010635,4.905275,0.1053605,9.91591,4.905275,5.010635,1,1,1,1.4935,4,0.7773,LESS
13,174,150,24,324,150,174,5.159055,5.010635,0.14842,10.16969,5.010635,5.159055,1,1,1,1.1007,4,0.7606,LESS
13,50,48,2,98,50,48,3.912023,3.871201,0.04082199,7.783224,3.912023,3.871201,0,1,0,1.211,4,0.7327,LESS
13,46,50,4,96,46,50,3.828641,3.912023,0.08338161,7.740664,3.828641,3.912023,0,0,1,1.3567,4,0.6812,LESS
13,129,150,21,279,150,129,4.859812,5.010635,0.1508229,9.870448,5.010635,4.859812,1,0,0,1.4899,1,0.9535,LESS
13,55,50,5,105,55,50,4.007333,3.912023,0.09531018,7.919356,4.007333,3.912023,0,1,0,1.4667,3,1.0171,LESS
13,94,100,6,194,94,100,4.543295,4.60517,0.0618754,9.148465,4.543295,4.60517,0,0,1,1.5089,2,0.6679,LESS
13,50,55,5,105,50,55,3.912023,4.007333,0.09531018,7.919356,3.912023,4.007333,0,0,1,1.7146,2,1.4829,LESS
13,84,100,16,184,84,100,4.430817,4.60517,0.1743534,9.035987,4.430817,4.60517,0,0,1,1.6733,3,0.7272,LESS
13,177,150,27,327,150,177,5.17615,5.010635,0.1655144,10.18679,5.010635,5.17615,1,1,1,1.2221,3,0.7111,LESS
13,150,123,27,273,123,150,5.010635,4.812184,0.1984509,9.82282,4.812184,5.010635,1,1,1,1.637,4,1.0149,LESS
13,50,49,1,99,49,50,3.912023,3.89182,0.02020271,7.803843,3.89182,3.912023,1,1,1,1.0974,4,0.5951,LESS
13,56,50,6,106,56,50,4.025352,3.912023,0.1133287,7.937375,4.025352,3.912023,0,1,0,1.4941,4,1.1838,LESS
13,50,51,1,101,50,51,3.912023,3.931826,0.01980263,7.843849,3.912023,3.931826,0,0,1,1.2812,4,0.6901,LESS
13,100,84,16,184,84,100,4.60517,4.430817,0.1743534,9.035987,4.430817,4.60517,1,1,1,1.4256,4,0.9644,LESS
13,50,42,8,92,50,42,3.912023,3.73767,0.1743534,7.649693,3.912023,3.73767,0,1,0,1.5148,1,1.0327,LESS
13,174,150,24,324,174,150,5.159055,5.010635,0.14842,10.16969,5.159055,5.010635,0,1,0,1.5745,2,0.6211,LESS
13,50,48,2,98,48,50,3.912023,3.871201,0.04082199,7.783224,3.871201,3.912023,1,1,1,1.6558,2,0.8619,LESS
13,120,100,20,220,100,120,4.787492,4.60517,0.1823216,9.392662,4.60517,4.787492,1,1,1,1.1107,3,0.5657,LESS
13,162,150,12,312,150,162,5.087596,5.010635,0.07696104,10.09823,5.010635,5.087596,1,1,1,1.4075,1,0.9305,LESS
13,50,59,9,109,50,59,3.912023,4.077537,0.1655144,7.98956,3.912023,4.077537,0,0,1,1.2813,4,0.7198,LESS
13,150,177,27,327,150,177,5.010635,5.17615,0.1655144,10.18679,5.010635,5.17615,0,0,1,1.3977,2,0.7314,LESS
13,150,159,9,309,159,150,5.010635,5.068904,0.05826891,10.07954,5.068904,5.010635,1,0,0,1.3123,2,1.5605,LESS
13,168,150,18,318,150,168,5.123964,5.010635,0.1133287,10.1346,5.010635,5.123964,1,1,1,1.599,1,1.8635,LESS
13,43,50,7,93,43,50,3.7612,3.912023,0.1508229,7.673223,3.7612,3.912023,0,0,1,1.7015,2,1.3452,LESS
13,141,150,9,291,150,141,4.94876,5.010635,0.0618754,9.959395,5.010635,4.94876,1,0,0,1.9651,2,0.7654,LESS
13,80,100,20,180,80,100,4.382027,4.60517,0.2231436,8.987197,4.382027,4.60517,0,0,1,1.6928,2,0.8505,LESS
13,150,177,27,327,150,177,5.010635,5.17615,0.1655144,10.18679,5.010635,5.17615,0,0,1,1.4927,3,1.0318,LESS
13,171,150,21,321,150,171,5.141664,5.010635,0.1310283,10.1523,5.010635,5.141664,1,1,1,1.8889,1,1.2805,LESS
13,104,100,4,204,100,104,4.644391,4.60517,0.03922071,9.249561,4.60517,4.644391,1,1,1,2.0621,2,0.7636,LESS
13,150,165,15,315,165,150,5.010635,5.105945,0.09531018,10.11658,5.105945,5.010635,1,0,0,1.5554,1,0.7012,LESS
13,84,100,16,184,84,100,4.430817,4.60517,0.1743534,9.035987,4.430817,4.60517,0,0,1,1.7835,3,0.665,LESS
13,108,100,8,208,100,108,4.682131,4.60517,0.07696104,9.287301,4.60517,4.682131,1,1,1,1.8596,2,0.6658,LESS
13,50,58,8,108,50,58,3.912023,4.060443,0.14842,7.972466,3.912023,4.060443,0,0,1,1.398,4,0.5823,LESS
13,50,46,4,96,46,50,3.912023,3.828641,0.08338161,7.740664,3.828641,3.912023,1,1,1,1.886,2,0.5996,LESS
13,40,50,10,90,40,50,3.688879,3.912023,0.2231436,7.600902,3.688879,3.912023,0,0,1,1.3831,4,0.5493,LESS
13,150,174,24,324,174,150,5.010635,5.159055,0.14842,10.16969,5.159055,5.010635,1,0,0,1.7244,2,0.6165,LESS
13,100,110,10,210,100,110,4.60517,4.70048,0.09531018,9.305651,4.60517,4.70048,0,0,1,1.5908,1,0.9164,LESS
13,153,150,3,303,150,153,5.030438,5.010635,0.01980263,10.04107,5.010635,5.030438,1,1,1,1.2808,2,0.6324,LESS
13,50,45,5,95,50,45,3.912023,3.806662,0.1053605,7.718685,3.912023,3.806662,0,1,0,1.5644,4,0.8493,LESS
13,50,52,2,102,52,50,3.912023,3.951244,0.03922071,7.863267,3.951244,3.912023,1,0,0,1.4565,4,0.6283,LESS
13,50,42,8,92,42,50,3.912023,3.73767,0.1743534,7.649693,3.73767,3.912023,1,1,1,1.8209,3,0.5827,LESS
13,144,150,6,294,150,144,4.969813,5.010635,0.04082199,9.980449,5.010635,4.969813,1,0,0,1.3968,2,0.8819,LESS
13,50,55,5,105,55,50,3.912023,4.007333,0.09531018,7.919356,4.007333,3.912023,1,0,0,2.2317,2,2.0815,LESS
13,50,47,3,97,50,47,3.912023,3.850148,0.0618754,7.762171,3.912023,3.850148,0,1,0,2.8224,3,1.1492,LESS
13,114,100,14,214,100,114,4.736198,4.60517,0.1310283,9.341369,4.60517,4.736198,1,1,1,1.3221,3,1.5486,LESS
13,150,129,21,279,129,150,5.010635,4.859812,0.1508229,9.870448,4.859812,5.010635,1,1,1,1.2269,2,0.666,LESS
13,50,57,7,107,50,57,3.912023,4.043051,0.1310283,7.955074,3.912023,4.043051,0,0,1,1.2958,4,0.5849,LESS
13,92,100,8,192,92,100,4.521789,4.60517,0.08338161,9.126959,4.521789,4.60517,0,0,1,1.6086,1,0.7327,LESS
13,58,50,8,108,50,58,4.060443,3.912023,0.14842,7.972466,3.912023,4.060443,1,1,1,1.3016,2,0.6309,LESS
13,100,118,18,218,100,118,4.60517,4.770685,0.1655144,9.375855,4.60517,4.770685,0,0,1,1.509,2,0.565,LESS
13,100,116,16,216,100,116,4.60517,4.75359,0.14842,9.35876,4.60517,4.75359,0,0,1,1.4768,2,1.6304,LESS
13,150,132,18,282,150,132,5.010635,4.882802,0.1278334,9.893437,5.010635,4.882802,0,1,0,1.7762,2,1.9653,LESS
13,129,150,21,279,129,150,4.859812,5.010635,0.1508229,9.870448,4.859812,5.010635,0,0,1,1.3374,2,1.0159,LESS
13,177,150,27,327,150,177,5.17615,5.010635,0.1655144,10.18679,5.010635,5.17615,1,1,1,1.2006,4,0.5315,LESS
13,53,50,3,103,50,53,3.970292,3.912023,0.05826891,7.882315,3.912023,3.970292,1,1,1,1.6674,4,0.5662,LESS
13,50,49,1,99,50,49,3.912023,3.89182,0.02020271,7.803843,3.912023,3.89182,0,1,0,1.4421,3,0.4837,LESS
13,96,100,4,196,96,100,4.564348,4.60517,0.04082199,9.169518,4.564348,4.60517,0,0,1,1.5619,2,0.5664,LESS
13,100,104,4,204,100,104,4.60517,4.644391,0.03922071,9.249561,4.60517,4.644391,0,0,1,2.1049,1,0.6787,LESS
13,100,112,12,212,112,100,4.60517,4.718499,0.1133287,9.323669,4.718499,4.60517,1,0,0,1.4333,3,0.6661,LESS
13,168,150,18,318,150,168,5.123964,5.010635,0.1133287,10.1346,5.010635,5.123964,1,1,1,1.2512,3,0.6651,LESS
13,50,41,9,91,41,50,3.912023,3.713572,0.1984509,7.625595,3.713572,3.912023,1,1,1,1.3923,3,0.5324,LESS
13,92,100,8,192,100,92,4.521789,4.60517,0.08338161,9.126959,4.60517,4.521789,1,0,0,1.5228,2,0.4992,LESS
13,50,56,6,106,56,50,3.912023,4.025352,0.1133287,7.937375,4.025352,3.912023,1,0,0,1.8166,1,0.9324,LESS
13,104,100,4,204,100,104,4.644391,4.60517,0.03922071,9.249561,4.60517,4.644391,1,1,1,1.3238,4,0.5665,LESS
13,150,153,3,303,153,150,5.010635,5.030438,0.01980263,10.04107,5.030438,5.010635,1,0,0,1.3074,2,0.6328,LESS
13,48,50,2,98,50,48,3.871201,3.912023,0.04082199,7.783224,3.912023,3.871201,1,0,0,3.2448,3,0.5962,LESS
13,100,84,16,184,84,100,4.60517,4.430817,0.1743534,9.035987,4.430817,4.60517,1,1,1,1.7015,2,0.6138,LESS
13,150,171,21,321,150,171,5.010635,5.141664,0.1310283,10.1523,5.010635,5.141664,0,0,1,1.3566,4,0.7329,LESS
13,51,50,1,101,51,50,3.931826,3.912023,0.01980263,7.843849,3.931826,3.912023,0,1,0,4.2024,1,0.7175,LESS
13,100,114,14,214,100,114,4.60517,4.736198,0.1310283,9.341369,4.60517,4.736198,0,0,1,2.9286,1,0.6163,LESS
13,150,147,3,297,147,150,5.010635,4.990433,0.02020271,10.00107,4.990433,5.010635,1,1,1,1.0744,2,1.0993,LESS
13,150,138,12,288,138,150,5.010635,4.927254,0.08338161,9.937889,4.927254,5.010635,1,1,1,1.3307,4,0.5201,LESS
13,49,50,1,99,50,49,3.89182,3.912023,0.02020271,7.803843,3.912023,3.89182,1,0,0,2.195,2,1.0993,LESS
13,45,50,5,95,45,50,3.806662,3.912023,0.1053605,7.718685,3.806662,3.912023,0,0,1,1.3734,4,0.6321,LESS
13,112,100,12,212,100,112,4.718499,4.60517,0.1133287,9.323669,4.60517,4.718499,1,1,1,1.7689,2,0.4998,LESS
13,180,150,30,330,150,180,5.192957,5.010635,0.1823216,10.20359,5.010635,5.192957,1,1,1,1.5062,2,0.592,LESS
13,147,150,3,297,150,147,4.990433,5.010635,0.02020271,10.00107,5.010635,4.990433,1,0,0,1.431,3,0.716,LESS
13,120,150,30,270,150,120,4.787492,5.010635,0.2231436,9.798127,5.010635,4.787492,1,0,0,3.2054,1,0.5165,LESS
13,150,144,6,294,150,144,5.010635,4.969813,0.04082199,9.980449,5.010635,4.969813,0,1,0,3.8857,2,0.3667,LESS
13,47,50,3,97,47,50,3.850148,3.912023,0.0618754,7.762171,3.850148,3.912023,0,0,1,1.5871,3,0.8636,LESS
13,96,100,4,196,100,96,4.564348,4.60517,0.04082199,9.169518,4.60517,4.564348,1,0,0,1.3174,3,1.2645,LESS
13,50,46,4,96,50,46,3.912023,3.828641,0.08338161,7.740664,3.912023,3.828641,0,1,0,1.2506,3,1.0482,LESS
13,100,110,10,210,110,100,4.60517,4.70048,0.09531018,9.305651,4.70048,4.60517,1,0,0,1.5552,2,0.6159,LESS
13,100,106,6,206,106,100,4.60517,4.663439,0.05826891,9.268609,4.663439,4.60517,1,0,0,1.6135,2,1.2642,LESS
13,50,44,6,94,50,44,3.912023,3.78419,0.1278334,7.696213,3.912023,3.78419,0,1,0,1.7634,2,1.0975,LESS
13,41,50,9,91,41,50,3.713572,3.912023,0.1984509,7.625595,3.713572,3.912023,0,0,1,1.3389,4,0.5983,LESS
13,54,50,4,104,54,50,3.988984,3.912023,0.07696104,7.901007,3.988984,3.912023,0,1,0,1.4675,3,1.2139,LESS
13,108,100,8,208,100,108,4.682131,4.60517,0.07696104,9.287301,4.60517,4.682131,1,1,1,1.2899,2,1.6332,LESS
13,100,92,8,192,92,100,4.60517,4.521789,0.08338161,9.126959,4.521789,4.60517,1,1,1,1.3007,2,0.5814,LESS
13,60,50,10,110,60,50,4.094345,3.912023,0.1823216,8.006368,4.094345,3.912023,0,1,0,2.7775,2,0.584,LESS
13,50,45,5,95,45,50,3.912023,3.806662,0.1053605,7.718685,3.806662,3.912023,1,1,1,1.0257,3,1.3359,LESS
13,120,100,20,220,100,120,4.787492,4.60517,0.1823216,9.392662,4.60517,4.787492,1,1,1,1.5828,3,0.5834,LESS
13,100,112,12,212,112,100,4.60517,4.718499,0.1133287,9.323669,4.718499,4.60517,1,0,0,2.066,3,0.6671,LESS
13,100,102,2,202,102,100,4.60517,4.624973,0.01980263,9.230143,4.624973,4.60517,1,0,0,1.1713,4,0.6323,LESS
13,100,98,2,198,100,98,4.60517,4.584967,0.02020271,9.190138,4.60517,4.584967,0,1,0,2.8356,2,0.8321,LESS
13,42,50,8,92,42,50,3.73767,3.912023,0.1743534,7.649693,3.73767,3.912023,0,0,1,1.245,4,0.4911,LESS
13,57,50,7,107,50,57,4.043051,3.912023,0.1310283,7.955074,3.912023,4.043051,1,1,1,1.6023,3,1.0006,LESS
13,59,50,9,109,50,59,4.077537,3.912023,0.1655144,7.98956,3.912023,4.077537,1,1,1,1.0971,4,0.5889,LESS
13,135,150,15,285,150,135,4.905275,5.010635,0.1053605,9.91591,5.010635,4.905275,1,0,0,1.2585,3,0.6639,LESS
13,100,90,10,190,100,90,4.60517,4.49981,0.1053605,9.10498,4.60517,4.49981,0,1,0,1.4841,1,0.7008,LESS
13,100,108,8,208,108,100,4.60517,4.682131,0.07696104,9.287301,4.682131,4.60517,1,0,0,1.0467,3,0.5456,LESS
13,52,50,2,102,52,50,3.951244,3.912023,0.03922071,7.863267,3.951244,3.912023,0,1,0,1.7129,3,1.0301,LESS
13,180,150,30,330,150,180,5.192957,5.010635,0.1823216,10.20359,5.010635,5.192957,1,1,1,1.2396,2,0.847,LESS
13,159,150,9,309,150,159,5.068904,5.010635,0.05826891,10.07954,5.010635,5.068904,1,1,1,1.2814,1,0.7997,LESS
13,42,50,8,92,42,50,3.73767,3.912023,0.1743534,7.649693,3.73767,3.912023,0,0,1,1.3048,4,1.3655,LESS
13,90,100,10,190,90,100,4.49981,4.60517,0.1053605,9.10498,4.49981,4.60517,0,0,1,1.3553,3,0.65,LESS
13,50,53,3,103,50,53,3.912023,3.970292,0.05826891,7.882315,3.912023,3.970292,0,0,1,1.0173,4,1.03,LESS
13,112,100,12,212,100,112,4.718499,4.60517,0.1133287,9.323669,4.60517,4.718499,1,1,1,1.196,2,1.7154,LESS
13,150,141,9,291,141,150,5.010635,4.94876,0.0618754,9.959395,4.94876,5.010635,1,1,1,1.0131,2,1.3974,LESS
13,100,90,10,190,90,100,4.60517,4.49981,0.1053605,9.10498,4.49981,4.60517,1,1,1,1.1124,3,1.2328,LESS
13,114,100,14,214,100,114,4.736198,4.60517,0.1310283,9.341369,4.60517,4.736198,1,1,1,2.4998,2,1.2328,LESS
13,88,100,12,188,88,100,4.477337,4.60517,0.1278334,9.082507,4.477337,4.60517,0,0,1,1.1046,2,1.0491,LESS
13,150,138,12,288,138,150,5.010635,4.927254,0.08338161,9.937889,4.927254,5.010635,1,1,1,1.1276,3,0.6713,LESS
13,86,100,14,186,86,100,4.454347,4.60517,0.1508229,9.059517,4.454347,4.60517,0,0,1,1.5098,2,1.3304,LESS
13,150,147,3,297,150,147,5.010635,4.990433,0.02020271,10.00107,5.010635,4.990433,0,1,0,1.7894,2,1.2672,LESS
13,100,118,18,218,100,118,4.60517,4.770685,0.1655144,9.375855,4.60517,4.770685,0,0,1,1.7451,2,0.646,LESS
13,100,86,14,186,86,100,4.60517,4.454347,0.1508229,9.059517,4.454347,4.60517,1,1,1,1.2827,3,0.5962,LESS
13,171,150,21,321,150,171,5.141664,5.010635,0.1310283,10.1523,5.010635,5.141664,1,1,1,1.2719,3,1.1827,LESS
13,132,150,18,282,150,132,4.882802,5.010635,0.1278334,9.893437,5.010635,4.882802,1,0,0,1.4337,1,0.7285,LESS
13,150,156,6,306,156,150,5.010635,5.049856,0.03922071,10.06049,5.049856,5.010635,1,0,0,1.9113,2,0.6838,LESS
13,50,56,6,106,50,56,3.912023,4.025352,0.1133287,7.937375,3.912023,4.025352,0,0,1,1.1658,4,0.5158,LESS
13,110,100,10,210,100,110,4.70048,4.60517,0.09531018,9.305651,4.60517,4.70048,1,1,1,2.1884,2,1.4649,LESS
13,150,144,6,294,144,150,5.010635,4.969813,0.04082199,9.980449,4.969813,5.010635,1,1,1,2.3027,1,0.5162,LESS
13,100,102,2,202,102,100,4.60517,4.624973,0.01980263,9.230143,4.624973,4.60517,1,0,0,1.2789,2,0.9495,LESS
13,41,50,9,91,41,50,3.713572,3.912023,0.1984509,7.625595,3.713572,3.912023,0,0,1,1.6114,3,0.7826,LESS
13,82,100,18,182,82,100,4.406719,4.60517,0.1984509,9.011889,4.406719,4.60517,0,0,1,2.1779,2,1.0329,LESS
13,150,180,30,330,180,150,5.010635,5.192957,0.1823216,10.20359,5.192957,5.010635,1,0,0,1.4634,2,3.581,LESS
13,50,53,3,103,53,50,3.912023,3.970292,0.05826891,7.882315,3.970292,3.912023,1,0,0,2.0703,1,1.7801,LESS
13,138,150,12,288,150,138,4.927254,5.010635,0.08338161,9.937889,5.010635,4.927254,1,0,0,1.6451,2,1.2342,LESS
13,110,100,10,210,100,110,4.70048,4.60517,0.09531018,9.305651,4.60517,4.70048,1,1,1,1.3817,3,0.6493,LESS
13,50,41,9,91,41,50,3.912023,3.713572,0.1984509,7.625595,3.713572,3.912023,1,1,1,1.3162,4,0.5633,LESS
13,150,123,27,273,123,150,5.010635,4.812184,0.1984509,9.82282,4.812184,5.010635,1,1,1,0.6282,4,1.0796,LESS
13,50,60,10,110,50,60,3.912023,4.094345,0.1823216,8.006368,3.912023,4.094345,0,0,1,0.5785,3,1.2618,LESS
13,102,100,2,202,100,102,4.624973,4.60517,0.01980263,9.230143,4.60517,4.624973,1,1,1,1.0429,3,0.9089,LESS
13,50,60,10,110,50,60,3.912023,4.094345,0.1823216,8.006368,3.912023,4.094345,0,0,1,0.5875,3,2.9977,LESS
13,60,50,10,110,60,50,4.094345,3.912023,0.1823216,8.006368,4.094345,3.912023,0,1,0,1.2128,4,1.3155,LESS
13,150,135,15,285,135,150,5.010635,4.905275,0.1053605,9.91591,4.905275,5.010635,1,1,1,0.9809,3,1.0428,LESS
13,100,120,20,220,120,100,4.60517,4.787492,0.1823216,9.392662,4.787492,4.60517,1,0,0,2.4518,2,0.3663,LESS
13,135,150,15,285,135,150,4.905275,5.010635,0.1053605,9.91591,4.905275,5.010635,0,0,1,1.485,3,0.6142,LESS
13,40,50,10,90,40,50,3.688879,3.912023,0.2231436,7.600902,3.688879,3.912023,0,0,1,1.4955,1,0.966,LESS
13,100,120,20,220,100,120,4.60517,4.787492,0.1823216,9.392662,4.60517,4.787492,0,0,1,2.7694,1,0.4339,LESS
13,150,120,30,270,120,150,5.010635,4.787492,0.2231436,9.798127,4.787492,5.010635,1,1,1,2.1322,3,0.3643,LESS
13,102,100,2,202,102,100,4.624973,4.60517,0.01980263,9.230143,4.624973,4.60517,0,1,0,1.8283,3,0.3829,LESS
13,43,50,7,93,43,50,3.7612,3.912023,0.1508229,7.673223,3.7612,3.912023,0,0,1,1.5297,4,0.3826,LESS
13,53,50,3,103,50,53,3.970292,3.912023,0.05826891,7.882315,3.912023,3.970292,1,1,1,1.7401,4,0.3472,LESS
13,98,100,2,198,98,100,4.584967,4.60517,0.02020271,9.190138,4.584967,4.60517,0,0,1,2.2958,1,0.3443,LESS
13,50,44,6,94,44,50,3.912023,3.78419,0.1278334,7.696213,3.78419,3.912023,1,1,1,1.6194,2,0.7664,LESS
13,144,150,6,294,150,144,4.969813,5.010635,0.04082199,9.980449,5.010635,4.969813,1,0,0,1.534,2,0.4322,LESS
13,150,159,9,309,159,150,5.010635,5.068904,0.05826891,10.07954,5.068904,5.010635,1,0,0,2.2403,2,0.3994,LESS
13,138,150,12,288,138,150,4.927254,5.010635,0.08338161,9.937889,4.927254,5.010635,0,0,1,1.5093,2,0.5502,LESS
13,59,50,9,109,50,59,4.077537,3.912023,0.1655144,7.98956,3.912023,4.077537,1,1,1,1.3932,3,0.4491,LESS
13,98,100,2,198,98,100,4.584967,4.60517,0.02020271,9.190138,4.584967,4.60517,0,0,1,1.7703,2,0.6654,LESS
13,150,180,30,330,150,180,5.010635,5.192957,0.1823216,10.20359,5.010635,5.192957,0,0,1,3.0668,1,0.3658,LESS
13,100,88,12,188,100,88,4.60517,4.477337,0.1278334,9.082507,4.60517,4.477337,0,1,0,1.6829,2,0.3489,LESS
13,156,150,6,306,150,156,5.049856,5.010635,0.03922071,10.06049,5.010635,5.049856,1,1,1,1.6251,3,0.3164,LESS
13,116,100,16,216,100,116,4.75359,4.60517,0.14842,9.35876,4.60517,4.75359,1,1,1,1.7693,3,0.5826,LESS
13,159,150,9,309,159,150,5.068904,5.010635,0.05826891,10.07954,5.068904,5.010635,0,1,0,3.1245,2,0.4999,LESS
13,120,150,30,270,120,150,4.787492,5.010635,0.2231436,9.798127,4.787492,5.010635,0,0,1,1.4905,3,0.3332,LESS
13,45,50,5,95,45,50,3.806662,3.912023,0.1053605,7.718685,3.806662,3.912023,0,0,1,1.2731,4,0.3662,LESS
13,126,150,24,276,150,126,4.836282,5.010635,0.1743534,9.846917,5.010635,4.836282,1,0,0,1.9265,2,0.5657,LESS
13,100,92,8,192,92,100,4.60517,4.521789,0.08338161,9.126959,4.521789,4.60517,1,1,1,2.551,1,1.6654,LESS
13,150,129,21,279,129,150,5.010635,4.859812,0.1508229,9.870448,4.859812,5.010635,1,1,1,1.1948,2,0.8165,LESS
13,44,50,6,94,44,50,3.78419,3.912023,0.1278334,7.696213,3.78419,3.912023,0,0,1,1.3031,4,0.4025,LESS
13,100,80,20,180,80,100,4.60517,4.382027,0.2231436,8.987197,4.382027,4.60517,1,1,1,1.8942,3,1.1979,LESS
13,123,150,27,273,150,123,4.812184,5.010635,0.1984509,9.82282,5.010635,4.812184,1,0,0,3.1038,2,0.3635,LESS
13,80,100,20,180,80,100,4.382027,4.60517,0.2231436,8.987197,4.382027,4.60517,0,0,1,2.3334,2,1.9167,LESS
13,150,120,30,270,120,150,5.010635,4.787492,0.2231436,9.798127,4.787492,5.010635,1,1,1,1.2173,4,0.5952,LESS
13,50,40,10,90,50,40,3.912023,3.688879,0.2231436,7.600902,3.912023,3.688879,0,1,0,2.7781,2,0.4164,LESS
13,50,54,4,104,50,54,3.912023,3.988984,0.07696104,7.901007,3.912023,3.988984,0,0,1,1.7369,4,0.7662,LESS
13,86,100,14,186,100,86,4.454347,4.60517,0.1508229,9.059517,4.60517,4.454347,1,0,0,2.6551,3,0.6645,LESS
13,116,100,16,216,100,116,4.75359,4.60517,0.14842,9.35876,4.60517,4.75359,1,1,1,1.1572,3,0.5166,LESS
13,118,100,18,218,100,118,4.770685,4.60517,0.1655144,9.375855,4.60517,4.770685,1,1,1,0.8135,4,1.4627,LESS
13,100,82,18,182,82,100,4.60517,4.406719,0.1984509,9.011889,4.406719,4.60517,1,1,1,1.5505,3,0.4151,LESS
13,165,150,15,315,150,165,5.105945,5.010635,0.09531018,10.11658,5.010635,5.105945,1,1,1,1.3492,2,0.8313,LESS
13,100,82,18,182,82,100,4.60517,4.406719,0.1984509,9.011889,4.406719,4.60517,1,1,1,1.3481,2,1.4152,LESS
13,50,57,7,107,50,57,3.912023,4.043051,0.1310283,7.955074,3.912023,4.043051,0,0,1,1.1595,4,0.4659,LESS
13,46,50,4,96,46,50,3.828641,3.912023,0.08338161,7.740664,3.828641,3.912023,0,0,1,1.3415,3,0.5792,LESS
13,50,52,2,102,50,52,3.912023,3.951244,0.03922071,7.863267,3.912023,3.951244,0,0,1,1.4712,1,0.6853,LESS
13,94,100,6,194,94,100,4.543295,4.60517,0.0618754,9.148465,4.543295,4.60517,0,0,1,1.2645,3,1.8487,LESS
13,50,43,7,93,43,50,3.912023,3.7612,0.1508229,7.673223,3.7612,3.912023,1,1,1,1.0578,4,0.5169,LESS
13,150,156,6,306,156,150,5.010635,5.049856,0.03922071,10.06049,5.049856,5.010635,1,0,0,1.03,2,0.6984,LESS
13,58,50,8,108,58,50,4.060443,3.912023,0.14842,7.972466,4.060443,3.912023,0,1,0,1.6459,1,2.1131,LESS
13,150,141,9,291,141,150,5.010635,4.94876,0.0618754,9.959395,4.94876,5.010635,1,1,1,1.1889,1,0.9116,LESS
13,50,47,3,97,50,47,3.912023,3.850148,0.0618754,7.762171,3.912023,3.850148,0,1,0,1.1789,1,1.4317,LESS
13,90,100,10,190,90,100,4.49981,4.60517,0.1053605,9.10498,4.49981,4.60517,0,0,1,2.8253,1,0.5997,LESS
13,50,43,7,93,50,43,3.912023,3.7612,0.1508229,7.673223,3.912023,3.7612,0,1,0,1.2767,3,0.4008,LESS
13,100,88,12,188,88,100,4.60517,4.477337,0.1278334,9.082507,4.477337,4.60517,1,1,1,1.9322,2,0.4993,LESS
13,50,40,10,90,40,50,3.912023,3.688879,0.2231436,7.600902,3.688879,3.912023,1,1,1,1.2719,2,1.8125,LESS
13,132,150,18,282,132,150,4.882802,5.010635,0.1278334,9.893437,4.882802,5.010635,0,0,1,2.1317,1,0.4335,LESS
13,100,86,14,186,86,100,4.60517,4.454347,0.1508229,9.059517,4.454347,4.60517,1,1,1,1.4978,2,1.5611,LESS
13,150,153,3,303,153,150,5.010635,5.030438,0.01980263,10.04107,5.030438,5.010635,1,0,0,1.2928,2,0.5649,LESS
13,47,50,3,97,47,50,3.850148,3.912023,0.0618754,7.762171,3.850148,3.912023,0,0,1,2.8795,1,0.3818,LESS
13,50,54,4,104,50,54,3.912023,3.988984,0.07696104,7.901007,3.912023,3.988984,0,0,1,1.316,2,0.5848,LESS
13,100,98,2,198,98,100,4.60517,4.584967,0.02020271,9.190138,4.584967,4.60517,1,1,1,1.1953,3,0.4129,LESS
13,150,126,24,276,126,150,5.010635,4.836282,0.1743534,9.846917,4.836282,5.010635,1,1,1,1.4709,3,0.8365,LESS
13,150,165,15,315,165,150,5.010635,5.105945,0.09531018,10.11658,5.105945,5.010635,1,0,0,1.2179,3,0.6814,LESS
13,100,94,6,194,94,100,4.60517,4.543295,0.0618754,9.148465,4.543295,4.60517,1,1,1,1.7321,2,0.8821,LESS
13,51,50,1,101,50,51,3.931826,3.912023,0.01980263,7.843849,3.912023,3.931826,1,1,1,1.1638,4,0.447,LESS
13,88,100,12,188,88,100,4.477337,4.60517,0.1278334,9.082507,4.477337,4.60517,0,0,1,1.5044,1,0.7654,LESS
13,162,150,12,312,150,162,5.087596,5.010635,0.07696104,10.09823,5.010635,5.087596,1,1,1,1.2776,2,1.2483,LESS
13,52,50,2,102,50,52,3.951244,3.912023,0.03922071,7.863267,3.912023,3.951244,1,1,1,1.1654,4,0.5482,LESS
13,55,50,5,105,50,55,4.007333,3.912023,0.09531018,7.919356,3.912023,4.007333,1,1,1,1.772,3,1.1809,LESS
13,44,50,6,94,44,50,3.78419,3.912023,0.1278334,7.696213,3.78419,3.912023,0,0,1,1.8797,2,3.4948,LESS
13,126,150,24,276,126,150,4.836282,5.010635,0.1743534,9.846917,4.836282,5.010635,0,0,1,1.242,4,1.1015,LESS
13,156,150,6,306,150,156,5.049856,5.010635,0.03922071,10.06049,5.010635,5.049856,1,1,1,1.16,2,0.5817,LESS
13,150,168,18,318,150,168,5.010635,5.123964,0.1133287,10.1346,5.010635,5.123964,0,0,1,2.9112,1,1.5469,LESS
13,100,104,4,204,104,100,4.60517,4.644391,0.03922071,9.249561,4.644391,4.60517,1,0,0,1.333,2,1.7644,LESS
13,48,50,2,98,48,50,3.871201,3.912023,0.04082199,7.783224,3.871201,3.912023,0,0,1,1.2132,3,0.4664,LESS
13,100,116,16,216,116,100,4.60517,4.75359,0.14842,9.35876,4.75359,4.60517,1,0,0,1.619,3,0.6481,LESS
13,82,100,18,182,100,82,4.406719,4.60517,0.1984509,9.011889,4.60517,4.406719,1,0,0,1.508,2,0.5655,LESS
13,141,150,9,291,150,141,4.94876,5.010635,0.0618754,9.959395,5.010635,4.94876,1,0,0,1.3643,1,1.4466,LESS
14,141,150,9,291,141,150,4.94876,5.010635,0.0618754,9.959395,4.94876,5.010635,0,0,1,2.1729,1,1.5163,LESS
14,150,168,18,318,150,168,5.010635,5.123964,0.1133287,10.1346,5.010635,5.123964,0,0,1,1.7311,1,0.9179,LESS
14,129,150,21,279,129,150,4.859812,5.010635,0.1508229,9.870448,4.859812,5.010635,0,0,1,3.2326,3,0.3664,LESS
14,177,150,27,327,150,177,5.17615,5.010635,0.1655144,10.18679,5.010635,5.17615,1,1,1,1.4685,2,0.7634,LESS
14,138,150,12,288,138,150,4.927254,5.010635,0.08338161,9.937889,4.927254,5.010635,0,0,1,1.6293,1,2.7051,LESS
14,50,45,5,95,45,50,3.912023,3.806662,0.1053605,7.718685,3.806662,3.912023,1,1,1,2.1826,4,0.5676,LESS
14,45,50,5,95,45,50,3.806662,3.912023,0.1053605,7.718685,3.806662,3.912023,0,0,1,2.0059,4,0.5838,LESS
14,174,150,24,324,150,174,5.159055,5.010635,0.14842,10.16969,5.010635,5.159055,1,1,1,2.9977,2,0.3806,LESS
14,86,100,14,186,86,100,4.454347,4.60517,0.1508229,9.059517,4.454347,4.60517,0,0,1,1.9515,3,0.7017,LESS
14,59,50,9,109,59,50,4.077537,3.912023,0.1655144,7.98956,4.077537,3.912023,0,1,0,1.6549,1,0.6857,LESS
14,116,100,16,216,100,116,4.75359,4.60517,0.14842,9.35876,4.60517,4.75359,1,1,1,3.5047,1,0.7383,LESS
14,100,116,16,216,100,116,4.60517,4.75359,0.14842,9.35876,4.60517,4.75359,0,0,1,1.7398,2,1.5033,LESS
14,100,96,4,196,96,100,4.60517,4.564348,0.04082199,9.169518,4.564348,4.60517,1,1,1,2.0145,3,0.5668,LESS
14,150,180,30,330,150,180,5.010635,5.192957,0.1823216,10.20359,5.010635,5.192957,0,0,1,1.5158,1,0.6022,LESS
14,57,50,7,107,50,57,4.043051,3.912023,0.1310283,7.955074,3.912023,4.043051,1,1,1,1.9348,1,0.9801,LESS
14,159,150,9,309,150,159,5.068904,5.010635,0.05826891,10.07954,5.010635,5.068904,1,1,1,3.9202,3,0.2334,LESS
14,60,50,10,110,50,60,4.094345,3.912023,0.1823216,8.006368,3.912023,4.094345,1,1,1,2.3583,4,0.3179,LESS
14,102,100,2,202,102,100,4.624973,4.60517,0.01980263,9.230143,4.624973,4.60517,0,1,0,5.5613,1,0.5505,LESS
14,100,112,12,212,112,100,4.60517,4.718499,0.1133287,9.323669,4.718499,4.60517,1,0,0,3.1914,1,0.2003,LESS
14,53,50,3,103,50,53,3.970292,3.912023,0.05826891,7.882315,3.912023,3.970292,1,1,1,3.0231,3,0.2196,LESS
14,100,120,20,220,100,120,4.60517,4.787492,0.1823216,9.392662,4.60517,4.787492,0,0,1,1.8876,1,0.7495,LESS
14,150,141,9,291,141,150,5.010635,4.94876,0.0618754,9.959395,4.94876,5.010635,1,1,1,3.4041,2,0.4679,LESS
14,150,177,27,327,150,177,5.010635,5.17615,0.1655144,10.18679,5.010635,5.17615,0,0,1,2.1009,1,0.2844,LESS
14,147,150,3,297,147,150,4.990433,5.010635,0.02020271,10.00107,4.990433,5.010635,0,0,1,2.0645,1,0.5173,LESS
14,118,100,18,218,100,118,4.770685,4.60517,0.1655144,9.375855,4.60517,4.770685,1,1,1,1.6739,3,0.4505,LESS
14,100,96,4,196,100,96,4.60517,4.564348,0.04082199,9.169518,4.60517,4.564348,0,1,0,2.1725,2,0.5359,LESS
14,171,150,21,321,150,171,5.141664,5.010635,0.1310283,10.1523,5.010635,5.141664,1,1,1,2.3853,1,0.5682,LESS
14,50,48,2,98,48,50,3.912023,3.871201,0.04082199,7.783224,3.871201,3.912023,1,1,1,2.7237,2,0.9163,LESS
14,50,57,7,107,50,57,3.912023,4.043051,0.1310283,7.955074,3.912023,4.043051,0,0,1,1.998,3,0.3173,LESS
14,88,100,12,188,88,100,4.477337,4.60517,0.1278334,9.082507,4.477337,4.60517,0,0,1,2.851,3,0.1864,LESS
14,50,57,7,107,50,57,3.912023,4.043051,0.1310283,7.955074,3.912023,4.043051,0,0,1,1.6428,4,0.1636,LESS
14,150,132,18,282,132,150,5.010635,4.882802,0.1278334,9.893437,4.882802,5.010635,1,1,1,1.7945,2,0.1845,LESS
14,98,100,2,198,98,100,4.584967,4.60517,0.02020271,9.190138,4.584967,4.60517,0,0,1,3.121,1,0.214,LESS
14,94,100,6,194,94,100,4.543295,4.60517,0.0618754,9.148465,4.543295,4.60517,0,0,1,2.4767,1,0.4206,LESS
14,82,100,18,182,82,100,4.406719,4.60517,0.1984509,9.011889,4.406719,4.60517,0,0,1,1.8269,3,0.3005,LESS
14,41,50,9,91,41,50,3.713572,3.912023,0.1984509,7.625595,3.713572,3.912023,0,0,1,1.7066,4,0.251,LESS
14,50,59,9,109,50,59,3.912023,4.077537,0.1655144,7.98956,3.912023,4.077537,0,0,1,2.6132,3,0.1904,LESS
14,150,174,24,324,150,174,5.010635,5.159055,0.14842,10.16969,5.010635,5.159055,0,0,1,2.2969,2,0.2704,LESS
14,47,50,3,97,47,50,3.850148,3.912023,0.0618754,7.762171,3.850148,3.912023,0,0,1,5.4683,4,0.184,LESS
14,50,41,9,91,41,50,3.912023,3.713572,0.1984509,7.625595,3.713572,3.912023,1,1,1,1.9561,4,0.2508,LESS
14,50,47,3,97,50,47,3.912023,3.850148,0.0618754,7.762171,3.912023,3.850148,0,1,0,1.7659,3,0.2361,LESS
14,104,100,4,204,100,104,4.644391,4.60517,0.03922071,9.249561,4.60517,4.644391,1,1,1,2.3041,4,0.1375,LESS
14,88,100,12,188,88,100,4.477337,4.60517,0.1278334,9.082507,4.477337,4.60517,0,0,1,2.7027,3,0.1491,LESS
14,59,50,9,109,50,59,4.077537,3.912023,0.1655144,7.98956,3.912023,4.077537,1,1,1,1.6046,4,0.2142,LESS
14,53,50,3,103,50,53,3.970292,3.912023,0.05826891,7.882315,3.912023,3.970292,1,1,1,1.5837,4,0.3721,LESS
14,150,153,3,303,150,153,5.010635,5.030438,0.01980263,10.04107,5.010635,5.030438,0,0,1,2.0317,1,0.1348,LESS
14,96,100,4,196,100,96,4.564348,4.60517,0.04082199,9.169518,4.60517,4.564348,1,0,0,3.4881,1,0.1997,LESS
14,100,88,12,188,88,100,4.60517,4.477337,0.1278334,9.082507,4.477337,4.60517,1,1,1,2.3082,2,0.1508,LESS
14,50,56,6,106,56,50,3.912023,4.025352,0.1133287,7.937375,4.025352,3.912023,1,0,0,7.1187,1,0.1842,LESS
14,100,84,16,184,84,100,4.60517,4.430817,0.1743534,9.035987,4.430817,4.60517,1,1,1,1.785,1,0.551,LESS
14,54,50,4,104,50,54,3.988984,3.912023,0.07696104,7.901007,3.912023,3.988984,1,1,1,2.4379,1,0.1381,LESS
14,144,150,6,294,144,150,4.969813,5.010635,0.04082199,9.980449,4.969813,5.010635,0,0,1,1.8537,1,0.2008,LESS
14,52,50,2,102,52,50,3.951244,3.912023,0.03922071,7.863267,3.951244,3.912023,0,1,0,3.5503,3,0.2353,LESS
14,50,55,5,105,50,55,3.912023,4.007333,0.09531018,7.919356,3.912023,4.007333,0,0,1,6.8712,2,0.2016,LESS
14,56,50,6,106,50,56,4.025352,3.912023,0.1133287,7.937375,3.912023,4.025352,1,1,1,1.6765,4,0.3008,LESS
14,132,150,18,282,132,150,4.882802,5.010635,0.1278334,9.893437,4.882802,5.010635,0,0,1,2.2297,1,0.1711,LESS
14,153,150,3,303,150,153,5.030438,5.010635,0.01980263,10.04107,5.010635,5.030438,1,1,1,5.019,1,0.1528,LESS
14,108,100,8,208,100,108,4.682131,4.60517,0.07696104,9.287301,4.60517,4.682131,1,1,1,1.8513,1,0.1352,LESS
14,162,150,12,312,150,162,5.087596,5.010635,0.07696104,10.09823,5.010635,5.087596,1,1,1,2.5947,1,0.1671,LESS
14,51,50,1,101,50,51,3.931826,3.912023,0.01980263,7.843849,3.912023,3.931826,1,1,1,3.7224,3,0.1471,LESS
14,150,144,6,294,150,144,5.010635,4.969813,0.04082199,9.980449,5.010635,4.969813,0,1,0,4.2717,1,0.1343,LESS
14,100,110,10,210,100,110,4.60517,4.70048,0.09531018,9.305651,4.60517,4.70048,0,0,1,5.2266,1,0.2678,LESS
14,129,150,21,279,129,150,4.859812,5.010635,0.1508229,9.870448,4.859812,5.010635,0,0,1,1.9539,2,0.2328,LESS
14,150,177,27,327,150,177,5.010635,5.17615,0.1655144,10.18679,5.010635,5.17615,0,0,1,2.5855,3,0.1838,LESS
14,100,80,20,180,80,100,4.60517,4.382027,0.2231436,8.987197,4.382027,4.60517,1,1,1,3.9254,2,0.2007,LESS
14,50,42,8,92,42,50,3.912023,3.73767,0.1743534,7.649693,3.73767,3.912023,1,1,1,2.237,4,0.1666,LESS
14,82,100,18,182,82,100,4.406719,4.60517,0.1984509,9.011889,4.406719,4.60517,0,0,1,4.158,1,0.1685,LESS
14,118,100,18,218,100,118,4.770685,4.60517,0.1655144,9.375855,4.60517,4.770685,1,1,1,3.1702,1,0.2186,LESS
14,150,174,24,324,150,174,5.010635,5.159055,0.14842,10.16969,5.010635,5.159055,0,0,1,2.1552,1,0.1046,LESS
14,156,150,6,306,156,150,5.049856,5.010635,0.03922071,10.06049,5.049856,5.010635,0,1,0,2.6854,1,0.2006,LESS
14,100,86,14,186,100,86,4.60517,4.454347,0.1508229,9.059517,4.60517,4.454347,0,1,0,2.1781,1,0.2013,LESS
14,50,55,5,105,50,55,3.912023,4.007333,0.09531018,7.919356,3.912023,4.007333,0,0,1,1.8527,4,0.1672,LESS
14,90,100,10,190,90,100,4.49981,4.60517,0.1053605,9.10498,4.49981,4.60517,0,0,1,2.5106,2,0.1364,LESS
14,150,165,15,315,150,165,5.010635,5.105945,0.09531018,10.11658,5.010635,5.105945,0,0,1,2.0219,2,0.1341,LESS
14,44,50,6,94,44,50,3.78419,3.912023,0.1278334,7.696213,3.78419,3.912023,0,0,1,2.6598,4,0.1211,LESS
14,159,150,9,309,159,150,5.068904,5.010635,0.05826891,10.07954,5.068904,5.010635,0,1,0,2.0896,1,0.1512,LESS
14,43,50,7,93,43,50,3.7612,3.912023,0.1508229,7.673223,3.7612,3.912023,0,0,1,1.8425,4,0.1671,LESS
14,100,108,8,208,100,108,4.60517,4.682131,0.07696104,9.287301,4.60517,4.682131,0,0,1,2.0363,2,0.1524,LESS
14,150,120,30,270,150,120,5.010635,4.787492,0.2231436,9.798127,5.010635,4.787492,0,1,0,3.4367,1,0.1671,LESS
14,57,50,7,107,50,57,4.043051,3.912023,0.1310283,7.955074,3.912023,4.043051,1,1,1,8.4921,2,0.2495,LESS
14,100,112,12,212,100,112,4.60517,4.718499,0.1133287,9.323669,4.60517,4.718499,0,0,1,1.9049,1,0.1512,LESS
14,40,50,10,90,40,50,3.688879,3.912023,0.2231436,7.600902,3.688879,3.912023,0,0,1,1.8861,4,0.1356,LESS
14,100,102,2,202,100,102,4.60517,4.624973,0.01980263,9.230143,4.60517,4.624973,0,0,1,1.5303,2,0.2173,LESS
14,120,150,30,270,120,150,4.787492,5.010635,0.2231436,9.798127,4.787492,5.010635,0,0,1,2.0912,2,0.1683,LESS
14,100,110,10,210,100,110,4.60517,4.70048,0.09531018,9.305651,4.60517,4.70048,0,0,1,1.7612,2,0.1346,LESS
14,100,102,2,202,102,100,4.60517,4.624973,0.01980263,9.230143,4.624973,4.60517,1,0,0,1.7465,1,0.5184,LESS
14,150,129,21,279,129,150,5.010635,4.859812,0.1508229,9.870448,4.859812,5.010635,1,1,1,2.977,3,0.1849,LESS
14,58,50,8,108,50,58,4.060443,3.912023,0.14842,7.972466,3.912023,4.060443,1,1,1,1.8501,3,0.1509,LESS
14,55,50,5,105,50,55,4.007333,3.912023,0.09531018,7.919356,3.912023,4.007333,1,1,1,6.6361,2,0.135,LESS
14,42,50,8,92,42,50,3.73767,3.912023,0.1743534,7.649693,3.73767,3.912023,0,0,1,1.6927,4,0.1676,LESS
14,177,150,27,327,150,177,5.17615,5.010635,0.1655144,10.18679,5.010635,5.17615,1,1,1,4.9544,1,0.2675,LESS
14,50,44,6,94,44,50,3.912023,3.78419,0.1278334,7.696213,3.78419,3.912023,1,1,1,6.7939,2,0.2505,LESS
14,50,40,10,90,40,50,3.912023,3.688879,0.2231436,7.600902,3.688879,3.912023,1,1,1,1.7777,4,0.1684,LESS
14,100,90,10,190,90,100,4.60517,4.49981,0.1053605,9.10498,4.49981,4.60517,1,1,1,3.7856,1,0.2541,LESS
14,49,50,1,99,49,50,3.89182,3.912023,0.02020271,7.803843,3.89182,3.912023,0,0,1,2.7503,4,0.2005,LESS
14,150,135,15,285,135,150,5.010635,4.905275,0.1053605,9.91591,4.905275,5.010635,1,1,1,3.2689,1,0.1225,LESS
14,100,120,20,220,100,120,4.60517,4.787492,0.1823216,9.392662,4.60517,4.787492,0,0,1,1.8029,2,0.1687,LESS
14,150,171,21,321,171,150,5.010635,5.141664,0.1310283,10.1523,5.141664,5.010635,1,0,0,6.345,1,0.1678,LESS
14,150,171,21,321,150,171,5.010635,5.141664,0.1310283,10.1523,5.010635,5.141664,0,0,1,1.2262,2,0.3681,LESS
14,43,50,7,93,43,50,3.7612,3.912023,0.1508229,7.673223,3.7612,3.912023,0,0,1,1.7541,3,0.1836,LESS
14,100,98,2,198,100,98,4.60517,4.584967,0.02020271,9.190138,4.60517,4.584967,0,1,0,1.6258,3,0.251,LESS
14,150,126,24,276,126,150,5.010635,4.836282,0.1743534,9.846917,4.836282,5.010635,1,1,1,2.1447,2,0.149,LESS
14,150,144,6,294,144,150,5.010635,4.969813,0.04082199,9.980449,4.969813,5.010635,1,1,1,1.9497,1,0.1139,LESS
14,94,100,6,194,94,100,4.543295,4.60517,0.0618754,9.148465,4.543295,4.60517,0,0,1,1.857,2,0.1538,LESS
14,50,52,2,102,50,52,3.912023,3.951244,0.03922071,7.863267,3.912023,3.951244,0,0,1,1.9693,3,0.2057,LESS
14,96,100,4,196,100,96,4.564348,4.60517,0.04082199,9.169518,4.60517,4.564348,1,0,0,5.7057,1,0.3172,LESS
14,168,150,18,318,150,168,5.123964,5.010635,0.1133287,10.1346,5.010635,5.123964,1,1,1,2.2799,2,0.3015,LESS
14,150,153,3,303,153,150,5.010635,5.030438,0.01980263,10.04107,5.030438,5.010635,1,0,0,5.0722,1,0.1995,LESS
14,46,50,4,96,46,50,3.828641,3.912023,0.08338161,7.740664,3.828641,3.912023,0,0,1,1.9546,4,0.2844,LESS
14,120,100,20,220,100,120,4.787492,4.60517,0.1823216,9.392662,4.60517,4.787492,1,1,1,2.4708,3,0.3171,LESS
14,100,106,6,206,106,100,4.60517,4.663439,0.05826891,9.268609,4.663439,4.60517,1,0,0,3.3276,2,0.301,LESS
14,48,50,2,98,48,50,3.871201,3.912023,0.04082199,7.783224,3.871201,3.912023,0,0,1,2.8273,3,0.1513,LESS
14,50,48,2,98,48,50,3.912023,3.871201,0.04082199,7.783224,3.871201,3.912023,1,1,1,7.2497,3,0.2013,LESS
14,112,100,12,212,100,112,4.718499,4.60517,0.1133287,9.323669,4.60517,4.718499,1,1,1,1.9464,2,0.3653,LESS
14,60,50,10,110,50,60,4.094345,3.912023,0.1823216,8.006368,3.912023,4.094345,1,1,1,6.0888,2,0.2012,LESS
14,92,100,8,192,92,100,4.521789,4.60517,0.08338161,9.126959,4.521789,4.60517,0,0,1,2.7919,1,0.1403,LESS
14,150,168,18,318,168,150,5.010635,5.123964,0.1133287,10.1346,5.123964,5.010635,1,0,0,7.4491,2,0.2223,LESS
14,150,141,9,291,141,150,5.010635,4.94876,0.0618754,9.959395,4.94876,5.010635,1,1,1,2.9149,1,0.3685,LESS
14,50,45,5,95,50,45,3.912023,3.806662,0.1053605,7.718685,3.912023,3.806662,0,1,0,2.2675,3,0.1674,LESS
14,40,50,10,90,40,50,3.688879,3.912023,0.2231436,7.600902,3.688879,3.912023,0,0,1,1.8689,4,0.1673,LESS
14,150,162,12,312,162,150,5.010635,5.087596,0.07696104,10.09823,5.087596,5.010635,1,0,0,2.8418,1,0.1677,LESS
14,100,106,6,206,106,100,4.60517,4.663439,0.05826891,9.268609,4.663439,4.60517,1,0,0,1.9038,1,0.5737,LESS
14,162,150,12,312,150,162,5.087596,5.010635,0.07696104,10.09823,5.010635,5.087596,1,1,1,3.6288,2,0.1759,LESS
14,58,50,8,108,58,50,4.060443,3.912023,0.14842,7.972466,4.060443,3.912023,0,1,0,3.0371,2,0.1938,LESS
14,150,147,3,297,147,150,5.010635,4.990433,0.02020271,10.00107,4.990433,5.010635,1,1,1,2.8952,1,0.2339,LESS
14,100,92,8,192,92,100,4.60517,4.521789,0.08338161,9.126959,4.521789,4.60517,1,1,1,2.6044,3,0.151,LESS
14,110,100,10,210,100,110,4.70048,4.60517,0.09531018,9.305651,4.60517,4.70048,1,1,1,2.2934,4,0.1336,LESS
14,100,84,16,184,84,100,4.60517,4.430817,0.1743534,9.035987,4.430817,4.60517,1,1,1,2.1698,3,0.1851,LESS
14,141,150,9,291,141,150,4.94876,5.010635,0.0618754,9.959395,4.94876,5.010635,0,0,1,2.5422,1,0.1349,LESS
14,156,150,6,306,150,156,5.049856,5.010635,0.03922071,10.06049,5.010635,5.049856,1,1,1,2.0043,2,0.1511,LESS
14,50,56,6,106,56,50,3.912023,4.025352,0.1133287,7.937375,4.025352,3.912023,1,0,0,8.0223,1,0.2678,LESS
14,100,94,6,194,94,100,4.60517,4.543295,0.0618754,9.148465,4.543295,4.60517,1,1,1,7.8644,2,0.1341,LESS
14,144,150,6,294,150,144,4.969813,5.010635,0.04082199,9.980449,5.010635,4.969813,1,0,0,9.0648,2,0.1672,LESS
14,150,180,30,330,150,180,5.010635,5.192957,0.1823216,10.20359,5.010635,5.192957,0,0,1,2.6714,2,0.1339,LESS
14,100,90,10,190,100,90,4.60517,4.49981,0.1053605,9.10498,4.60517,4.49981,0,1,0,4.4594,1,0.1028,LESS
14,46,50,4,96,50,46,3.828641,3.912023,0.08338161,7.740664,3.912023,3.828641,1,0,0,4.4984,4,0.2409,LESS
14,50,52,2,102,52,50,3.912023,3.951244,0.03922071,7.863267,3.951244,3.912023,1,0,0,4.498,1,0.2176,LESS
14,52,50,2,102,52,50,3.951244,3.912023,0.03922071,7.863267,3.951244,3.912023,0,1,0,3.69,2,0.1841,LESS
14,86,100,14,186,86,100,4.454347,4.60517,0.1508229,9.059517,4.454347,4.60517,0,0,1,3.9617,1,0.2007,LESS
14,165,150,15,315,165,150,5.105945,5.010635,0.09531018,10.11658,5.105945,5.010635,0,1,0,7.486,1,0.1675,LESS
14,150,132,18,282,132,150,5.010635,4.882802,0.1278334,9.893437,4.882802,5.010635,1,1,1,3.9584,1,0.2177,LESS
14,49,50,1,99,49,50,3.89182,3.912023,0.02020271,7.803843,3.89182,3.912023,0,0,1,2.8458,4,0.3319,LESS
14,110,100,10,210,100,110,4.70048,4.60517,0.09531018,9.305651,4.60517,4.70048,1,1,1,3.7508,1,0.1902,LESS
14,80,100,20,180,80,100,4.382027,4.60517,0.2231436,8.987197,4.382027,4.60517,0,0,1,3.4402,2,0.2175,LESS
14,100,94,6,194,100,94,4.60517,4.543295,0.0618754,9.148465,4.60517,4.543295,0,1,0,2.3956,2,0.1847,LESS
14,180,150,30,330,150,180,5.192957,5.010635,0.1823216,10.20359,5.010635,5.192957,1,1,1,2.6579,1,0.3346,LESS
14,100,82,18,182,82,100,4.60517,4.406719,0.1984509,9.011889,4.406719,4.60517,1,1,1,2.1489,2,0.2339,LESS
14,171,150,21,321,171,150,5.141664,5.010635,0.1310283,10.1523,5.141664,5.010635,0,1,0,9.0323,1,0.1846,LESS
14,50,60,10,110,50,60,3.912023,4.094345,0.1823216,8.006368,3.912023,4.094345,0,0,1,3.1445,4,0.2176,LESS
14,92,100,8,192,92,100,4.521789,4.60517,0.08338161,9.126959,4.521789,4.60517,0,0,1,3.8621,1,0.251,LESS
14,102,100,2,202,100,102,4.624973,4.60517,0.01980263,9.230143,4.60517,4.624973,1,1,1,2.7677,2,0.2367,LESS
14,116,100,16,216,100,116,4.75359,4.60517,0.14842,9.35876,4.60517,4.75359,1,1,1,2.4314,2,0.1844,LESS
14,150,123,27,273,123,150,5.010635,4.812184,0.1984509,9.82282,4.812184,5.010635,1,1,1,2.2317,2,0.2841,LESS
14,100,108,8,208,100,108,4.60517,4.682131,0.07696104,9.287301,4.60517,4.682131,0,0,1,3.2021,2,0.2339,LESS
14,150,138,12,288,138,150,5.010635,4.927254,0.08338161,9.937889,4.927254,5.010635,1,1,1,2.951,1,0.3676,LESS
14,112,100,12,212,100,112,4.718499,4.60517,0.1133287,9.323669,4.60517,4.718499,1,1,1,2.4732,1,0.4179,LESS
14,126,150,24,276,150,126,4.836282,5.010635,0.1743534,9.846917,5.010635,4.836282,1,0,0,5.8893,1,0.3515,LESS
14,50,58,8,108,50,58,3.912023,4.060443,0.14842,7.972466,3.912023,4.060443,0,0,1,3.768,2,0.3149,LESS
14,50,60,10,110,50,60,3.912023,4.094345,0.1823216,8.006368,3.912023,4.094345,0,0,1,2.8908,4,0.4506,LESS
14,135,150,15,285,135,150,4.905275,5.010635,0.1053605,9.91591,4.905275,5.010635,0,0,1,2.9357,3,0.4175,LESS
14,50,54,4,104,50,54,3.912023,3.988984,0.07696104,7.901007,3.912023,3.988984,0,0,1,2.4845,2,0.1175,LESS
14,120,150,30,270,120,150,4.787492,5.010635,0.2231436,9.798127,4.787492,5.010635,0,0,1,2.4462,3,0.1174,LESS
14,100,86,14,186,86,100,4.60517,4.454347,0.1508229,9.059517,4.454347,4.60517,1,1,1,4.0205,3,0.1676,LESS
14,50,58,8,108,50,58,3.912023,4.060443,0.14842,7.972466,3.912023,4.060443,0,0,1,2.2197,4,0.1012,LESS
14,153,150,3,303,150,153,5.030438,5.010635,0.01980263,10.04107,5.010635,5.030438,1,1,1,3.6215,1,0.201,LESS
14,100,118,18,218,100,118,4.60517,4.770685,0.1655144,9.375855,4.60517,4.770685,0,0,1,2.5989,2,0.1512,LESS
14,104,100,4,204,104,100,4.644391,4.60517,0.03922071,9.249561,4.644391,4.60517,0,1,0,6.319,1,0.1186,LESS
14,50,40,10,90,40,50,3.912023,3.688879,0.2231436,7.600902,3.688879,3.912023,1,1,1,5.1712,3,0.1012,LESS
14,50,54,4,104,54,50,3.912023,3.988984,0.07696104,7.901007,3.988984,3.912023,1,0,0,3.9385,4,0.2175,LESS
14,150,156,6,306,156,150,5.010635,5.049856,0.03922071,10.06049,5.049856,5.010635,1,0,0,4.1905,1,0.1006,LESS
14,50,46,4,96,46,50,3.912023,3.828641,0.08338161,7.740664,3.828641,3.912023,1,1,1,2.4665,4,0.1847,LESS
14,150,147,3,297,147,150,5.010635,4.990433,0.02020271,10.00107,4.990433,5.010635,1,1,1,3.4062,1,0.2181,LESS
14,114,100,14,214,100,114,4.736198,4.60517,0.1310283,9.341369,4.60517,4.736198,1,1,1,4.1332,1,0.1873,LESS
14,150,129,21,279,129,150,5.010635,4.859812,0.1508229,9.870448,4.859812,5.010635,1,1,1,6.129,1,0.2211,LESS
14,120,100,20,220,100,120,4.787492,4.60517,0.1823216,9.392662,4.60517,4.787492,1,1,1,2.2157,2,0.2528,LESS
14,147,150,3,297,150,147,4.990433,5.010635,0.02020271,10.00107,5.010635,4.990433,1,0,0,2.384,1,0.2174,LESS
14,100,104,4,204,100,104,4.60517,4.644391,0.03922071,9.249561,4.60517,4.644391,0,0,1,1.8794,3,0.3015,LESS
14,100,88,12,188,88,100,4.60517,4.477337,0.1278334,9.082507,4.477337,4.60517,1,1,1,2.2547,2,0.1561,LESS
14,50,53,3,103,50,53,3.912023,3.970292,0.05826891,7.882315,3.912023,3.970292,0,0,1,1.7672,4,0.154,LESS
14,50,43,7,93,43,50,3.912023,3.7612,0.1508229,7.673223,3.7612,3.912023,1,1,1,3.1256,4,0.1684,LESS
14,100,114,14,214,100,114,4.60517,4.736198,0.1310283,9.341369,4.60517,4.736198,0,0,1,3.0816,1,0.2177,LESS
14,50,43,7,93,50,43,3.912023,3.7612,0.1508229,7.673223,3.912023,3.7612,0,1,0,3.8558,2,0.1204,LESS
14,50,49,1,99,50,49,3.912023,3.89182,0.02020271,7.803843,3.912023,3.89182,0,1,0,3.8098,3,0.1337,LESS
14,55,50,5,105,55,50,4.007333,3.912023,0.09531018,7.919356,4.007333,3.912023,0,1,0,2.5323,3,0.151,LESS
14,123,150,27,273,123,150,4.812184,5.010635,0.1984509,9.82282,4.812184,5.010635,0,0,1,2.0251,3,0.1878,LESS
14,50,59,9,109,50,59,3.912023,4.077537,0.1655144,7.98956,3.912023,4.077537,0,0,1,2.0491,4,0.2008,LESS
14,138,150,12,288,138,150,4.927254,5.010635,0.08338161,9.937889,4.927254,5.010635,0,0,1,3.8316,1,0.1171,LESS
14,51,50,1,101,50,51,3.931826,3.912023,0.01980263,7.843849,3.912023,3.931826,1,1,1,2.438,2,0.1708,LESS
14,168,150,18,318,150,168,5.123964,5.010635,0.1133287,10.1346,5.010635,5.123964,1,1,1,1.6422,3,0.1682,LESS
14,50,46,4,96,50,46,3.912023,3.828641,0.08338161,7.740664,3.912023,3.828641,0,1,0,7.3269,1,0.2014,LESS
14,90,100,10,190,100,90,4.49981,4.60517,0.1053605,9.10498,4.60517,4.49981,1,0,0,2.4468,2,0.4336,LESS
14,100,80,20,180,100,80,4.60517,4.382027,0.2231436,8.987197,4.60517,4.382027,0,1,0,5.5211,1,0.201,LESS
14,56,50,6,106,56,50,4.025352,3.912023,0.1133287,7.937375,4.025352,3.912023,0,1,0,4.1354,1,0.1844,LESS
14,98,100,2,198,100,98,4.584967,4.60517,0.02020271,9.190138,4.60517,4.584967,1,0,0,2.7232,1,0.1512,LESS
14,132,150,18,282,132,150,4.882802,5.010635,0.1278334,9.893437,4.882802,5.010635,0,0,1,2.991,1,0.1501,LESS
14,80,100,20,180,80,100,4.382027,4.60517,0.2231436,8.987197,4.382027,4.60517,0,0,1,5.8899,1,0.285,LESS
14,174,150,24,324,150,174,5.159055,5.010635,0.14842,10.16969,5.010635,5.159055,1,1,1,1.6862,2,0.1509,LESS
14,150,120,30,270,120,150,5.010635,4.787492,0.2231436,9.798127,4.787492,5.010635,1,1,1,1.5929,3,0.1669,LESS
14,165,150,15,315,150,165,5.105945,5.010635,0.09531018,10.11658,5.010635,5.105945,1,1,1,2.0557,1,0.1846,LESS
14,48,50,2,98,48,50,3.871201,3.912023,0.04082199,7.783224,3.871201,3.912023,0,0,1,2.946,1,0.1345,LESS
14,150,126,24,276,126,150,5.010635,4.836282,0.1743534,9.846917,4.836282,5.010635,1,1,1,1.5823,2,0.1511,LESS
14,50,47,3,97,47,50,3.912023,3.850148,0.0618754,7.762171,3.850148,3.912023,1,1,1,2.2733,4,0.1333,LESS
14,45,50,5,95,45,50,3.806662,3.912023,0.1053605,7.718685,3.806662,3.912023,0,0,1,2.9938,3,0.1179,LESS
14,108,100,8,208,100,108,4.682131,4.60517,0.07696104,9.287301,4.60517,4.682131,1,1,1,4.3854,1,0.15,LESS
14,50,49,1,99,50,49,3.912023,3.89182,0.02020271,7.803843,3.912023,3.89182,0,1,0,2.0957,2,0.1676,LESS
14,50,51,1,101,51,50,3.912023,3.931826,0.01980263,7.843849,3.931826,3.912023,1,0,0,3.1388,1,0.1561,LESS
14,114,100,14,214,100,114,4.736198,4.60517,0.1310283,9.341369,4.60517,4.736198,1,1,1,2.4361,2,0.1348,LESS
14,106,100,6,206,100,106,4.663439,4.60517,0.05826891,9.268609,4.60517,4.663439,1,1,1,4.3662,2,0.1012,LESS
14,150,165,15,315,150,165,5.010635,5.105945,0.09531018,10.11658,5.010635,5.105945,0,0,1,2.3124,1,0.2066,LESS
14,126,150,24,276,126,150,4.836282,5.010635,0.1743534,9.846917,4.836282,5.010635,0,0,1,4.1669,1,0.1507,LESS
14,50,51,1,101,50,51,3.912023,3.931826,0.01980263,7.843849,3.912023,3.931826,0,0,1,2.0537,3,0.1176,LESS
14,180,150,30,330,150,180,5.192957,5.010635,0.1823216,10.20359,5.010635,5.192957,1,1,1,1.5848,2,0.2005,LESS
14,150,156,6,306,150,156,5.010635,5.049856,0.03922071,10.06049,5.010635,5.049856,0,0,1,3.2526,2,0.1511,LESS
14,44,50,6,94,44,50,3.78419,3.912023,0.1278334,7.696213,3.78419,3.912023,0,0,1,2.4658,4,0.2005,LESS
14,41,50,9,91,41,50,3.713572,3.912023,0.1984509,7.625595,3.713572,3.912023,0,0,1,1.6239,4,0.2011,LESS
14,150,123,27,273,123,150,5.010635,4.812184,0.1984509,9.82282,4.812184,5.010635,1,1,1,2.7816,2,0.2006,LESS
14,84,100,16,184,84,100,4.430817,4.60517,0.1743534,9.035987,4.430817,4.60517,0,0,1,3.3248,1,0.1874,LESS
14,100,104,4,204,104,100,4.60517,4.644391,0.03922071,9.249561,4.644391,4.60517,1,0,0,2.3741,1,0.1672,LESS
14,50,53,3,103,50,53,3.912023,3.970292,0.05826891,7.882315,3.912023,3.970292,0,0,1,1.8914,3,0.1678,LESS
14,135,150,15,285,150,135,4.905275,5.010635,0.1053605,9.91591,5.010635,4.905275,1,0,0,2.8645,1,0.2006,LESS
14,123,150,27,273,123,150,4.812184,5.010635,0.1984509,9.82282,4.812184,5.010635,0,0,1,2.8706,3,0.1669,LESS
14,100,118,18,218,100,118,4.60517,4.770685,0.1655144,9.375855,4.60517,4.770685,0,0,1,4.1553,2,0.1847,LESS
14,106,100,6,206,100,106,4.663439,4.60517,0.05826891,9.268609,4.60517,4.663439,1,1,1,3.5839,1,0.2371,LESS
14,84,100,16,184,84,100,4.430817,4.60517,0.1743534,9.035987,4.430817,4.60517,0,0,1,7.4487,1,0.1838,LESS
14,50,41,9,91,41,50,3.912023,3.713572,0.1984509,7.625595,3.713572,3.912023,1,1,1,2.1826,3,0.1853,LESS
14,50,44,6,94,50,44,3.912023,3.78419,0.1278334,7.696213,3.912023,3.78419,0,1,0,2.9415,1,0.1014,LESS
14,100,98,2,198,98,100,4.60517,4.584967,0.02020271,9.190138,4.584967,4.60517,1,1,1,6.8003,2,0.2557,LESS
14,150,162,12,312,150,162,5.010635,5.087596,0.07696104,10.09823,5.010635,5.087596,0,0,1,8.3815,1,0.1516,LESS
14,54,50,4,104,50,54,3.988984,3.912023,0.07696104,7.901007,3.912023,3.988984,1,1,1,3.0044,3,0.5013,LESS
14,100,82,18,182,82,100,4.60517,4.406719,0.1984509,9.011889,4.406719,4.60517,1,1,1,2.04,4,0.4211,LESS
14,50,42,8,92,50,42,3.912023,3.73767,0.1743534,7.649693,3.912023,3.73767,0,1,0,2.3894,3,0.2045,LESS
14,150,159,9,309,159,150,5.010635,5.068904,0.05826891,10.07954,5.068904,5.010635,1,0,0,2.7581,3,0.1343,LESS
14,47,50,3,97,47,50,3.850148,3.912023,0.0618754,7.762171,3.850148,3.912023,0,0,1,4.5608,3,0.2351,LESS
14,150,138,12,288,150,138,5.010635,4.927254,0.08338161,9.937889,5.010635,4.927254,0,1,0,7.6277,1,0.1341,LESS
14,100,114,14,214,100,114,4.60517,4.736198,0.1310283,9.341369,4.60517,4.736198,0,0,1,6.4426,1,0.1383,LESS
14,100,92,8,192,92,100,4.60517,4.521789,0.08338161,9.126959,4.521789,4.60517,1,1,1,4.5032,1,0.1509,LESS
14,100,116,16,216,100,116,4.60517,4.75359,0.14842,9.35876,4.60517,4.75359,0,0,1,2.5405,1,0.1501,LESS
14,42,50,8,92,42,50,3.73767,3.912023,0.1743534,7.649693,3.73767,3.912023,0,0,1,2.3354,4,0.2002,LESS
14,150,135,15,285,135,150,5.010635,4.905275,0.1053605,9.91591,4.905275,5.010635,1,1,1,4.9408,1,0.1744,LESS
14,150,159,9,309,150,159,5.010635,5.068904,0.05826891,10.07954,5.010635,5.068904,0,0,1,4.1735,1,0.1673,LESS
15,57,50,7,107,57,50,4.043051,3.912023,0.1310283,7.955074,4.043051,3.912023,0,1,0,1.6029,4,1.6554,LESS
15,88,100,12,188,88,100,4.477337,4.60517,0.1278334,9.082507,4.477337,4.60517,0,0,1,1.3696,3,1.5421,LESS
15,108,100,8,208,108,100,4.682131,4.60517,0.07696104,9.287301,4.682131,4.60517,0,1,0,1.3619,3,0.9492,LESS
15,126,150,24,276,126,150,4.836282,5.010635,0.1743534,9.846917,4.836282,5.010635,0,0,1,0.985,4,0.9487,LESS
15,114,100,14,214,114,100,4.736198,4.60517,0.1310283,9.341369,4.736198,4.60517,0,1,0,2.3829,3,1.0246,LESS
15,59,50,9,109,50,59,4.077537,3.912023,0.1655144,7.98956,3.912023,4.077537,1,1,1,2.6834,2,1.1128,LESS
15,100,96,4,196,100,96,4.60517,4.564348,0.04082199,9.169518,4.60517,4.564348,0,1,0,1.0957,3,0.8473,LESS
15,44,50,6,94,44,50,3.78419,3.912023,0.1278334,7.696213,3.78419,3.912023,0,0,1,1.5744,4,0.4031,LESS
15,50,54,4,104,50,54,3.912023,3.988984,0.07696104,7.901007,3.912023,3.988984,0,0,1,1.0743,4,0.4158,LESS
15,120,100,20,220,100,120,4.787492,4.60517,0.1823216,9.392662,4.60517,4.787492,1,1,1,3.6068,2,0.7134,LESS
15,59,50,9,109,59,50,4.077537,3.912023,0.1655144,7.98956,4.077537,3.912023,0,1,0,1.3379,4,0.6769,LESS
15,52,50,2,102,52,50,3.951244,3.912023,0.03922071,7.863267,3.951244,3.912023,0,1,0,1.1401,3,0.7624,LESS
15,50,57,7,107,50,57,3.912023,4.043051,0.1310283,7.955074,3.912023,4.043051,0,0,1,1.6546,4,0.6037,LESS
15,57,50,7,107,57,50,4.043051,3.912023,0.1310283,7.955074,4.043051,3.912023,0,1,0,1.6734,3,1.0237,LESS
15,86,100,14,186,86,100,4.454347,4.60517,0.1508229,9.059517,4.454347,4.60517,0,0,1,0.9474,4,0.4474,LESS
15,100,90,10,190,100,90,4.60517,4.49981,0.1053605,9.10498,4.60517,4.49981,0,1,0,1.2104,3,0.7672,LESS
15,150,165,15,315,150,165,5.010635,5.105945,0.09531018,10.11658,5.010635,5.105945,0,0,1,0.9375,4,0.4279,LESS
15,50,56,6,106,50,56,3.912023,4.025352,0.1133287,7.937375,3.912023,4.025352,0,0,1,0.9107,4,0.3477,LESS
15,84,100,16,184,84,100,4.430817,4.60517,0.1743534,9.035987,4.430817,4.60517,0,0,1,1.0193,4,0.5194,LESS
15,162,150,12,312,162,150,5.087596,5.010635,0.07696104,10.09823,5.087596,5.010635,0,1,0,2.2185,3,0.7259,LESS
15,123,150,27,273,123,150,4.812184,5.010635,0.1984509,9.82282,4.812184,5.010635,0,0,1,0.9224,4,0.4404,LESS
15,177,150,27,327,177,150,5.17615,5.010635,0.1655144,10.18679,5.17615,5.010635,0,1,0,2.9529,2,0.9514,LESS
15,100,82,18,182,100,82,4.60517,4.406719,0.1984509,9.011889,4.60517,4.406719,0,1,0,0.9595,3,0.9731,LESS
15,50,58,8,108,50,58,3.912023,4.060443,0.14842,7.972466,3.912023,4.060443,0,0,1,0.7871,4,0.8495,LESS
15,100,112,12,212,100,112,4.60517,4.718499,0.1133287,9.323669,4.60517,4.718499,0,0,1,0.8591,3,0.8658,LESS
15,47,50,3,97,47,50,3.850148,3.912023,0.0618754,7.762171,3.850148,3.912023,0,0,1,0.8796,4,0.6005,LESS
15,100,98,2,198,100,98,4.60517,4.584967,0.02020271,9.190138,4.60517,4.584967,0,1,0,1.4363,3,0.4671,LESS
15,47,50,3,97,47,50,3.850148,3.912023,0.0618754,7.762171,3.850148,3.912023,0,0,1,0.9765,4,0.6957,LESS
15,150,171,21,321,150,171,5.010635,5.141664,0.1310283,10.1523,5.010635,5.141664,0,0,1,1.0156,3,0.5118,LESS
15,100,98,2,198,100,98,4.60517,4.584967,0.02020271,9.190138,4.60517,4.584967,0,1,0,0.9962,3,0.5395,LESS
15,45,50,5,95,45,50,3.806662,3.912023,0.1053605,7.718685,3.806662,3.912023,0,0,1,0.9211,3,0.7653,LESS
15,50,54,4,104,50,54,3.912023,3.988984,0.07696104,7.901007,3.912023,3.988984,0,0,1,0.8302,4,0.7671,LESS
15,150,168,18,318,150,168,5.010635,5.123964,0.1133287,10.1346,5.010635,5.123964,0,0,1,1.1651,3,0.8401,LESS
15,171,150,21,321,150,171,5.141664,5.010635,0.1310283,10.1523,5.010635,5.141664,1,1,1,1.7853,3,0.7247,LESS
15,90,100,10,190,90,100,4.49981,4.60517,0.1053605,9.10498,4.49981,4.60517,0,0,1,0.833,3,0.3462,LESS
15,100,102,2,202,100,102,4.60517,4.624973,0.01980263,9.230143,4.60517,4.624973,0,0,1,1.0132,3,0.3396,LESS
15,114,100,14,214,114,100,4.736198,4.60517,0.1310283,9.341369,4.736198,4.60517,0,1,0,0.7659,4,0.7866,LESS
15,150,132,18,282,132,150,5.010635,4.882802,0.1278334,9.893437,4.882802,5.010635,1,1,1,1.8308,3,0.6914,LESS
15,100,116,16,216,100,116,4.60517,4.75359,0.14842,9.35876,4.60517,4.75359,0,0,1,1.191,3,0.4332,LESS
15,150,177,27,327,150,177,5.010635,5.17615,0.1655144,10.18679,5.010635,5.17615,0,0,1,1.005,3,0.4382,LESS
15,43,50,7,93,43,50,3.7612,3.912023,0.1508229,7.673223,3.7612,3.912023,0,0,1,0.8058,4,0.7707,LESS
15,150,177,27,327,150,177,5.010635,5.17615,0.1655144,10.18679,5.010635,5.17615,0,0,1,1.0043,4,0.4327,LESS
15,50,53,3,103,50,53,3.912023,3.970292,0.05826891,7.882315,3.912023,3.970292,0,0,1,3.0975,4,0.839,LESS
15,50,41,9,91,50,41,3.912023,3.713572,0.1984509,7.625595,3.912023,3.713572,0,1,0,0.7913,4,0.5021,LESS
15,165,150,15,315,150,165,5.105945,5.010635,0.09531018,10.11658,5.010635,5.105945,1,1,1,2.1374,3,0.4964,LESS
15,100,86,14,186,86,100,4.60517,4.454347,0.1508229,9.059517,4.454347,4.60517,1,1,1,1.6956,2,0.7727,LESS
15,150,168,18,318,150,168,5.010635,5.123964,0.1133287,10.1346,5.010635,5.123964,0,0,1,1.1477,3,0.5044,LESS
15,40,50,10,90,40,50,3.688879,3.912023,0.2231436,7.600902,3.688879,3.912023,0,0,1,0.8061,4,1.1963,LESS
15,141,150,9,291,141,150,4.94876,5.010635,0.0618754,9.959395,4.94876,5.010635,0,0,1,1.0729,3,0.3327,LESS
15,48,50,2,98,48,50,3.871201,3.912023,0.04082199,7.783224,3.871201,3.912023,0,0,1,1.129,4,0.436,LESS
15,150,156,6,306,150,156,5.010635,5.049856,0.03922071,10.06049,5.010635,5.049856,0,0,1,1.2235,2,3.7882,LESS
15,49,50,1,99,49,50,3.89182,3.912023,0.02020271,7.803843,3.89182,3.912023,0,0,1,1.4862,3,0.2355,LESS
15,102,100,2,202,102,100,4.624973,4.60517,0.01980263,9.230143,4.624973,4.60517,0,1,0,0.8364,3,0.3553,LESS
15,80,100,20,180,80,100,4.382027,4.60517,0.2231436,8.987197,4.382027,4.60517,0,0,1,0.8443,3,0.5065,LESS
15,98,100,2,198,98,100,4.584967,4.60517,0.02020271,9.190138,4.584967,4.60517,0,0,1,1.1472,3,0.4211,LESS
15,82,100,18,182,82,100,4.406719,4.60517,0.1984509,9.011889,4.406719,4.60517,0,0,1,1.1559,4,0.2757,LESS
15,50,49,1,99,50,49,3.912023,3.89182,0.02020271,7.803843,3.912023,3.89182,0,1,0,0.7954,3,0.8416,LESS
15,100,116,16,216,100,116,4.60517,4.75359,0.14842,9.35876,4.60517,4.75359,0,0,1,1.0385,3,0.4997,LESS
15,150,180,30,330,150,180,5.010635,5.192957,0.1823216,10.20359,5.010635,5.192957,0,0,1,1.0072,4,0.6711,LESS
15,50,48,2,98,50,48,3.912023,3.871201,0.04082199,7.783224,3.912023,3.871201,0,1,0,1.5421,3,0.4278,LESS
15,108,100,8,208,100,108,4.682131,4.60517,0.07696104,9.287301,4.60517,4.682131,1,1,1,1.4819,2,1.4311,LESS
15,135,150,15,285,135,150,4.905275,5.010635,0.1053605,9.91591,4.905275,5.010635,0,0,1,1.171,3,0.3513,LESS
15,43,50,7,93,43,50,3.7612,3.912023,0.1508229,7.673223,3.7612,3.912023,0,0,1,3.2835,2,0.8571,LESS
15,54,50,4,104,50,54,3.988984,3.912023,0.07696104,7.901007,3.912023,3.988984,1,1,1,2.6207,2,0.4115,LESS
15,180,150,30,330,150,180,5.192957,5.010635,0.1823216,10.20359,5.010635,5.192957,1,1,1,1.374,3,0.6704,LESS
15,54,50,4,104,50,54,3.988984,3.912023,0.07696104,7.901007,3.912023,3.988984,1,1,1,2.0668,2,0.5719,LESS
15,112,100,12,212,100,112,4.718499,4.60517,0.1133287,9.323669,4.60517,4.718499,1,1,1,1.6739,2,0.782,LESS
15,51,50,1,101,51,50,3.931826,3.912023,0.01980263,7.843849,3.931826,3.912023,0,1,0,1.0447,1,3.3476,LESS
15,50,58,8,108,58,50,3.912023,4.060443,0.14842,7.972466,4.060443,3.912023,1,0,0,1.716,2,1.5906,LESS
15,150,162,12,312,150,162,5.010635,5.087596,0.07696104,10.09823,5.010635,5.087596,0,0,1,0.9519,3,0.6206,LESS
15,55,50,5,105,50,55,4.007333,3.912023,0.09531018,7.919356,3.912023,4.007333,1,1,1,1.8526,3,0.6104,LESS
15,56,50,6,106,56,50,4.025352,3.912023,0.1133287,7.937375,4.025352,3.912023,0,1,0,1.4019,2,0.3477,LESS
15,150,123,27,273,123,150,5.010635,4.812184,0.1984509,9.82282,4.812184,5.010635,1,1,1,1.4097,2,1.0446,LESS
15,100,86,14,186,86,100,4.60517,4.454347,0.1508229,9.059517,4.454347,4.60517,1,1,1,1.1038,3,0.4174,LESS
15,150,129,21,279,129,150,5.010635,4.859812,0.1508229,9.870448,4.859812,5.010635,1,1,1,1.4119,3,0.5183,LESS
15,41,50,9,91,41,50,3.713572,3.912023,0.1984509,7.625595,3.713572,3.912023,0,0,1,1.8994,1,0.938,LESS
15,129,150,21,279,129,150,4.859812,5.010635,0.1508229,9.870448,4.859812,5.010635,0,0,1,1.2478,2,0.3429,LESS
15,120,150,30,270,120,150,4.787492,5.010635,0.2231436,9.798127,4.787492,5.010635,0,0,1,1.0619,3,0.4164,LESS
15,100,120,20,220,100,120,4.60517,4.787492,0.1823216,9.392662,4.60517,4.787492,0,0,1,1.0266,3,0.419,LESS
15,55,50,5,105,50,55,4.007333,3.912023,0.09531018,7.919356,3.912023,4.007333,1,1,1,1.911,2,0.9478,LESS
15,50,47,3,97,47,50,3.912023,3.850148,0.0618754,7.762171,3.850148,3.912023,1,1,1,1.3882,3,0.6059,LESS
15,123,150,27,273,123,150,4.812184,5.010635,0.1984509,9.82282,4.812184,5.010635,0,0,1,0.9887,3,0.5927,LESS
15,100,114,14,214,100,114,4.60517,4.736198,0.1310283,9.341369,4.60517,4.736198,0,0,1,1.1848,2,0.692,LESS
15,110,100,10,210,100,110,4.70048,4.60517,0.09531018,9.305651,4.60517,4.70048,1,1,1,1.5982,1,2.0678,LESS
15,100,118,18,218,100,118,4.60517,4.770685,0.1655144,9.375855,4.60517,4.770685,0,0,1,0.9518,2,0.3439,LESS
15,50,51,1,101,50,51,3.912023,3.931826,0.01980263,7.843849,3.912023,3.931826,0,0,1,1.1361,3,0.8442,LESS
15,100,84,16,184,84,100,4.60517,4.430817,0.1743534,9.035987,4.430817,4.60517,1,1,1,1.3281,2,1.8891,LESS
15,96,100,4,196,96,100,4.564348,4.60517,0.04082199,9.169518,4.564348,4.60517,0,0,1,1.2079,3,0.422,LESS
15,100,120,20,220,100,120,4.60517,4.787492,0.1823216,9.392662,4.60517,4.787492,0,0,1,0.9448,2,0.3693,LESS
15,150,174,24,324,150,174,5.010635,5.159055,0.14842,10.16969,5.010635,5.159055,0,0,1,1.1063,4,0.7673,LESS
15,180,150,30,330,150,180,5.192957,5.010635,0.1823216,10.20359,5.010635,5.192957,1,1,1,1.5267,3,0.5056,LESS
15,150,147,3,297,150,147,5.010635,4.990433,0.02020271,10.00107,5.010635,4.990433,0,1,0,1.495,2,0.3378,LESS
15,100,94,6,194,100,94,4.60517,4.543295,0.0618754,9.148465,4.60517,4.543295,0,1,0,1.097,2,0.3406,LESS
15,132,150,18,282,132,150,4.882802,5.010635,0.1278334,9.893437,4.882802,5.010635,0,0,1,1.1717,2,1.2273,LESS
15,100,84,16,184,84,100,4.60517,4.430817,0.1743534,9.035987,4.430817,4.60517,1,1,1,1.2363,3,1.9586,LESS
15,150,129,21,279,150,129,5.010635,4.859812,0.1508229,9.870448,5.010635,4.859812,0,1,0,1.3389,3,0.3335,LESS
15,50,46,4,96,50,46,3.912023,3.828641,0.08338161,7.740664,3.912023,3.828641,0,1,0,1.3113,3,0.6656,LESS
15,100,94,6,194,100,94,4.60517,4.543295,0.0618754,9.148465,4.60517,4.543295,0,1,0,1.1821,2,0.3541,LESS
15,150,120,30,270,120,150,5.010635,4.787492,0.2231436,9.798127,4.787492,5.010635,1,1,1,1.1997,3,0.8433,LESS
15,100,112,12,212,100,112,4.60517,4.718499,0.1133287,9.323669,4.60517,4.718499,0,0,1,1.1516,2,0.5719,LESS
15,150,138,12,288,138,150,5.010635,4.927254,0.08338161,9.937889,4.927254,5.010635,1,1,1,1.0912,3,1.1861,LESS
15,174,150,24,324,150,174,5.159055,5.010635,0.14842,10.16969,5.010635,5.159055,1,1,1,1.4433,3,0.5111,LESS
15,150,132,18,282,132,150,5.010635,4.882802,0.1278334,9.893437,4.882802,5.010635,1,1,1,1.1711,3,0.9853,LESS
15,46,50,4,96,46,50,3.828641,3.912023,0.08338161,7.740664,3.828641,3.912023,0,0,1,1.0024,2,0.2546,LESS
15,50,52,2,102,50,52,3.912023,3.951244,0.03922071,7.863267,3.912023,3.951244,0,0,1,1.0817,2,0.25,LESS
15,82,100,18,182,82,100,4.406719,4.60517,0.1984509,9.011889,4.406719,4.60517,0,0,1,0.9541,3,0.5225,LESS
15,53,50,3,103,50,53,3.970292,3.912023,0.05826891,7.882315,3.912023,3.970292,1,1,1,1.5006,3,0.7138,LESS
15,110,100,10,210,100,110,4.70048,4.60517,0.09531018,9.305651,4.60517,4.70048,1,1,1,1.7927,3,0.6185,LESS
15,50,52,2,102,52,50,3.912023,3.951244,0.03922071,7.863267,3.951244,3.912023,1,0,0,1.3391,3,1.6141,LESS
15,100,102,2,202,100,102,4.60517,4.624973,0.01980263,9.230143,4.60517,4.624973,0,0,1,1.2851,2,0.3529,LESS
15,168,150,18,318,168,150,5.123964,5.010635,0.1133287,10.1346,5.123964,5.010635,0,1,0,3.2121,1,1.0368,LESS
15,50,59,9,109,50,59,3.912023,4.077537,0.1655144,7.98956,3.912023,4.077537,0,0,1,1.3336,3,0.6789,LESS
15,156,150,6,306,150,156,5.049856,5.010635,0.03922071,10.06049,5.010635,5.049856,1,1,1,1.076,3,0.4059,LESS
15,50,44,6,94,44,50,3.912023,3.78419,0.1278334,7.696213,3.78419,3.912023,1,1,1,1.4078,2,1.6233,LESS
15,51,50,1,101,51,50,3.931826,3.912023,0.01980263,7.843849,3.931826,3.912023,0,1,0,5.7291,3,0.4363,LESS
15,58,50,8,108,50,58,4.060443,3.912023,0.14842,7.972466,3.912023,4.060443,1,1,1,1.9051,4,1.0981,LESS
15,150,174,24,324,150,174,5.010635,5.159055,0.14842,10.16969,5.010635,5.159055,0,0,1,0.9411,2,0.1824,LESS
15,49,50,1,99,49,50,3.89182,3.912023,0.02020271,7.803843,3.89182,3.912023,0,0,1,0.8758,3,0.2482,LESS
15,40,50,10,90,40,50,3.688879,3.912023,0.2231436,7.600902,3.688879,3.912023,0,0,1,0.916,3,0.34,LESS
15,118,100,18,218,100,118,4.770685,4.60517,0.1655144,9.375855,4.60517,4.770685,1,1,1,1.3157,2,0.561,LESS
15,52,50,2,102,52,50,3.951244,3.912023,0.03922071,7.863267,3.951244,3.912023,0,1,0,1.3835,3,1.1059,LESS
15,126,150,24,276,126,150,4.836282,5.010635,0.1743534,9.846917,4.836282,5.010635,0,0,1,1.1763,2,0.5833,LESS
15,100,110,10,210,100,110,4.60517,4.70048,0.09531018,9.305651,4.60517,4.70048,0,0,1,0.8465,2,1.3718,LESS
15,116,100,16,216,116,100,4.75359,4.60517,0.14842,9.35876,4.75359,4.60517,0,1,0,1.443,3,0.1879,LESS
15,94,100,6,194,94,100,4.543295,4.60517,0.0618754,9.148465,4.543295,4.60517,0,0,1,1.0988,2,0.2463,LESS
15,156,150,6,306,156,150,5.049856,5.010635,0.03922071,10.06049,5.049856,5.010635,0,1,0,1.1732,2,0.5062,LESS
15,150,165,15,315,150,165,5.010635,5.105945,0.09531018,10.11658,5.010635,5.105945,0,0,1,1.2091,3,0.5034,LESS
15,100,114,14,214,100,114,4.60517,4.736198,0.1310283,9.341369,4.60517,4.736198,0,0,1,2.3272,3,0.5834,LESS
15,42,50,8,92,42,50,3.73767,3.912023,0.1743534,7.649693,3.73767,3.912023,0,0,1,1.0318,2,0.5792,LESS
15,104,100,4,204,104,100,4.644391,4.60517,0.03922071,9.249561,4.644391,4.60517,0,1,0,0.9386,2,0.3432,LESS
15,100,108,8,208,100,108,4.60517,4.682131,0.07696104,9.287301,4.60517,4.682131,0,0,1,1.0997,1,1.7482,LESS
15,100,80,20,180,100,80,4.60517,4.382027,0.2231436,8.987197,4.60517,4.382027,0,1,0,1.0249,2,0.4459,LESS
15,144,150,6,294,144,150,4.969813,5.010635,0.04082199,9.980449,4.969813,5.010635,0,0,1,0.9982,2,0.3228,LESS
15,120,100,20,220,100,120,4.787492,4.60517,0.1823216,9.392662,4.60517,4.787492,1,1,1,1.952,1,1.0269,LESS
15,50,55,5,105,50,55,3.912023,4.007333,0.09531018,7.919356,3.912023,4.007333,0,0,1,1.7751,3,0.7489,LESS
15,100,110,10,210,100,110,4.60517,4.70048,0.09531018,9.305651,4.60517,4.70048,0,0,1,1.0265,2,0.6685,LESS
15,88,100,12,188,88,100,4.477337,4.60517,0.1278334,9.082507,4.477337,4.60517,0,0,1,0.9095,3,0.2517,LESS
15,150,135,15,285,135,150,5.010635,4.905275,0.1053605,9.91591,4.905275,5.010635,1,1,1,1.1934,2,0.4867,LESS
15,60,50,10,110,50,60,4.094345,3.912023,0.1823216,8.006368,3.912023,4.094345,1,1,1,1.2556,3,1.0227,LESS
15,100,82,18,182,82,100,4.60517,4.406719,0.1984509,9.011889,4.406719,4.60517,1,1,1,1.4518,2,0.5273,LESS
15,50,41,9,91,41,50,3.912023,3.713572,0.1984509,7.625595,3.713572,3.912023,1,1,1,1.5485,4,1.1884,LESS
15,102,100,2,202,102,100,4.624973,4.60517,0.01980263,9.230143,4.624973,4.60517,0,1,0,1.1338,3,0.4151,LESS
15,159,150,9,309,159,150,5.068904,5.010635,0.05826891,10.07954,5.068904,5.010635,0,1,0,1.5971,2,0.4425,LESS
15,42,50,8,92,42,50,3.73767,3.912023,0.1743534,7.649693,3.73767,3.912023,0,0,1,0.9698,3,0.4227,LESS
15,150,126,24,276,126,150,5.010635,4.836282,0.1743534,9.846917,4.836282,5.010635,1,1,1,4.5077,1,0.3558,LESS
15,100,108,8,208,100,108,4.60517,4.682131,0.07696104,9.287301,4.60517,4.682131,0,0,1,0.9447,2,0.3292,LESS
15,112,100,12,212,112,100,4.718499,4.60517,0.1133287,9.323669,4.718499,4.60517,0,1,0,2.1987,1,0.7727,LESS
15,100,80,20,180,80,100,4.60517,4.382027,0.2231436,8.987197,4.382027,4.60517,1,1,1,2.0346,1,0.5876,LESS
15,50,55,5,105,50,55,3.912023,4.007333,0.09531018,7.919356,3.912023,4.007333,0,0,1,0.897,3,0.5208,LESS
15,48,50,2,98,48,50,3.871201,3.912023,0.04082199,7.783224,3.871201,3.912023,0,0,1,1.0489,3,0.6878,LESS
15,50,40,10,90,40,50,3.912023,3.688879,0.2231436,7.600902,3.688879,3.912023,1,1,1,1.0608,2,0.6879,LESS
15,84,100,16,184,84,100,4.430817,4.60517,0.1743534,9.035987,4.430817,4.60517,0,0,1,1.1946,2,1.0294,LESS
15,100,90,10,190,100,90,4.60517,4.49981,0.1053605,9.10498,4.60517,4.49981,0,1,0,1.1305,2,0.4171,LESS
15,150,159,9,309,150,159,5.010635,5.068904,0.05826891,10.07954,5.010635,5.068904,0,0,1,1.2178,2,0.4234,LESS
15,50,57,7,107,50,57,3.912023,4.043051,0.1310283,7.955074,3.912023,4.043051,0,0,1,1.1388,3,0.9283,LESS
15,46,50,4,96,46,50,3.828641,3.912023,0.08338161,7.740664,3.828641,3.912023,0,0,1,1.1339,1,1.8628,LESS
15,116,100,16,216,116,100,4.75359,4.60517,0.14842,9.35876,4.75359,4.60517,0,1,0,1.0447,2,0.5068,LESS
15,150,120,30,270,150,120,5.010635,4.787492,0.2231436,9.798127,5.010635,4.787492,0,1,0,0.977,1,0.6904,LESS
15,150,180,30,330,150,180,5.010635,5.192957,0.1823216,10.20359,5.010635,5.192957,0,0,1,1.0323,2,0.3377,LESS
15,118,100,18,218,118,100,4.770685,4.60517,0.1655144,9.375855,4.770685,4.60517,0,1,0,1.0473,2,0.771,LESS
15,100,118,18,218,100,118,4.60517,4.770685,0.1655144,9.375855,4.60517,4.770685,0,0,1,0.971,2,0.9504,LESS
15,150,162,12,312,150,162,5.010635,5.087596,0.07696104,10.09823,5.010635,5.087596,0,0,1,1.259,2,0.4249,LESS
15,171,150,21,321,150,171,5.141664,5.010635,0.1310283,10.1523,5.010635,5.141664,1,1,1,1.1385,1,0.5079,LESS
15,150,144,6,294,144,150,5.010635,4.969813,0.04082199,9.980449,4.969813,5.010635,1,1,1,2.4345,1,0.8924,LESS
15,129,150,21,279,129,150,4.859812,5.010635,0.1508229,9.870448,4.859812,5.010635,0,0,1,0.9932,2,0.2696,LESS
15,50,60,10,110,50,60,3.912023,4.094345,0.1823216,8.006368,3.912023,4.094345,0,0,1,0.8894,4,0.7703,LESS
15,90,100,10,190,90,100,4.49981,4.60517,0.1053605,9.10498,4.49981,4.60517,0,0,1,1.4785,3,0.438,LESS
15,50,59,9,109,50,59,3.912023,4.077537,0.1655144,7.98956,3.912023,4.077537,0,0,1,0.9023,4,0.5038,LESS
15,159,150,9,309,150,159,5.068904,5.010635,0.05826891,10.07954,5.010635,5.068904,1,1,1,1.5263,2,0.524,LESS
15,150,171,21,321,150,171,5.010635,5.141664,0.1310283,10.1523,5.010635,5.141664,0,0,1,0.9971,2,0.4383,LESS
15,150,153,3,303,150,153,5.010635,5.030438,0.01980263,10.04107,5.010635,5.030438,0,0,1,1.0214,2,0.4999,LESS
15,50,44,6,94,50,44,3.912023,3.78419,0.1278334,7.696213,3.912023,3.78419,0,1,0,0.9632,2,0.5107,LESS
15,50,45,5,95,45,50,3.912023,3.806662,0.1053605,7.718685,3.806662,3.912023,1,1,1,1.4003,3,0.6734,LESS
15,150,138,12,288,138,150,5.010635,4.927254,0.08338161,9.937889,4.927254,5.010635,1,1,1,1.2605,2,0.4155,LESS
15,98,100,2,198,98,100,4.584967,4.60517,0.02020271,9.190138,4.584967,4.60517,0,0,1,1.1808,1,0.8864,LESS
15,50,51,1,101,50,51,3.912023,3.931826,0.01980263,7.843849,3.912023,3.931826,0,0,1,1.031,2,0.1716,LESS
15,50,53,3,103,50,53,3.912023,3.970292,0.05826891,7.882315,3.912023,3.970292,0,0,1,1.4187,3,0.419,LESS
15,44,50,6,94,50,44,3.78419,3.912023,0.1278334,7.696213,3.912023,3.78419,1,0,0,1.7085,3,1.2027,LESS
15,135,150,15,285,135,150,4.905275,5.010635,0.1053605,9.91591,4.905275,5.010635,0,0,1,1.1658,2,0.3372,LESS
15,80,100,20,180,80,100,4.382027,4.60517,0.2231436,8.987197,4.382027,4.60517,0,0,1,0.9362,3,0.3424,LESS
15,150,141,9,291,141,150,5.010635,4.94876,0.0618754,9.959395,4.94876,5.010635,1,1,1,2.8437,2,0.5048,LESS
15,150,153,3,303,150,153,5.010635,5.030438,0.01980263,10.04107,5.010635,5.030438,0,0,1,1.2554,3,0.6623,LESS
15,60,50,10,110,50,60,4.094345,3.912023,0.1823216,8.006368,3.912023,4.094345,1,1,1,1.3917,3,1.2792,LESS
15,92,100,8,192,100,92,4.521789,4.60517,0.08338161,9.126959,4.60517,4.521789,1,0,0,1.3704,2,0.7094,LESS
15,100,106,6,206,100,106,4.60517,4.663439,0.05826891,9.268609,4.60517,4.663439,0,0,1,1.3355,2,0.6048,LESS
15,177,150,27,327,150,177,5.17615,5.010635,0.1655144,10.18679,5.010635,5.17615,1,1,1,2.394,3,1.2769,LESS
15,50,47,3,97,50,47,3.912023,3.850148,0.0618754,7.762171,3.912023,3.850148,0,1,0,1.2991,4,0.3478,LESS
15,50,45,5,95,50,45,3.912023,3.806662,0.1053605,7.718685,3.912023,3.806662,0,1,0,1.3935,4,0.4308,LESS
15,153,150,3,303,150,153,5.030438,5.010635,0.01980263,10.04107,5.010635,5.030438,1,1,1,1.5538,3,0.7809,LESS
15,138,150,12,288,138,150,4.927254,5.010635,0.08338161,9.937889,4.927254,5.010635,0,0,1,1.0607,3,0.5005,LESS
15,138,150,12,288,150,138,4.927254,5.010635,0.08338161,9.937889,5.010635,4.927254,1,0,0,2.6058,2,1.5374,LESS
15,153,150,3,303,150,153,5.030438,5.010635,0.01980263,10.04107,5.010635,5.030438,1,1,1,2.2188,2,1.0175,LESS
15,150,135,15,285,135,150,5.010635,4.905275,0.1053605,9.91591,4.905275,5.010635,1,1,1,1.7232,3,0.5061,LESS
15,120,150,30,270,120,150,4.787492,5.010635,0.2231436,9.798127,4.787492,5.010635,0,0,1,0.8966,4,0.4365,LESS
15,100,96,4,196,96,100,4.60517,4.564348,0.04082199,9.169518,4.564348,4.60517,1,1,1,1.5237,1,1.8018,LESS
15,50,48,2,98,50,48,3.912023,3.871201,0.04082199,7.783224,3.912023,3.871201,0,1,0,2.1578,3,0.8597,LESS
15,100,88,12,188,100,88,4.60517,4.477337,0.1278334,9.082507,4.60517,4.477337,0,1,0,1.0229,2,0.5048,LESS
15,147,150,3,297,147,150,4.990433,5.010635,0.02020271,10.00107,4.990433,5.010635,0,0,1,1.5027,3,0.3576,LESS
15,150,141,9,291,141,150,5.010635,4.94876,0.0618754,9.959395,4.94876,5.010635,1,1,1,1.4037,2,0.5113,LESS
15,144,150,6,294,150,144,4.969813,5.010635,0.04082199,9.980449,5.010635,4.969813,1,0,0,1.6968,1,0.4962,LESS
15,100,104,4,204,100,104,4.60517,4.644391,0.03922071,9.249561,4.60517,4.644391,0,0,1,2.0546,1,2.3118,LESS
15,147,150,3,297,147,150,4.990433,5.010635,0.02020271,10.00107,4.990433,5.010635,0,0,1,0.8876,1,0.4359,LESS
15,96,100,4,196,96,100,4.564348,4.60517,0.04082199,9.169518,4.564348,4.60517,0,0,1,1.0405,4,0.5409,LESS
15,92,100,8,192,92,100,4.521789,4.60517,0.08338161,9.126959,4.521789,4.60517,0,0,1,2.5105,3,0.4426,LESS
15,50,42,8,92,42,50,3.912023,3.73767,0.1743534,7.649693,3.73767,3.912023,1,1,1,1.2167,3,0.936,LESS
15,150,147,3,297,150,147,5.010635,4.990433,0.02020271,10.00107,5.010635,4.990433,0,1,0,0.9532,2,0.8309,LESS
15,50,42,8,92,42,50,3.912023,3.73767,0.1743534,7.649693,3.73767,3.912023,1,1,1,1.4855,4,0.946,LESS
15,150,159,9,309,150,159,5.010635,5.068904,0.05826891,10.07954,5.010635,5.068904,0,0,1,1.362,2,0.3255,LESS
15,50,60,10,110,50,60,3.912023,4.094345,0.1823216,8.006368,3.912023,4.094345,0,0,1,1.2452,4,1.3809,LESS
15,45,50,5,95,45,50,3.806662,3.912023,0.1053605,7.718685,3.806662,3.912023,0,0,1,1.0707,3,0.3413,LESS
15,86,100,14,186,86,100,4.454347,4.60517,0.1508229,9.059517,4.454347,4.60517,0,0,1,1.1794,2,0.5081,LESS
15,141,150,9,291,141,150,4.94876,5.010635,0.0618754,9.959395,4.94876,5.010635,0,0,1,1.4273,2,0.3342,LESS
15,50,43,7,93,50,43,3.912023,3.7612,0.1508229,7.673223,3.912023,3.7612,0,1,0,1.1637,1,0.5895,LESS
15,53,50,3,103,53,50,3.970292,3.912023,0.05826891,7.882315,3.970292,3.912023,0,1,0,1.3927,1,0.4179,LESS
15,100,92,8,192,92,100,4.60517,4.521789,0.08338161,9.126959,4.521789,4.60517,1,1,1,2.5185,1,0.4756,LESS
15,50,43,7,93,50,43,3.912023,3.7612,0.1508229,7.673223,3.912023,3.7612,0,1,0,1.0005,3,0.6928,LESS
15,50,49,1,99,50,49,3.912023,3.89182,0.02020271,7.803843,3.912023,3.89182,0,1,0,1.3982,3,0.6077,LESS
15,100,106,6,206,100,106,4.60517,4.663439,0.05826891,9.268609,4.60517,4.663439,0,0,1,0.9323,2,0.165,LESS
15,150,156,6,306,156,150,5.010635,5.049856,0.03922071,10.06049,5.049856,5.010635,1,0,0,1.2976,1,0.8353,LESS
15,132,150,18,282,132,150,4.882802,5.010635,0.1278334,9.893437,4.882802,5.010635,0,0,1,1.2063,2,0.5048,LESS
15,168,150,18,318,150,168,5.123964,5.010635,0.1133287,10.1346,5.010635,5.123964,1,1,1,1.3134,2,0.4922,LESS
15,162,150,12,312,150,162,5.087596,5.010635,0.07696104,10.09823,5.010635,5.087596,1,1,1,1.2027,1,0.6542,LESS
15,100,92,8,192,100,92,4.60517,4.521789,0.08338161,9.126959,4.60517,4.521789,0,1,0,1.1606,2,1.0729,LESS
15,56,50,6,106,56,50,4.025352,3.912023,0.1133287,7.937375,4.025352,3.912023,0,1,0,1.0009,2,0.5812,LESS
15,150,126,24,276,126,150,5.010635,4.836282,0.1743534,9.846917,4.836282,5.010635,1,1,1,1.8389,2,0.8961,LESS
15,50,46,4,96,50,46,3.912023,3.828641,0.08338161,7.740664,3.912023,3.828641,0,1,0,1.2279,3,0.5838,LESS
15,100,88,12,188,88,100,4.60517,4.477337,0.1278334,9.082507,4.477337,4.60517,1,1,1,1.5671,1,1.0635,LESS
15,94,100,6,194,94,100,4.543295,4.60517,0.0618754,9.148465,4.543295,4.60517,0,0,1,1.2749,1,0.3329,LESS
15,104,100,4,204,100,104,4.644391,4.60517,0.03922071,9.249561,4.60517,4.644391,1,1,1,1.5713,2,0.4802,LESS
15,50,56,6,106,50,56,3.912023,4.025352,0.1133287,7.937375,3.912023,4.025352,0,0,1,1.0488,1,0.6286,LESS
15,41,50,9,91,41,50,3.713572,3.912023,0.1984509,7.625595,3.713572,3.912023,0,0,1,0.739,3,0.5863,LESS
15,150,144,6,294,150,144,5.010635,4.969813,0.04082199,9.980449,5.010635,4.969813,0,1,0,1.3099,2,0.423,LESS
15,174,150,24,324,174,150,5.159055,5.010635,0.14842,10.16969,5.159055,5.010635,0,1,0,1.2273,4,1.4028,LESS
15,150,123,27,273,150,123,5.010635,4.812184,0.1984509,9.82282,5.010635,4.812184,0,1,0,1.5819,3,0.569,LESS
15,165,150,15,315,165,150,5.105945,5.010635,0.09531018,10.11658,5.105945,5.010635,0,1,0,1.1313,3,0.5769,LESS
15,100,104,4,204,100,104,4.60517,4.644391,0.03922071,9.249561,4.60517,4.644391,0,0,1,1.3984,2,0.4962,LESS
15,58,50,8,108,50,58,4.060443,3.912023,0.14842,7.972466,3.912023,4.060443,1,1,1,1.6016,2,0.7541,LESS
15,50,40,10,90,40,50,3.912023,3.688879,0.2231436,7.600902,3.688879,3.912023,1,1,1,1.6075,3,0.9774,LESS
15,106,100,6,206,100,106,4.663439,4.60517,0.05826891,9.268609,4.60517,4.663439,1,1,1,1.7322,2,0.744,LESS
15,106,100,6,206,100,106,4.663439,4.60517,0.05826891,9.268609,4.60517,4.663439,1,1,1,1.8799,2,0.5839,LESS
16,52,50,2,102,52,50,3.951244,3.912023,0.03922071,7.863267,3.951244,3.912023,0,0,1,1.5214,2,1.182,MORE
16,50,58,8,108,58,50,3.912023,4.060443,0.14842,7.972466,4.060443,3.912023,1,1,1,1.077,3,1.3765,MORE
16,47,50,3,97,50,47,3.850148,3.912023,0.0618754,7.762171,3.912023,3.850148,1,1,1,1.2943,2,0.959,MORE
16,100,90,10,190,100,90,4.60517,4.49981,0.1053605,9.10498,4.60517,4.49981,0,0,1,1.3823,3,1.037,MORE
16,156,150,6,306,156,150,5.049856,5.010635,0.03922071,10.06049,5.049856,5.010635,0,0,1,1.256,2,1.536,MORE
16,40,50,10,90,50,40,3.688879,3.912023,0.2231436,7.600902,3.912023,3.688879,1,1,1,1.1103,4,0.9855,MORE
16,118,100,18,218,100,118,4.770685,4.60517,0.1655144,9.375855,4.60517,4.770685,1,0,0,1.798,2,0.6352,MORE
16,51,50,1,101,50,51,3.931826,3.912023,0.01980263,7.843849,3.912023,3.931826,1,0,0,1.5698,3,0.4575,MORE
16,102,100,2,202,102,100,4.624973,4.60517,0.01980263,9.230143,4.624973,4.60517,0,0,1,1.5163,3,0.6742,MORE
16,100,108,8,208,108,100,4.60517,4.682131,0.07696104,9.287301,4.682131,4.60517,1,1,1,1.2263,2,1.2702,MORE
16,100,94,6,194,100,94,4.60517,4.543295,0.0618754,9.148465,4.60517,4.543295,0,0,1,1.5987,2,1.2057,MORE
16,135,150,15,285,150,135,4.905275,5.010635,0.1053605,9.91591,5.010635,4.905275,1,1,1,0.8684,4,1.0163,MORE
16,100,106,6,206,100,106,4.60517,4.663439,0.05826891,9.268609,4.60517,4.663439,0,1,0,1.7989,1,1.4677,MORE
16,150,141,9,291,150,141,5.010635,4.94876,0.0618754,9.959395,5.010635,4.94876,0,0,1,1.4308,3,0.7526,MORE
16,129,150,21,279,150,129,4.859812,5.010635,0.1508229,9.870448,5.010635,4.859812,1,1,1,1.259,3,0.7144,MORE
16,150,162,12,312,162,150,5.010635,5.087596,0.07696104,10.09823,5.087596,5.010635,1,1,1,0.9572,3,0.6735,MORE
16,150,153,3,303,153,150,5.010635,5.030438,0.01980263,10.04107,5.030438,5.010635,1,1,1,1.6895,2,0.4338,MORE
16,54,50,4,104,54,50,3.988984,3.912023,0.07696104,7.901007,3.988984,3.912023,0,0,1,1.3194,4,0.8202,MORE
16,100,106,6,206,106,100,4.60517,4.663439,0.05826891,9.268609,4.663439,4.60517,1,1,1,1.4124,1,0.8151,MORE
16,50,41,9,91,50,41,3.912023,3.713572,0.1984509,7.625595,3.912023,3.713572,0,0,1,1.2903,3,0.948,MORE
16,96,100,4,196,100,96,4.564348,4.60517,0.04082199,9.169518,4.60517,4.564348,1,1,1,1.351,2,0.9904,MORE
16,147,150,3,297,147,150,4.990433,5.010635,0.02020271,10.00107,4.990433,5.010635,0,1,0,1.3958,3,0.8938,MORE
16,156,150,6,306,150,156,5.049856,5.010635,0.03922071,10.06049,5.010635,5.049856,1,0,0,1.5983,1,0.9511,MORE
16,116,100,16,216,116,100,4.75359,4.60517,0.14842,9.35876,4.75359,4.60517,0,0,1,1.4495,2,0.7352,MORE
16,150,129,21,279,129,150,5.010635,4.859812,0.1508229,9.870448,4.859812,5.010635,1,0,0,1.1969,3,0.7302,MORE
16,50,43,7,93,50,43,3.912023,3.7612,0.1508229,7.673223,3.912023,3.7612,0,0,1,1.2257,3,0.8187,MORE
16,84,100,16,184,100,84,4.430817,4.60517,0.1743534,9.035987,4.60517,4.430817,1,1,1,1.2167,3,0.8071,MORE
16,53,50,3,103,53,50,3.970292,3.912023,0.05826891,7.882315,3.970292,3.912023,0,0,1,1.2652,3,0.5895,MORE
16,100,96,4,196,96,100,4.60517,4.564348,0.04082199,9.169518,4.564348,4.60517,1,0,0,1.2532,2,0.5492,MORE
16,94,100,6,194,94,100,4.543295,4.60517,0.0618754,9.148465,4.543295,4.60517,0,1,0,1.0682,3,0.7828,MORE
16,120,100,20,220,120,100,4.787492,4.60517,0.1823216,9.392662,4.787492,4.60517,0,0,1,1.5182,3,0.5722,MORE
16,46,50,4,96,50,46,3.828641,3.912023,0.08338161,7.740664,3.912023,3.828641,1,1,1,1.0609,4,0.8093,MORE
16,50,49,1,99,50,49,3.912023,3.89182,0.02020271,7.803843,3.912023,3.89182,0,0,1,1.1215,3,1.4012,MORE
16,123,150,27,273,150,123,4.812184,5.010635,0.1984509,9.82282,5.010635,4.812184,1,1,1,0.8291,4,0.8925,MORE
16,120,150,30,270,150,120,4.787492,5.010635,0.2231436,9.798127,5.010635,4.787492,1,1,1,1.3319,4,0.8184,MORE
16,47,50,3,97,47,50,3.850148,3.912023,0.0618754,7.762171,3.850148,3.912023,0,1,0,1.4946,3,0.4106,MORE
16,150,147,3,297,150,147,5.010635,4.990433,0.02020271,10.00107,5.010635,4.990433,0,0,1,1.3521,2,0.5491,MORE
16,150,171,21,321,171,150,5.010635,5.141664,0.1310283,10.1523,5.141664,5.010635,1,1,1,1.3863,2,0.6203,MORE
16,126,150,24,276,150,126,4.836282,5.010635,0.1743534,9.846917,5.010635,4.836282,1,1,1,1.3818,3,0.5663,MORE
16,51,50,1,101,51,50,3.931826,3.912023,0.01980263,7.843849,3.931826,3.912023,0,0,1,1.4268,3,0.6171,MORE
16,104,100,4,204,100,104,4.644391,4.60517,0.03922071,9.249561,4.60517,4.644391,1,0,0,0.8588,2,0.817,MORE
16,150,141,9,291,150,141,5.010635,4.94876,0.0618754,9.959395,5.010635,4.94876,0,0,1,1.1082,3,0.6494,MORE
16,49,50,1,99,50,49,3.89182,3.912023,0.02020271,7.803843,3.912023,3.89182,1,1,1,1.0122,4,0.551,MORE
16,50,46,4,96,50,46,3.912023,3.828641,0.08338161,7.740664,3.912023,3.828641,0,0,1,1.3822,2,0.7872,MORE
16,180,150,30,330,180,150,5.192957,5.010635,0.1823216,10.20359,5.192957,5.010635,0,0,1,1.2065,3,0.6854,MORE
16,50,43,7,93,43,50,3.912023,3.7612,0.1508229,7.673223,3.7612,3.912023,1,0,0,1.3139,2,0.471,MORE
16,108,100,8,208,108,100,4.682131,4.60517,0.07696104,9.287301,4.682131,4.60517,0,0,1,1.3839,1,0.7173,MORE
16,150,156,6,306,150,156,5.010635,5.049856,0.03922071,10.06049,5.010635,5.049856,0,1,0,1.6021,3,0.6053,MORE
16,41,50,9,91,50,41,3.713572,3.912023,0.1984509,7.625595,3.912023,3.713572,1,1,1,1.1888,3,0.6229,MORE
16,88,100,12,188,88,100,4.477337,4.60517,0.1278334,9.082507,4.477337,4.60517,0,1,0,1.4043,2,0.6527,MORE
16,100,112,12,212,112,100,4.60517,4.718499,0.1133287,9.323669,4.718499,4.60517,1,1,1,1.2615,3,0.6251,MORE
16,150,120,30,270,150,120,5.010635,4.787492,0.2231436,9.798127,5.010635,4.787492,0,0,1,1.2089,3,0.5684,MORE
16,50,48,2,98,50,48,3.912023,3.871201,0.04082199,7.783224,3.912023,3.871201,0,0,1,1.2985,2,0.4816,MORE
16,100,104,4,204,104,100,4.60517,4.644391,0.03922071,9.249561,4.644391,4.60517,1,1,1,1.2264,2,0.6664,MORE
16,58,50,8,108,58,50,4.060443,3.912023,0.14842,7.972466,4.060443,3.912023,0,0,1,1.3135,1,0.5175,MORE
16,50,49,1,99,49,50,3.912023,3.89182,0.02020271,7.803843,3.89182,3.912023,1,0,0,1.2294,2,0.892,MORE
16,92,100,8,192,100,92,4.521789,4.60517,0.08338161,9.126959,4.60517,4.521789,1,1,1,1.5309,2,0.7195,MORE
16,153,150,3,303,153,150,5.030438,5.010635,0.01980263,10.04107,5.030438,5.010635,0,0,1,1.4278,2,0.7038,MORE
16,135,150,15,285,150,135,4.905275,5.010635,0.1053605,9.91591,5.010635,4.905275,1,1,1,1.3332,3,0.6187,MORE
16,150,135,15,285,150,135,5.010635,4.905275,0.1053605,9.91591,5.010635,4.905275,0,0,1,1.0363,2,0.598,MORE
16,50,51,1,101,50,51,3.912023,3.931826,0.01980263,7.843849,3.912023,3.931826,0,1,0,1.3766,2,0.4986,MORE
16,50,52,2,102,52,50,3.912023,3.951244,0.03922071,7.863267,3.951244,3.912023,1,1,1,1.0154,3,0.7346,MORE
16,100,92,8,192,100,92,4.60517,4.521789,0.08338161,9.126959,4.60517,4.521789,0,0,1,1.3089,2,0.4323,MORE
16,42,50,8,92,42,50,3.73767,3.912023,0.1743534,7.649693,3.73767,3.912023,0,1,0,1.2329,2,0.4642,MORE
16,54,50,4,104,54,50,3.988984,3.912023,0.07696104,7.901007,3.988984,3.912023,0,0,1,1.1373,3,0.6663,MORE
16,50,57,7,107,57,50,3.912023,4.043051,0.1310283,7.955074,4.043051,3.912023,1,1,1,1.4158,2,0.4539,MORE
16,150,180,30,330,180,150,5.010635,5.192957,0.1823216,10.20359,5.192957,5.010635,1,1,1,1.3424,3,0.583,MORE
16,150,168,18,318,168,150,5.010635,5.123964,0.1133287,10.1346,5.123964,5.010635,1,1,1,1.3161,2,0.7357,MORE
16,100,82,18,182,100,82,4.60517,4.406719,0.1984509,9.011889,4.60517,4.406719,0,0,1,1.1339,3,0.5993,MORE
16,180,150,30,330,180,150,5.192957,5.010635,0.1823216,10.20359,5.192957,5.010635,0,0,1,1.5717,2,0.5398,MORE
16,100,84,16,184,100,84,4.60517,4.430817,0.1743534,9.035987,4.60517,4.430817,0,0,1,1.35,3,0.5731,MORE
16,50,42,8,92,50,42,3.912023,3.73767,0.1743534,7.649693,3.912023,3.73767,0,0,1,1.2211,3,0.65,MORE
16,150,138,12,288,150,138,5.010635,4.927254,0.08338161,9.937889,5.010635,4.927254,0,0,1,0.9039,3,0.6802,MORE
16,45,50,5,95,50,45,3.806662,3.912023,0.1053605,7.718685,3.912023,3.806662,1,1,1,1.4426,2,0.7339,MORE
16,50,40,10,90,50,40,3.912023,3.688879,0.2231436,7.600902,3.912023,3.688879,0,0,1,1.3131,4,1.3025,MORE
16,147,150,3,297,150,147,4.990433,5.010635,0.02020271,10.00107,5.010635,4.990433,1,1,1,1.4169,1,1.2348,MORE
16,50,53,3,103,50,53,3.912023,3.970292,0.05826891,7.882315,3.912023,3.970292,0,1,0,1.2811,2,0.569,MORE
16,150,174,24,324,174,150,5.010635,5.159055,0.14842,10.16969,5.159055,5.010635,1,1,1,1.2865,2,0.5328,MORE
16,90,100,10,190,100,90,4.49981,4.60517,0.1053605,9.10498,4.60517,4.49981,1,1,1,1.2291,2,0.7674,MORE
16,100,88,12,188,100,88,4.60517,4.477337,0.1278334,9.082507,4.60517,4.477337,0,0,1,1.02,2,0.4554,MORE
16,53,50,3,103,50,53,3.970292,3.912023,0.05826891,7.882315,3.912023,3.970292,1,0,0,0.6926,2,0.7837,MORE
16,48,50,2,98,50,48,3.871201,3.912023,0.04082199,7.783224,3.912023,3.871201,1,1,1,1.0728,3,0.7177,MORE
16,60,50,10,110,60,50,4.094345,3.912023,0.1823216,8.006368,4.094345,3.912023,0,0,1,1.0843,3,0.7831,MORE
16,114,100,14,214,114,100,4.736198,4.60517,0.1310283,9.341369,4.736198,4.60517,0,0,1,1.1748,3,0.6088,MORE
16,100,86,14,186,100,86,4.60517,4.454347,0.1508229,9.059517,4.60517,4.454347,0,0,1,1.3685,2,0.4724,MORE
16,104,100,4,204,104,100,4.644391,4.60517,0.03922071,9.249561,4.644391,4.60517,0,0,1,1.2681,3,0.4641,MORE
16,56,50,6,106,56,50,4.025352,3.912023,0.1133287,7.937375,4.025352,3.912023,0,0,1,1.3617,3,0.5352,MORE
16,50,59,9,109,59,50,3.912023,4.077537,0.1655144,7.98956,4.077537,3.912023,1,1,1,1.3228,4,0.6696,MORE
16,56,50,6,106,50,56,4.025352,3.912023,0.1133287,7.937375,3.912023,4.025352,1,0,0,1.3008,2,0.5862,MORE
16,59,50,9,109,59,50,4.077537,3.912023,0.1655144,7.98956,4.077537,3.912023,0,0,1,1.2516,3,0.5385,MORE
16,150,165,15,315,165,150,5.010635,5.105945,0.09531018,10.11658,5.105945,5.010635,1,1,1,0.8834,4,0.6655,MORE
16,150,144,6,294,150,144,5.010635,4.969813,0.04082199,9.980449,5.010635,4.969813,0,0,1,1.3529,3,0.8188,MORE
16,94,100,6,194,100,94,4.543295,4.60517,0.0618754,9.148465,4.60517,4.543295,1,1,1,1.1449,3,0.4996,MORE
16,88,100,12,188,100,88,4.477337,4.60517,0.1278334,9.082507,4.60517,4.477337,1,1,1,1.3215,4,0.5498,MORE
16,57,50,7,107,57,50,4.043051,3.912023,0.1310283,7.955074,4.043051,3.912023,0,0,1,1.2812,3,0.5308,MORE
16,162,150,12,312,150,162,5.087596,5.010635,0.07696104,10.09823,5.010635,5.087596,1,0,0,1.2183,3,0.6011,MORE
16,138,150,12,288,150,138,4.927254,5.010635,0.08338161,9.937889,5.010635,4.927254,1,1,1,1.1744,3,0.6662,MORE
16,114,100,14,214,100,114,4.736198,4.60517,0.1310283,9.341369,4.60517,4.736198,1,0,0,1.181,3,0.5496,MORE
16,100,86,14,186,100,86,4.60517,4.454347,0.1508229,9.059517,4.60517,4.454347,0,0,1,1.2233,2,0.498,MORE
16,100,114,14,214,114,100,4.60517,4.736198,0.1310283,9.341369,4.736198,4.60517,1,1,1,1.3005,3,0.5137,MORE
16,153,150,3,303,150,153,5.030438,5.010635,0.01980263,10.04107,5.010635,5.030438,1,0,0,1.1455,3,0.5182,MORE
16,100,96,4,196,96,100,4.60517,4.564348,0.04082199,9.169518,4.564348,4.60517,1,0,0,1.3583,2,0.6017,MORE
16,100,88,12,188,88,100,4.60517,4.477337,0.1278334,9.082507,4.477337,4.60517,1,0,0,1.31,2,0.4167,MORE
16,138,150,12,288,138,150,4.927254,5.010635,0.08338161,9.937889,4.927254,5.010635,0,1,0,1.4886,2,0.5826,MORE
16,100,92,8,192,100,92,4.60517,4.521789,0.08338161,9.126959,4.60517,4.521789,0,0,1,1.5803,2,0.4726,MORE
16,50,57,7,107,57,50,3.912023,4.043051,0.1310283,7.955074,4.043051,3.912023,1,1,1,1.2894,3,0.5516,MORE
16,92,100,8,192,92,100,4.521789,4.60517,0.08338161,9.126959,4.521789,4.60517,0,1,0,1.6725,2,0.5726,MORE
16,150,144,6,294,150,144,5.010635,4.969813,0.04082199,9.980449,5.010635,4.969813,0,0,1,1.4045,2,0.4998,MORE
16,40,50,10,90,50,40,3.688879,3.912023,0.2231436,7.600902,3.912023,3.688879,1,1,1,1.2566,3,0.6179,MORE
16,50,52,2,102,52,50,3.912023,3.951244,0.03922071,7.863267,3.951244,3.912023,1,1,1,1.5276,3,0.5518,MORE
16,50,41,9,91,41,50,3.912023,3.713572,0.1984509,7.625595,3.713572,3.912023,1,0,0,1.2783,4,0.6088,MORE
16,177,150,27,327,177,150,5.17615,5.010635,0.1655144,10.18679,5.17615,5.010635,0,0,1,1.1641,2,0.5163,MORE
16,141,150,9,291,150,141,4.94876,5.010635,0.0618754,9.959395,5.010635,4.94876,1,1,1,1.3001,1,0.8743,MORE
16,108,100,8,208,100,108,4.682131,4.60517,0.07696104,9.287301,4.60517,4.682131,1,0,0,1.5001,2,0.6706,MORE
16,46,50,4,96,46,50,3.828641,3.912023,0.08338161,7.740664,3.828641,3.912023,0,1,0,1.2797,2,0.5846,MORE
16,100,98,2,198,100,98,4.60517,4.584967,0.02020271,9.190138,4.60517,4.584967,0,0,1,1.343,2,0.6149,MORE
16,100,110,10,210,110,100,4.60517,4.70048,0.09531018,9.305651,4.70048,4.60517,1,1,1,1.1918,2,0.4732,MORE
16,50,56,6,106,56,50,3.912023,4.025352,0.1133287,7.937375,4.025352,3.912023,1,1,1,1.1265,4,0.6578,MORE
16,132,150,18,282,132,150,4.882802,5.010635,0.1278334,9.893437,4.882802,5.010635,0,1,0,1.2914,2,0.449,MORE
16,90,100,10,190,100,90,4.49981,4.60517,0.1053605,9.10498,4.60517,4.49981,1,1,1,1.4762,3,0.4585,MORE
16,84,100,16,184,100,84,4.430817,4.60517,0.1743534,9.035987,4.60517,4.430817,1,1,1,0.6043,3,1.1009,MORE
16,48,50,2,98,50,48,3.871201,3.912023,0.04082199,7.783224,3.912023,3.871201,1,1,1,1.227,2,0.3595,MORE
16,150,153,3,303,153,150,5.010635,5.030438,0.01980263,10.04107,5.030438,5.010635,1,1,1,1.4746,2,0.7249,MORE
16,150,174,24,324,174,150,5.010635,5.159055,0.14842,10.16969,5.159055,5.010635,1,1,1,1.1957,2,0.5237,MORE
16,50,55,5,105,55,50,3.912023,4.007333,0.09531018,7.919356,4.007333,3.912023,1,1,1,1.2276,2,0.3839,MORE
16,55,50,5,105,55,50,4.007333,3.912023,0.09531018,7.919356,4.007333,3.912023,0,0,1,1.1756,4,0.5637,MORE
16,150,171,21,321,171,150,5.010635,5.141664,0.1310283,10.1523,5.141664,5.010635,1,1,1,1.2746,3,0.5947,MORE
16,150,123,27,273,150,123,5.010635,4.812184,0.1984509,9.82282,5.010635,4.812184,0,0,1,1.3166,2,0.4996,MORE
16,174,150,24,324,174,150,5.159055,5.010635,0.14842,10.16969,5.159055,5.010635,0,0,1,1.2021,3,0.4983,MORE
16,100,116,16,216,116,100,4.60517,4.75359,0.14842,9.35876,4.75359,4.60517,1,1,1,1.3354,3,0.518,MORE
16,50,42,8,92,42,50,3.912023,3.73767,0.1743534,7.649693,3.73767,3.912023,1,0,0,1.2321,2,0.4478,MORE
16,168,150,18,318,168,150,5.123964,5.010635,0.1133287,10.1346,5.123964,5.010635,0,0,1,1.1311,3,0.452,MORE
16,50,48,2,98,48,50,3.912023,3.871201,0.04082199,7.783224,3.871201,3.912023,1,0,0,1.1504,3,0.5001,MORE
16,59,50,9,109,50,59,4.077537,3.912023,0.1655144,7.98956,3.912023,4.077537,1,0,0,1.1358,2,0.5333,MORE
16,150,159,9,309,159,150,5.010635,5.068904,0.05826891,10.07954,5.068904,5.010635,1,1,1,1.1644,2,0.4323,MORE
16,41,50,9,91,41,50,3.713572,3.912023,0.1984509,7.625595,3.713572,3.912023,0,1,0,1.1914,4,0.4583,MORE
16,120,150,30,270,150,120,4.787492,5.010635,0.2231436,9.798127,5.010635,4.787492,1,1,1,1.2837,3,0.6346,MORE
16,120,100,20,220,120,100,4.787492,4.60517,0.1823216,9.392662,4.787492,4.60517,0,0,1,1.3256,3,0.4513,MORE
16,150,123,27,273,150,123,5.010635,4.812184,0.1984509,9.82282,5.010635,4.812184,0,0,1,1.3365,3,1,MORE
16,174,150,24,324,174,150,5.159055,5.010635,0.14842,10.16969,5.159055,5.010635,0,0,1,1.2239,2,0.5181,MORE
16,50,56,6,106,56,50,3.912023,4.025352,0.1133287,7.937375,4.025352,3.912023,1,1,1,1.1105,2,0.6074,MORE
16,82,100,18,182,82,100,4.406719,4.60517,0.1984509,9.011889,4.406719,4.60517,0,1,0,1.8884,2,0.483,MORE
16,44,50,6,94,50,44,3.78419,3.912023,0.1278334,7.696213,3.912023,3.78419,1,1,1,1.1404,4,0.6502,MORE
16,100,102,2,202,100,102,4.60517,4.624973,0.01980263,9.230143,4.60517,4.624973,0,1,0,1.3098,2,0.7048,MORE
16,50,44,6,94,50,44,3.912023,3.78419,0.1278334,7.696213,3.912023,3.78419,0,0,1,1.1299,3,0.8169,MORE
16,50,47,3,97,50,47,3.912023,3.850148,0.0618754,7.762171,3.912023,3.850148,0,0,1,1.0831,3,0.6832,MORE
16,126,150,24,276,150,126,4.836282,5.010635,0.1743534,9.846917,5.010635,4.836282,1,1,1,1.035,4,0.6374,MORE
16,102,100,2,202,102,100,4.624973,4.60517,0.01980263,9.230143,4.624973,4.60517,0,0,1,1.3949,2,0.6074,MORE
16,150,132,18,282,150,132,5.010635,4.882802,0.1278334,9.893437,5.010635,4.882802,0,0,1,1.2705,3,0.4117,MORE
16,50,51,1,101,51,50,3.912023,3.931826,0.01980263,7.843849,3.931826,3.912023,1,1,1,1.2602,2,0.9167,MORE
16,50,44,6,94,50,44,3.912023,3.78419,0.1278334,7.696213,3.912023,3.78419,0,0,1,1.0893,4,0.691,MORE
16,150,177,27,327,150,177,5.010635,5.17615,0.1655144,10.18679,5.010635,5.17615,0,1,0,1.2074,1,0.7357,MORE
16,144,150,6,294,150,144,4.969813,5.010635,0.04082199,9.980449,5.010635,4.969813,1,1,1,1.1178,2,0.4969,MORE
16,141,150,9,291,141,150,4.94876,5.010635,0.0618754,9.959395,4.94876,5.010635,0,1,0,1.2462,2,0.3972,MORE
16,100,84,16,184,100,84,4.60517,4.430817,0.1743534,9.035987,4.60517,4.430817,0,0,1,1.3537,2,0.6852,MORE
16,45,50,5,95,50,45,3.806662,3.912023,0.1053605,7.718685,3.912023,3.806662,1,1,1,1.1157,3,0.4811,MORE
16,150,147,3,297,150,147,5.010635,4.990433,0.02020271,10.00107,5.010635,4.990433,0,0,1,1.2063,2,0.4997,MORE
16,43,50,7,93,50,43,3.7612,3.912023,0.1508229,7.673223,3.912023,3.7612,1,1,1,1.1654,3,0.5172,MORE
16,118,100,18,218,100,118,4.770685,4.60517,0.1655144,9.375855,4.60517,4.770685,1,0,0,1.3579,2,0.4682,MORE
16,100,94,6,194,100,94,4.60517,4.543295,0.0618754,9.148465,4.60517,4.543295,0,0,1,1.0688,3,0.4727,MORE
16,58,50,8,108,58,50,4.060443,3.912023,0.14842,7.972466,4.060443,3.912023,0,0,1,0.9487,2,0.4841,MORE
16,50,55,5,105,50,55,3.912023,4.007333,0.09531018,7.919356,3.912023,4.007333,0,1,0,0.876,2,0.4839,MORE
16,150,126,24,276,150,126,5.010635,4.836282,0.1743534,9.846917,5.010635,4.836282,0,0,1,1.0438,3,0.5403,MORE
16,150,120,30,270,150,120,5.010635,4.787492,0.2231436,9.798127,5.010635,4.787492,0,0,1,1.0467,4,0.4062,MORE
16,165,150,15,315,150,165,5.105945,5.010635,0.09531018,10.11658,5.010635,5.105945,1,0,0,1.2204,2,0.4686,MORE
16,132,150,18,282,150,132,4.882802,5.010635,0.1278334,9.893437,5.010635,4.882802,1,1,1,1.1669,3,0.4483,MORE
16,106,100,6,206,106,100,4.663439,4.60517,0.05826891,9.268609,4.663439,4.60517,0,0,1,1.5183,2,0.4174,MORE
16,110,100,10,210,110,100,4.70048,4.60517,0.09531018,9.305651,4.70048,4.60517,0,0,1,1.4659,2,0.5685,MORE
16,159,150,9,309,159,150,5.068904,5.010635,0.05826891,10.07954,5.068904,5.010635,0,0,1,1.2078,3,0.5215,MORE
16,100,90,10,190,100,90,4.60517,4.49981,0.1053605,9.10498,4.60517,4.49981,0,0,1,1.2858,2,0.5165,MORE
16,100,112,12,212,112,100,4.60517,4.718499,0.1133287,9.323669,4.718499,4.60517,1,1,1,1.2307,3,0.551,MORE
16,100,102,2,202,100,102,4.60517,4.624973,0.01980263,9.230143,4.60517,4.624973,0,1,0,1.3837,2,0.7241,MORE
16,100,118,18,218,118,100,4.60517,4.770685,0.1655144,9.375855,4.770685,4.60517,1,1,1,1.2336,2,0.4642,MORE
16,150,165,15,315,165,150,5.010635,5.105945,0.09531018,10.11658,5.105945,5.010635,1,1,1,1.0856,3,0.6025,MORE
16,100,98,2,198,100,98,4.60517,4.584967,0.02020271,9.190138,4.60517,4.584967,0,0,1,1.2439,2,0.4688,MORE
16,150,162,12,312,162,150,5.010635,5.087596,0.07696104,10.09823,5.087596,5.010635,1,1,1,1.2386,2,0.5152,MORE
16,50,54,4,104,50,54,3.912023,3.988984,0.07696104,7.901007,3.912023,3.988984,0,1,0,1.3102,4,0.5173,MORE
16,171,150,21,321,150,171,5.141664,5.010635,0.1310283,10.1523,5.010635,5.141664,1,0,0,1.2244,3,0.5687,MORE
16,82,100,18,182,82,100,4.406719,4.60517,0.1984509,9.011889,4.406719,4.60517,0,1,0,1.3112,2,0.3336,MORE
16,100,104,4,204,104,100,4.60517,4.644391,0.03922071,9.249561,4.644391,4.60517,1,1,1,0.9125,4,0.6363,MORE
16,50,47,3,97,47,50,3.912023,3.850148,0.0618754,7.762171,3.850148,3.912023,1,0,0,1.358,2,0.5733,MORE
16,150,126,24,276,150,126,5.010635,4.836282,0.1743534,9.846917,5.010635,4.836282,0,0,1,1.2399,3,0.6373,MORE
16,50,60,10,110,50,60,3.912023,4.094345,0.1823216,8.006368,3.912023,4.094345,0,1,0,0.9274,2,0.4331,MORE
16,100,120,20,220,120,100,4.60517,4.787492,0.1823216,9.392662,4.787492,4.60517,1,1,1,0.9446,3,0.4825,MORE
16,50,53,3,103,53,50,3.912023,3.970292,0.05826891,7.882315,3.970292,3.912023,1,1,1,1.2194,2,0.5322,MORE
16,52,50,2,102,52,50,3.951244,3.912023,0.03922071,7.863267,3.951244,3.912023,0,0,1,1.1766,3,0.5009,MORE
16,100,116,16,216,100,116,4.60517,4.75359,0.14842,9.35876,4.60517,4.75359,0,1,0,1.3161,2,0.4738,MORE
16,123,150,27,273,150,123,4.812184,5.010635,0.1984509,9.82282,5.010635,4.812184,1,1,1,1.1011,4,0.5008,MORE
16,150,129,21,279,150,129,5.010635,4.859812,0.1508229,9.870448,5.010635,4.859812,0,0,1,1.037,3,0.4112,MORE
16,49,50,1,99,49,50,3.89182,3.912023,0.02020271,7.803843,3.89182,3.912023,0,1,0,1.1592,3,0.4022,MORE
16,150,138,12,288,150,138,5.010635,4.927254,0.08338161,9.937889,5.010635,4.927254,0,0,1,1.0326,2,0.5822,MORE
16,129,150,21,279,150,129,4.859812,5.010635,0.1508229,9.870448,5.010635,4.859812,1,1,1,0.9347,4,0.4539,MORE
16,150,168,18,318,168,150,5.010635,5.123964,0.1133287,10.1346,5.123964,5.010635,1,1,1,0.9973,4,0.5353,MORE
16,150,156,6,306,150,156,5.010635,5.049856,0.03922071,10.06049,5.010635,5.049856,0,1,0,1.0451,3,0.4569,MORE
16,43,50,7,93,43,50,3.7612,3.912023,0.1508229,7.673223,3.7612,3.912023,0,1,0,1.1093,2,0.4843,MORE
16,50,45,5,95,45,50,3.912023,3.806662,0.1053605,7.718685,3.806662,3.912023,1,0,0,1.1438,1,0.4503,MORE
16,96,100,4,196,96,100,4.564348,4.60517,0.04082199,9.169518,4.564348,4.60517,0,1,0,1.1836,3,0.4017,MORE
16,100,82,18,182,100,82,4.60517,4.406719,0.1984509,9.011889,4.60517,4.406719,0,0,1,1.0378,3,0.3689,MORE
16,100,80,20,180,100,80,4.60517,4.382027,0.2231436,8.987197,4.60517,4.382027,0,0,1,1.0295,3,0.3492,MORE
16,100,120,20,220,120,100,4.60517,4.787492,0.1823216,9.392662,4.787492,4.60517,1,1,1,0.9032,4,0.6489,MORE
16,171,150,21,321,171,150,5.141664,5.010635,0.1310283,10.1523,5.141664,5.010635,0,0,1,0.8735,3,0.5248,MORE
16,50,59,9,109,59,50,3.912023,4.077537,0.1655144,7.98956,4.077537,3.912023,1,1,1,0.6411,3,0.8881,MORE
16,50,45,5,95,50,45,3.912023,3.806662,0.1053605,7.718685,3.912023,3.806662,0,0,1,0.9843,4,0.407,MORE
16,98,100,2,198,98,100,4.584967,4.60517,0.02020271,9.190138,4.584967,4.60517,0,1,0,1.1352,2,0.3565,MORE
16,86,100,14,186,86,100,4.454347,4.60517,0.1508229,9.059517,4.454347,4.60517,0,1,0,1.0662,3,0.3816,MORE
16,150,159,9,309,159,150,5.010635,5.068904,0.05826891,10.07954,5.068904,5.010635,1,1,1,0.9829,3,0.4229,MORE
16,159,150,9,309,159,150,5.068904,5.010635,0.05826891,10.07954,5.068904,5.010635,0,0,1,1.0133,3,0.5298,MORE
16,150,135,15,285,150,135,5.010635,4.905275,0.1053605,9.91591,5.010635,4.905275,0,0,1,1.0258,4,0.4028,MORE
16,55,50,5,105,50,55,4.007333,3.912023,0.09531018,7.919356,3.912023,4.007333,1,0,0,1.1613,2,0.3927,MORE
16,168,150,18,318,150,168,5.123964,5.010635,0.1133287,10.1346,5.010635,5.123964,1,0,0,1.1282,1,0.6823,MORE
16,162,150,12,312,162,150,5.087596,5.010635,0.07696104,10.09823,5.087596,5.010635,0,0,1,1.0328,2,0.3828,MORE
16,100,118,18,218,118,100,4.60517,4.770685,0.1655144,9.375855,4.770685,4.60517,1,1,1,1.0306,2,0.3822,MORE
16,150,177,27,327,177,150,5.010635,5.17615,0.1655144,10.18679,5.17615,5.010635,1,1,1,0.9259,3,0.399,MORE
16,144,150,6,294,144,150,4.969813,5.010635,0.04082199,9.980449,4.969813,5.010635,0,1,0,0.8997,3,0.3824,MORE
16,42,50,8,92,50,42,3.73767,3.912023,0.1743534,7.649693,3.912023,3.73767,1,1,1,1.0215,3,0.4652,MORE
16,60,50,10,110,60,50,4.094345,3.912023,0.1823216,8.006368,4.094345,3.912023,0,0,1,0.9956,4,0.3006,MORE
16,100,80,20,180,100,80,4.60517,4.382027,0.2231436,8.987197,4.60517,4.382027,0,0,1,0.9102,4,0.4387,MORE
16,165,150,15,315,165,150,5.105945,5.010635,0.09531018,10.11658,5.105945,5.010635,0,0,1,1.0763,3,0.382,MORE
16,116,100,16,216,116,100,4.75359,4.60517,0.14842,9.35876,4.75359,4.60517,0,0,1,0.9565,4,0.3152,MORE
16,86,100,14,186,100,86,4.454347,4.60517,0.1508229,9.059517,4.60517,4.454347,1,1,1,0.9223,4,0.2882,MORE
16,112,100,12,212,100,112,4.718499,4.60517,0.1133287,9.323669,4.60517,4.718499,1,0,0,1.0464,3,0.3889,MORE
16,44,50,6,94,50,44,3.78419,3.912023,0.1278334,7.696213,3.912023,3.78419,1,1,1,0.9374,3,0.3996,MORE
16,50,46,4,96,50,46,3.912023,3.828641,0.08338161,7.740664,3.912023,3.828641,0,0,1,0.9696,3,0.2881,MORE
16,150,180,30,330,180,150,5.010635,5.192957,0.1823216,10.20359,5.192957,5.010635,1,1,1,0.8629,3,0.3482,MORE
16,100,110,10,210,100,110,4.60517,4.70048,0.09531018,9.305651,4.60517,4.70048,0,1,0,1.0808,2,0.4835,MORE
16,57,50,7,107,50,57,4.043051,3.912023,0.1310283,7.955074,3.912023,4.043051,1,0,0,1.1326,2,0.319,MORE
16,80,100,20,180,100,80,4.382027,4.60517,0.2231436,8.987197,4.60517,4.382027,1,1,1,1.0265,2,0.3062,MORE
16,100,114,14,214,114,100,4.60517,4.736198,0.1310283,9.341369,4.736198,4.60517,1,1,1,0.9464,2,0.3064,MORE
16,100,108,8,208,108,100,4.60517,4.682131,0.07696104,9.287301,4.682131,4.60517,1,1,1,1.0035,2,0.4818,MORE
16,80,100,20,180,100,80,4.382027,4.60517,0.2231436,8.987197,4.60517,4.382027,1,1,1,0.9292,2,0.5988,MORE
16,150,132,18,282,150,132,5.010635,4.882802,0.1278334,9.893437,5.010635,4.882802,0,0,1,1.0806,2,0.2837,MORE
16,50,40,10,90,50,40,3.912023,3.688879,0.2231436,7.600902,3.912023,3.688879,0,0,1,1.2894,1,0.7078,MORE
16,50,54,4,104,54,50,3.912023,3.988984,0.07696104,7.901007,3.988984,3.912023,1,1,1,0.9989,1,0.6175,MORE
16,50,60,10,110,60,50,3.912023,4.094345,0.1823216,8.006368,4.094345,3.912023,1,1,1,1.0774,2,0.4187,MORE
16,110,100,10,210,110,100,4.70048,4.60517,0.09531018,9.305651,4.70048,4.60517,0,0,1,1.0795,3,0.3352,MORE
16,177,150,27,327,177,150,5.17615,5.010635,0.1655144,10.18679,5.17615,5.010635,0,0,1,1.0121,3,0.3989,MORE
16,106,100,6,206,100,106,4.663439,4.60517,0.05826891,9.268609,4.60517,4.663439,1,0,0,0.9088,3,0.4383,MORE
16,98,100,2,198,98,100,4.584967,4.60517,0.02020271,9.190138,4.584967,4.60517,0,1,0,1.0024,3,0.3505,MORE
16,50,58,8,108,58,50,3.912023,4.060443,0.14842,7.972466,4.060443,3.912023,1,1,1,0.9717,1,0.9493,MORE
16,112,100,12,212,112,100,4.718499,4.60517,0.1133287,9.323669,4.718499,4.60517,0,0,1,0.9996,3,0.3032,MORE
17,120,100,20,220,120,100,4.787492,4.60517,0.1823216,9.392662,4.787492,4.60517,0,0,1,1.3835,2,0.7701,MORE
17,150,171,21,321,171,150,5.010635,5.141664,0.1310283,10.1523,5.141664,5.010635,1,1,1,1.1774,2,0.3801,MORE
17,150,132,18,282,150,132,5.010635,4.882802,0.1278334,9.893437,5.010635,4.882802,0,0,1,1.4901,2,0.6409,MORE
17,50,51,1,101,51,50,3.912023,3.931826,0.01980263,7.843849,3.931826,3.912023,1,1,1,1.056,3,1.4751,MORE
17,100,94,6,194,100,94,4.60517,4.543295,0.0618754,9.148465,4.60517,4.543295,0,0,1,1.1569,2,0.6034,MORE
17,100,106,6,206,106,100,4.60517,4.663439,0.05826891,9.268609,4.663439,4.60517,1,1,1,0.9912,3,0.4839,MORE
17,120,150,30,270,150,120,4.787492,5.010635,0.2231436,9.798127,5.010635,4.787492,1,1,1,0.9092,4,1.1679,MORE
17,116,100,16,216,116,100,4.75359,4.60517,0.14842,9.35876,4.75359,4.60517,0,0,1,0.8744,2,0.5029,MORE
17,177,150,27,327,150,177,5.17615,5.010635,0.1655144,10.18679,5.010635,5.17615,1,0,0,1.2595,1,1.517,MORE
17,159,150,9,309,150,159,5.068904,5.010635,0.05826891,10.07954,5.010635,5.068904,1,0,0,0.7837,2,0.4886,MORE
17,54,50,4,104,50,54,3.988984,3.912023,0.07696104,7.901007,3.912023,3.988984,1,0,0,1.1024,3,0.6862,MORE
17,108,100,8,208,100,108,4.682131,4.60517,0.07696104,9.287301,4.60517,4.682131,1,0,0,1.0084,2,0.4335,MORE
17,120,150,30,270,150,120,4.787492,5.010635,0.2231436,9.798127,5.010635,4.787492,1,1,1,0.8892,2,0.6005,MORE
17,50,57,7,107,57,50,3.912023,4.043051,0.1310283,7.955074,4.043051,3.912023,1,1,1,0.781,3,1.4322,MORE
17,88,100,12,188,100,88,4.477337,4.60517,0.1278334,9.082507,4.60517,4.477337,1,1,1,0.8823,2,1.0195,MORE
17,141,150,9,291,150,141,4.94876,5.010635,0.0618754,9.959395,5.010635,4.94876,1,1,1,1.2623,2,0.9298,MORE
17,150,144,6,294,150,144,5.010635,4.969813,0.04082199,9.980449,5.010635,4.969813,0,0,1,1.3846,2,0.4126,MORE
17,50,56,6,106,50,56,3.912023,4.025352,0.1133287,7.937375,3.912023,4.025352,0,1,0,1.5058,2,0.4806,MORE
17,174,150,24,324,150,174,5.159055,5.010635,0.14842,10.16969,5.010635,5.159055,1,0,0,1.4074,3,0.5869,MORE
17,47,50,3,97,50,47,3.850148,3.912023,0.0618754,7.762171,3.912023,3.850148,1,1,1,1.3241,3,0.8671,MORE
17,147,150,3,297,150,147,4.990433,5.010635,0.02020271,10.00107,5.010635,4.990433,1,1,1,1.0219,2,0.8036,MORE
17,44,50,6,94,50,44,3.78419,3.912023,0.1278334,7.696213,3.912023,3.78419,1,1,1,1.2339,2,0.5341,MORE
17,150,180,30,330,180,150,5.010635,5.192957,0.1823216,10.20359,5.192957,5.010635,1,1,1,0.772,2,0.6552,MORE
17,171,150,21,321,171,150,5.141664,5.010635,0.1310283,10.1523,5.141664,5.010635,0,0,1,1.0904,2,0.7232,MORE
17,150,129,21,279,129,150,5.010635,4.859812,0.1508229,9.870448,4.859812,5.010635,1,0,0,1.081,1,0.6007,MORE
17,150,123,27,273,150,123,5.010635,4.812184,0.1984509,9.82282,5.010635,4.812184,0,0,1,0.9937,2,0.6013,MORE
17,100,96,4,196,96,100,4.60517,4.564348,0.04082199,9.169518,4.564348,4.60517,1,0,0,0.64,2,0.4154,MORE
17,100,84,16,184,100,84,4.60517,4.430817,0.1743534,9.035987,4.60517,4.430817,0,0,1,0.8054,2,0.6026,MORE
17,112,100,12,212,100,112,4.718499,4.60517,0.1133287,9.323669,4.60517,4.718499,1,0,0,0.6158,1,1.1348,MORE
17,150,153,3,303,153,150,5.010635,5.030438,0.01980263,10.04107,5.030438,5.010635,1,1,1,0.9497,2,0.4301,MORE
17,106,100,6,206,106,100,4.663439,4.60517,0.05826891,9.268609,4.663439,4.60517,0,0,1,1.0972,2,0.3737,MORE
17,100,94,6,194,100,94,4.60517,4.543295,0.0618754,9.148465,4.60517,4.543295,0,0,1,0.9794,2,0.3797,MORE
17,150,165,15,315,165,150,5.010635,5.105945,0.09531018,10.11658,5.105945,5.010635,1,1,1,1.164,2,0.3215,MORE
17,50,48,2,98,50,48,3.912023,3.871201,0.04082199,7.783224,3.912023,3.871201,0,0,1,1.3482,2,0.34,MORE
17,100,116,16,216,116,100,4.60517,4.75359,0.14842,9.35876,4.75359,4.60517,1,1,1,0.6661,2,0.4844,MORE
17,150,156,6,306,150,156,5.010635,5.049856,0.03922071,10.06049,5.010635,5.049856,0,1,0,1.0184,2,0.3049,MORE
17,100,114,14,214,114,100,4.60517,4.736198,0.1310283,9.341369,4.736198,4.60517,1,1,1,0.8624,2,0.3979,MORE
17,116,100,16,216,100,116,4.75359,4.60517,0.14842,9.35876,4.60517,4.75359,1,0,0,0.8581,2,0.3462,MORE
17,165,150,15,315,150,165,5.105945,5.010635,0.09531018,10.11658,5.010635,5.105945,1,0,0,1.0699,2,0.282,MORE
17,50,52,2,102,52,50,3.912023,3.951244,0.03922071,7.863267,3.951244,3.912023,1,1,1,1.0388,2,0.2842,MORE
17,46,50,4,96,50,46,3.828641,3.912023,0.08338161,7.740664,3.912023,3.828641,1,1,1,1.4238,2,1.0346,MORE
17,50,59,9,109,59,50,3.912023,4.077537,0.1655144,7.98956,4.077537,3.912023,1,1,1,1.0942,2,0.4185,MORE
17,177,150,27,327,177,150,5.17615,5.010635,0.1655144,10.18679,5.17615,5.010635,0,0,1,1.2593,1,0.452,MORE
17,59,50,9,109,59,50,4.077537,3.912023,0.1655144,7.98956,4.077537,3.912023,0,0,1,1.1158,2,0.4184,MORE
17,102,100,2,202,100,102,4.624973,4.60517,0.01980263,9.230143,4.60517,4.624973,1,0,0,1.1293,2,0.4165,MORE
17,150,120,30,270,150,120,5.010635,4.787492,0.2231436,9.798127,5.010635,4.787492,0,0,1,1.045,3,0.6296,MORE
17,100,120,20,220,120,100,4.60517,4.787492,0.1823216,9.392662,4.787492,4.60517,1,1,1,0.9537,3,0.6342,MORE
17,48,50,2,98,50,48,3.871201,3.912023,0.04082199,7.783224,3.912023,3.871201,1,1,1,1.1694,4,0.9718,MORE
17,100,90,10,190,90,100,4.60517,4.49981,0.1053605,9.10498,4.49981,4.60517,1,0,0,0.9382,2,0.5478,MORE
17,100,102,2,202,100,102,4.60517,4.624973,0.01980263,9.230143,4.60517,4.624973,0,1,0,1.1894,2,0.5303,MORE
17,86,100,14,186,100,86,4.454347,4.60517,0.1508229,9.059517,4.60517,4.454347,1,1,1,0.7238,2,0.6515,MORE
17,100,80,20,180,100,80,4.60517,4.382027,0.2231436,8.987197,4.60517,4.382027,0,0,1,1.1453,2,0.392,MORE
17,129,150,21,279,150,129,4.859812,5.010635,0.1508229,9.870448,5.010635,4.859812,1,1,1,0.8886,3,0.546,MORE
17,42,50,8,92,50,42,3.73767,3.912023,0.1743534,7.649693,3.912023,3.73767,1,1,1,0.7866,2,0.4343,MORE
17,150,177,27,327,177,150,5.010635,5.17615,0.1655144,10.18679,5.17615,5.010635,1,1,1,1.0062,3,0.9058,MORE
17,150,126,24,276,126,150,5.010635,4.836282,0.1743534,9.846917,4.836282,5.010635,1,0,0,1.2236,2,0.4167,MORE
17,50,57,7,107,57,50,3.912023,4.043051,0.1310283,7.955074,4.043051,3.912023,1,1,1,1.1579,3,0.5826,MORE
17,100,86,14,186,86,100,4.60517,4.454347,0.1508229,9.059517,4.454347,4.60517,1,0,0,0.9277,2,0.4066,MORE
17,141,150,9,291,150,141,4.94876,5.010635,0.0618754,9.959395,5.010635,4.94876,1,1,1,0.9335,2,0.8132,MORE
17,118,100,18,218,118,100,4.770685,4.60517,0.1655144,9.375855,4.770685,4.60517,0,0,1,1.1363,2,0.3842,MORE
17,92,100,8,192,100,92,4.521789,4.60517,0.08338161,9.126959,4.60517,4.521789,1,1,1,0.8831,2,0.3241,MORE
17,50,54,4,104,54,50,3.912023,3.988984,0.07696104,7.901007,3.988984,3.912023,1,1,1,0.8812,3,0.6567,MORE
17,51,50,1,101,51,50,3.931826,3.912023,0.01980263,7.843849,3.931826,3.912023,0,0,1,1.0596,2,0.9143,MORE
17,84,100,16,184,100,84,4.430817,4.60517,0.1743534,9.035987,4.60517,4.430817,1,1,1,0.6691,3,0.7582,MORE
17,100,118,18,218,118,100,4.60517,4.770685,0.1655144,9.375855,4.770685,4.60517,1,1,1,1.1504,2,0.5026,MORE
17,100,116,16,216,116,100,4.60517,4.75359,0.14842,9.35876,4.75359,4.60517,1,1,1,0.6246,4,1.0341,MORE
17,50,55,5,105,55,50,3.912023,4.007333,0.09531018,7.919356,4.007333,3.912023,1,1,1,1.1393,3,0.466,MORE
17,150,135,15,285,150,135,5.010635,4.905275,0.1053605,9.91591,5.010635,4.905275,0,0,1,1.1868,2,0.54,MORE
17,98,100,2,198,100,98,4.584967,4.60517,0.02020271,9.190138,4.60517,4.584967,1,1,1,0.8792,3,1.0079,MORE
17,80,100,20,180,100,80,4.382027,4.60517,0.2231436,8.987197,4.60517,4.382027,1,1,1,1.0755,3,0.4891,MORE
17,54,50,4,104,54,50,3.988984,3.912023,0.07696104,7.901007,3.988984,3.912023,0,0,1,1.0169,4,0.5624,MORE
17,84,100,16,184,100,84,4.430817,4.60517,0.1743534,9.035987,4.60517,4.430817,1,1,1,0.773,3,0.3297,MORE
17,104,100,4,204,104,100,4.644391,4.60517,0.03922071,9.249561,4.644391,4.60517,0,0,1,1.2103,3,0.38,MORE
17,88,100,12,188,100,88,4.477337,4.60517,0.1278334,9.082507,4.60517,4.477337,1,1,1,0.7795,4,0.4381,MORE
17,120,100,20,220,120,100,4.787492,4.60517,0.1823216,9.392662,4.787492,4.60517,0,0,1,0.9268,3,0.3869,MORE
17,55,50,5,105,50,55,4.007333,3.912023,0.09531018,7.919356,3.912023,4.007333,1,0,0,1.0126,3,0.2879,MORE
17,150,141,9,291,141,150,5.010635,4.94876,0.0618754,9.959395,4.94876,5.010635,1,0,0,0.9396,3,0.3051,MORE
17,96,100,4,196,100,96,4.564348,4.60517,0.04082199,9.169518,4.60517,4.564348,1,1,1,1.0725,3,0.4151,MORE
17,150,141,9,291,150,141,5.010635,4.94876,0.0618754,9.959395,5.010635,4.94876,0,0,1,0.83,3,0.3701,MORE
17,94,100,6,194,100,94,4.543295,4.60517,0.0618754,9.148465,4.60517,4.543295,1,1,1,0.9495,3,0.3692,MORE
17,42,50,8,92,50,42,3.73767,3.912023,0.1743534,7.649693,3.912023,3.73767,1,1,1,1.1069,4,1.8174,MORE
17,150,147,3,297,147,150,5.010635,4.990433,0.02020271,10.00107,4.990433,5.010635,1,0,0,0.9868,2,0.3364,MORE
17,171,150,21,321,150,171,5.141664,5.010635,0.1310283,10.1523,5.010635,5.141664,1,0,0,0.8975,1,0.5011,MORE
17,50,43,7,93,50,43,3.912023,3.7612,0.1508229,7.673223,3.912023,3.7612,0,0,1,1.7024,2,0.4349,MORE
17,150,162,12,312,162,150,5.010635,5.087596,0.07696104,10.09823,5.087596,5.010635,1,1,1,1.0818,1,0.6625,MORE
17,144,150,6,294,150,144,4.969813,5.010635,0.04082199,9.980449,5.010635,4.969813,1,1,1,1.0536,1,0.5131,MORE
17,100,80,20,180,100,80,4.60517,4.382027,0.2231436,8.987197,4.60517,4.382027,0,0,1,1.2251,2,0.6043,MORE
17,138,150,12,288,150,138,4.927254,5.010635,0.08338161,9.937889,5.010635,4.927254,1,1,1,0.8771,3,0.5504,MORE
17,50,47,3,97,47,50,3.912023,3.850148,0.0618754,7.762171,3.850148,3.912023,1,0,0,0.9714,3,0.8499,MORE
17,150,159,9,309,159,150,5.010635,5.068904,0.05826891,10.07954,5.068904,5.010635,1,1,1,1.2531,1,0.5296,MORE
17,46,50,4,96,50,46,3.828641,3.912023,0.08338161,7.740664,3.912023,3.828641,1,1,1,0.9492,2,0.4312,MORE
17,92,100,8,192,100,92,4.521789,4.60517,0.08338161,9.126959,4.60517,4.521789,1,1,1,1.185,2,0.2701,MORE
17,150,126,24,276,150,126,5.010635,4.836282,0.1743534,9.846917,5.010635,4.836282,0,0,1,1.0592,3,0.9246,MORE
17,50,60,10,110,60,50,3.912023,4.094345,0.1823216,8.006368,4.094345,3.912023,1,1,1,1.1391,2,0.3824,MORE
17,135,150,15,285,135,150,4.905275,5.010635,0.1053605,9.91591,4.905275,5.010635,0,1,0,1.3089,1,0.4172,MORE
17,100,114,14,214,114,100,4.60517,4.736198,0.1310283,9.341369,4.736198,4.60517,1,1,1,0.9923,2,0.3675,MORE
17,150,129,21,279,150,129,5.010635,4.859812,0.1508229,9.870448,5.010635,4.859812,0,0,1,1.1093,2,0.4592,MORE
17,135,150,15,285,150,135,4.905275,5.010635,0.1053605,9.91591,5.010635,4.905275,1,1,1,0.8715,3,0.4726,MORE
17,55,50,5,105,50,55,4.007333,3.912023,0.09531018,7.919356,3.912023,4.007333,1,0,0,1.2154,2,0.5072,MORE
17,150,144,6,294,144,150,5.010635,4.969813,0.04082199,9.980449,4.969813,5.010635,1,0,0,1.0832,2,0.3367,MORE
17,50,40,10,90,50,40,3.912023,3.688879,0.2231436,7.600902,3.912023,3.688879,0,0,1,0.9675,4,0.8901,MORE
17,156,150,6,306,150,156,5.049856,5.010635,0.03922071,10.06049,5.010635,5.049856,1,0,0,1.0637,2,0.319,MORE
17,50,60,10,110,60,50,3.912023,4.094345,0.1823216,8.006368,4.094345,3.912023,1,1,1,0.8393,3,0.3411,MORE
17,50,40,10,90,50,40,3.912023,3.688879,0.2231436,7.600902,3.912023,3.688879,0,0,1,1.2848,1,0.491,MORE
17,100,120,20,220,120,100,4.60517,4.787492,0.1823216,9.392662,4.787492,4.60517,1,1,1,0.8923,3,0.4827,MORE
17,47,50,3,97,47,50,3.850148,3.912023,0.0618754,7.762171,3.850148,3.912023,0,1,0,1.3045,1,0.5044,MORE
17,50,42,8,92,50,42,3.912023,3.73767,0.1743534,7.649693,3.912023,3.73767,0,0,1,1.3344,2,0.3068,MORE
17,100,104,4,204,104,100,4.60517,4.644391,0.03922071,9.249561,4.644391,4.60517,1,1,1,1.0736,2,0.3616,MORE
17,90,100,10,190,100,90,4.49981,4.60517,0.1053605,9.10498,4.60517,4.49981,1,1,1,1.2448,2,0.3165,MORE
17,50,58,8,108,58,50,3.912023,4.060443,0.14842,7.972466,4.060443,3.912023,1,1,1,1.2881,2,0.4643,MORE
17,82,100,18,182,100,82,4.406719,4.60517,0.1984509,9.011889,4.60517,4.406719,1,1,1,0.8943,3,0.48,MORE
17,43,50,7,93,50,43,3.7612,3.912023,0.1508229,7.673223,3.912023,3.7612,1,1,1,1.4172,2,0.3517,MORE
17,50,48,2,98,50,48,3.912023,3.871201,0.04082199,7.783224,3.912023,3.871201,0,0,1,1.2999,2,0.3068,MORE
17,100,98,2,198,100,98,4.60517,4.584967,0.02020271,9.190138,4.60517,4.584967,0,0,1,1.2253,1,0.4498,MORE
17,90,100,10,190,100,90,4.49981,4.60517,0.1053605,9.10498,4.60517,4.49981,1,1,1,0.8634,1,0.4025,MORE
17,180,150,30,330,180,150,5.192957,5.010635,0.1823216,10.20359,5.192957,5.010635,0,0,1,0.9334,3,0.4502,MORE
17,150,180,30,330,180,150,5.010635,5.192957,0.1823216,10.20359,5.192957,5.010635,1,1,1,0.6316,3,0.551,MORE
17,48,50,2,98,50,48,3.871201,3.912023,0.04082199,7.783224,3.912023,3.871201,1,1,1,0.8363,4,0.9388,MORE
17,150,132,18,282,150,132,5.010635,4.882802,0.1278334,9.893437,5.010635,4.882802,0,0,1,0.9346,2,0.404,MORE
17,50,56,6,106,56,50,3.912023,4.025352,0.1133287,7.937375,4.025352,3.912023,1,1,1,1.0143,2,0.4571,MORE
17,110,100,10,210,110,100,4.70048,4.60517,0.09531018,9.305651,4.70048,4.60517,0,0,1,1.1419,2,0.3887,MORE
17,100,110,10,210,110,100,4.60517,4.70048,0.09531018,9.305651,4.70048,4.60517,1,1,1,0.8073,3,0.3219,MORE
17,106,100,6,206,100,106,4.663439,4.60517,0.05826891,9.268609,4.60517,4.663439,1,0,0,0.9496,2,0.8374,MORE
17,129,150,21,279,150,129,4.859812,5.010635,0.1508229,9.870448,5.010635,4.859812,1,1,1,0.7953,4,1.0708,MORE
17,147,150,3,297,150,147,4.990433,5.010635,0.02020271,10.00107,5.010635,4.990433,1,1,1,1.234,2,0.59,MORE
17,50,44,6,94,50,44,3.912023,3.78419,0.1278334,7.696213,3.912023,3.78419,0,0,1,0.9911,4,0.9675,MORE
17,150,159,9,309,159,150,5.010635,5.068904,0.05826891,10.07954,5.068904,5.010635,1,1,1,1.0843,2,0.3558,MORE
17,118,100,18,218,118,100,4.770685,4.60517,0.1655144,9.375855,4.770685,4.60517,0,0,1,0.8395,2,0.3693,MORE
17,43,50,7,93,50,43,3.7612,3.912023,0.1508229,7.673223,3.912023,3.7612,1,1,1,0.6856,4,0.8351,MORE
17,59,50,9,109,59,50,4.077537,3.912023,0.1655144,7.98956,4.077537,3.912023,0,0,1,0.9366,4,0.6974,MORE
17,50,49,1,99,49,50,3.912023,3.89182,0.02020271,7.803843,3.89182,3.912023,1,0,0,0.6996,4,0.9003,MORE
17,150,174,24,324,174,150,5.010635,5.159055,0.14842,10.16969,5.159055,5.010635,1,1,1,1.2195,1,0.6118,MORE
17,50,45,5,95,45,50,3.912023,3.806662,0.1053605,7.718685,3.806662,3.912023,1,0,0,1.1001,2,0.2499,MORE
17,50,54,4,104,50,54,3.912023,3.988984,0.07696104,7.901007,3.912023,3.988984,0,1,0,1.0148,3,0.5993,MORE
17,82,100,18,182,100,82,4.406719,4.60517,0.1984509,9.011889,4.60517,4.406719,1,1,1,0.9695,2,0.3311,MORE
17,57,50,7,107,57,50,4.043051,3.912023,0.1310283,7.955074,4.043051,3.912023,0,0,1,0.8587,2,0.9299,MORE
17,150,168,18,318,150,168,5.010635,5.123964,0.1133287,10.1346,5.010635,5.123964,0,1,0,1.0071,1,0.7199,MORE
17,162,150,12,312,162,150,5.087596,5.010635,0.07696104,10.09823,5.087596,5.010635,0,0,1,1.5965,1,0.334,MORE
17,98,100,2,198,98,100,4.584967,4.60517,0.02020271,9.190138,4.584967,4.60517,0,1,0,0.9606,2,0.2997,MORE
17,100,102,2,202,102,100,4.60517,4.624973,0.01980263,9.230143,4.624973,4.60517,1,1,1,0.8037,2,0.3558,MORE
17,60,50,10,110,60,50,4.094345,3.912023,0.1823216,8.006368,4.094345,3.912023,0,0,1,0.9099,3,0.4717,MORE
17,150,135,15,285,150,135,5.010635,4.905275,0.1053605,9.91591,5.010635,4.905275,0,0,1,0.9879,2,0.442,MORE
17,180,150,30,330,180,150,5.192957,5.010635,0.1823216,10.20359,5.192957,5.010635,0,0,1,0.8496,3,0.3222,MORE
17,100,84,16,184,100,84,4.60517,4.430817,0.1743534,9.035987,4.60517,4.430817,0,0,1,0.9103,2,0.3009,MORE
17,144,150,6,294,144,150,4.969813,5.010635,0.04082199,9.980449,4.969813,5.010635,0,1,0,0.9604,1,0.5754,MORE
17,112,100,12,212,100,112,4.718499,4.60517,0.1133287,9.323669,4.60517,4.718499,1,0,0,0.9254,1,0.6316,MORE
17,168,150,18,318,168,150,5.123964,5.010635,0.1133287,10.1346,5.123964,5.010635,0,0,1,0.8221,2,0.4882,MORE
17,150,156,6,306,156,150,5.010635,5.049856,0.03922071,10.06049,5.049856,5.010635,1,1,1,1.0453,1,0.4228,MORE
17,50,55,5,105,55,50,3.912023,4.007333,0.09531018,7.919356,4.007333,3.912023,1,1,1,0.9781,2,0.3708,MORE
17,150,162,12,312,150,162,5.010635,5.087596,0.07696104,10.09823,5.010635,5.087596,0,1,0,0.9472,1,0.369,MORE
17,50,41,9,91,50,41,3.912023,3.713572,0.1984509,7.625595,3.912023,3.713572,0,0,1,1.2386,1,0.3737,MORE
17,49,50,1,99,49,50,3.89182,3.912023,0.02020271,7.803843,3.89182,3.912023,0,1,0,1.0765,1,0.5124,MORE
17,100,96,4,196,96,100,4.60517,4.564348,0.04082199,9.169518,4.564348,4.60517,1,0,0,1.0405,1,0.5192,MORE
17,58,50,8,108,50,58,4.060443,3.912023,0.14842,7.972466,3.912023,4.060443,1,0,0,1.3954,1,0.399,MORE
17,41,50,9,91,50,41,3.713572,3.912023,0.1984509,7.625595,3.912023,3.713572,1,1,1,0.9548,2,0.4011,MORE
17,150,123,27,273,150,123,5.010635,4.812184,0.1984509,9.82282,5.010635,4.812184,0,0,1,0.8688,2,0.6,MORE
17,126,150,24,276,150,126,4.836282,5.010635,0.1743534,9.846917,5.010635,4.836282,1,1,1,0.8177,2,0.4727,MORE
17,50,42,8,92,42,50,3.912023,3.73767,0.1743534,7.649693,3.73767,3.912023,1,0,0,1.042,2,0.2503,MORE
17,165,150,15,315,165,150,5.105945,5.010635,0.09531018,10.11658,5.105945,5.010635,0,0,1,0.8731,3,0.4396,MORE
17,50,43,7,93,50,43,3.912023,3.7612,0.1508229,7.673223,3.912023,3.7612,0,0,1,1.0486,2,0.2838,MORE
17,49,50,1,99,50,49,3.89182,3.912023,0.02020271,7.803843,3.912023,3.89182,1,1,1,0.8243,3,0.5299,MORE
17,58,50,8,108,58,50,4.060443,3.912023,0.14842,7.972466,4.060443,3.912023,0,0,1,1.2271,1,0.5051,MORE
17,51,50,1,101,50,51,3.931826,3.912023,0.01980263,7.843849,3.912023,3.931826,1,0,0,1.131,2,0.3075,MORE
17,150,165,15,315,165,150,5.010635,5.105945,0.09531018,10.11658,5.105945,5.010635,1,1,1,0.988,2,1.9839,MORE
17,56,50,6,106,56,50,4.025352,3.912023,0.1133287,7.937375,4.025352,3.912023,0,0,1,1.1161,2,0.3637,MORE
17,104,100,4,204,100,104,4.644391,4.60517,0.03922071,9.249561,4.60517,4.644391,1,0,0,1.9905,3,0.4727,MORE
17,50,49,1,99,50,49,3.912023,3.89182,0.02020271,7.803843,3.912023,3.89182,0,0,1,1.1754,2,0.3413,MORE
17,174,150,24,324,174,150,5.159055,5.010635,0.14842,10.16969,5.159055,5.010635,0,0,1,0.9204,2,0.3984,MORE
17,40,50,10,90,50,40,3.688879,3.912023,0.2231436,7.600902,3.912023,3.688879,1,1,1,1.4801,4,0.8877,MORE
17,100,86,14,186,100,86,4.60517,4.454347,0.1508229,9.059517,4.60517,4.454347,0,0,1,0.9388,2,0.2638,MORE
17,126,150,24,276,126,150,4.836282,5.010635,0.1743534,9.846917,4.836282,5.010635,0,1,0,0.9542,2,0.3036,MORE
17,150,120,30,270,150,120,5.010635,4.787492,0.2231436,9.798127,5.010635,4.787492,0,0,1,1.6899,3,0.4675,MORE
17,123,150,27,273,150,123,4.812184,5.010635,0.1984509,9.82282,5.010635,4.812184,1,1,1,0.7198,4,0.7843,MORE
17,96,100,4,196,100,96,4.564348,4.60517,0.04082199,9.169518,4.60517,4.564348,1,1,1,0.8031,4,0.4525,MORE
17,150,138,12,288,150,138,5.010635,4.927254,0.08338161,9.937889,5.010635,4.927254,0,0,1,1.0682,3,0.8819,MORE
17,150,147,3,297,147,150,5.010635,4.990433,0.02020271,10.00107,4.990433,5.010635,1,0,0,0.7372,3,0.3251,MORE
17,100,88,12,188,100,88,4.60517,4.477337,0.1278334,9.082507,4.60517,4.477337,0,0,1,1.0605,2,0.699,MORE
17,57,50,7,107,57,50,4.043051,3.912023,0.1310283,7.955074,4.043051,3.912023,0,0,1,1.0889,3,1.0405,MORE
17,100,92,8,192,100,92,4.60517,4.521789,0.08338161,9.126959,4.60517,4.521789,0,0,1,0.9768,2,0.6621,MORE
17,100,92,8,192,100,92,4.60517,4.521789,0.08338161,9.126959,4.60517,4.521789,0,0,1,0.9923,3,0.3684,MORE
17,50,46,4,96,50,46,3.912023,3.828641,0.08338161,7.740664,3.912023,3.828641,0,0,1,1.1915,2,0.8382,MORE
17,53,50,3,103,50,53,3.970292,3.912023,0.05826891,7.882315,3.912023,3.970292,1,0,0,0.9302,3,0.7078,MORE
17,45,50,5,95,50,45,3.806662,3.912023,0.1053605,7.718685,3.912023,3.806662,1,1,1,0.8486,3,0.6673,MORE
17,50,47,3,97,47,50,3.912023,3.850148,0.0618754,7.762171,3.850148,3.912023,1,0,0,1.2257,1,0.6002,MORE
17,50,41,9,91,41,50,3.912023,3.713572,0.1984509,7.625595,3.713572,3.912023,1,0,0,1.8518,1,0.3121,MORE
17,100,112,12,212,112,100,4.60517,4.718499,0.1133287,9.323669,4.718499,4.60517,1,1,1,0.8306,2,0.9811,MORE
17,50,46,4,96,50,46,3.912023,3.828641,0.08338161,7.740664,3.912023,3.828641,0,0,1,0.9788,1,0.436,MORE
17,80,100,20,180,100,80,4.382027,4.60517,0.2231436,8.987197,4.60517,4.382027,1,1,1,0.87,2,0.3247,MORE
17,56,50,6,106,50,56,4.025352,3.912023,0.1133287,7.937375,3.912023,4.025352,1,0,0,0.8924,2,0.4747,MORE
17,100,110,10,210,110,100,4.60517,4.70048,0.09531018,9.305651,4.70048,4.60517,1,1,1,0.7167,3,0.5354,MORE
17,50,44,6,94,44,50,3.912023,3.78419,0.1278334,7.696213,3.78419,3.912023,1,0,0,0.7316,3,0.3812,MORE
17,150,177,27,327,177,150,5.010635,5.17615,0.1655144,10.18679,5.17615,5.010635,1,1,1,1.2126,3,0.3493,MORE
17,50,45,5,95,45,50,3.912023,3.806662,0.1053605,7.718685,3.806662,3.912023,1,0,0,0.9604,4,0.7131,MORE
17,41,50,9,91,50,41,3.713572,3.912023,0.1984509,7.625595,3.912023,3.713572,1,1,1,0.9753,3,0.6334,MORE
17,52,50,2,102,50,52,3.951244,3.912023,0.03922071,7.863267,3.912023,3.951244,1,0,0,1.2152,2,0.6521,MORE
17,50,52,2,102,52,50,3.912023,3.951244,0.03922071,7.863267,3.951244,3.912023,1,1,1,1.7194,1,0.435,MORE
17,108,100,8,208,100,108,4.682131,4.60517,0.07696104,9.287301,4.60517,4.682131,1,0,0,0.9581,1,0.7035,MORE
17,150,168,18,318,168,150,5.010635,5.123964,0.1133287,10.1346,5.123964,5.010635,1,1,1,1.3553,1,0.4676,MORE
17,86,100,14,186,86,100,4.454347,4.60517,0.1508229,9.059517,4.454347,4.60517,0,1,0,1.2885,1,0.5184,MORE
17,168,150,18,318,168,150,5.123964,5.010635,0.1133287,10.1346,5.123964,5.010635,0,0,1,0.8614,1,0.3629,MORE
17,153,150,3,303,150,153,5.030438,5.010635,0.01980263,10.04107,5.010635,5.030438,1,0,0,0.9215,2,0.7814,MORE
17,100,112,12,212,112,100,4.60517,4.718499,0.1133287,9.323669,4.718499,4.60517,1,1,1,1.1224,1,0.5191,MORE
17,60,50,10,110,60,50,4.094345,3.912023,0.1823216,8.006368,4.094345,3.912023,0,0,1,0.8314,4,0.6884,MORE
17,102,100,2,202,100,102,4.624973,4.60517,0.01980263,9.230143,4.60517,4.624973,1,0,0,1.3476,2,0.4631,MORE
17,100,106,6,206,106,100,4.60517,4.663439,0.05826891,9.268609,4.663439,4.60517,1,1,1,0.9651,2,0.7346,MORE
17,50,51,1,101,51,50,3.912023,3.931826,0.01980263,7.843849,3.931826,3.912023,1,1,1,1.6768,3,0.9668,MORE
17,114,100,14,214,114,100,4.736198,4.60517,0.1310283,9.341369,4.736198,4.60517,0,0,1,1.0341,1,0.6019,MORE
17,150,138,12,288,150,138,5.010635,4.927254,0.08338161,9.937889,5.010635,4.927254,0,0,1,0.9122,1,0.3844,MORE
17,53,50,3,103,50,53,3.970292,3.912023,0.05826891,7.882315,3.912023,3.970292,1,0,0,0.9158,3,0.8334,MORE
17,100,82,18,182,100,82,4.60517,4.406719,0.1984509,9.011889,4.60517,4.406719,0,0,1,0.9347,3,0.6722,MORE
17,40,50,10,90,50,40,3.688879,3.912023,0.2231436,7.600902,3.912023,3.688879,1,1,1,0.8957,4,0.8065,MORE
17,100,108,8,208,108,100,4.60517,4.682131,0.07696104,9.287301,4.682131,4.60517,1,1,1,1.0875,1,0.5671,MORE
17,153,150,3,303,150,153,5.030438,5.010635,0.01980263,10.04107,5.010635,5.030438,1,0,0,0.8851,2,0.3301,MORE
17,100,98,2,198,98,100,4.60517,4.584967,0.02020271,9.190138,4.584967,4.60517,1,0,0,0.9794,1,0.5009,MORE
17,132,150,18,282,150,132,4.882802,5.010635,0.1278334,9.893437,5.010635,4.882802,1,1,1,0.6895,3,0.7329,MORE
17,50,53,3,103,53,50,3.912023,3.970292,0.05826891,7.882315,3.970292,3.912023,1,1,1,0.6721,3,0.502,MORE
17,110,100,10,210,100,110,4.70048,4.60517,0.09531018,9.305651,4.60517,4.70048,1,0,0,1.2512,1,0.5009,MORE
17,156,150,6,306,150,156,5.049856,5.010635,0.03922071,10.06049,5.010635,5.049856,1,0,0,0.9037,1,0.4898,MORE
17,94,100,6,194,100,94,4.543295,4.60517,0.0618754,9.148465,4.60517,4.543295,1,1,1,0.5734,2,0.7086,MORE
17,50,58,8,108,58,50,3.912023,4.060443,0.14842,7.972466,4.060443,3.912023,1,1,1,0.7695,4,0.6558,MORE
17,100,82,18,182,100,82,4.60517,4.406719,0.1984509,9.011889,4.60517,4.406719,0,0,1,0.9783,2,0.4578,MORE
17,45,50,5,95,50,45,3.806662,3.912023,0.1053605,7.718685,3.912023,3.806662,1,1,1,0.7995,2,0.6844,MORE
17,150,174,24,324,174,150,5.010635,5.159055,0.14842,10.16969,5.159055,5.010635,1,1,1,0.7182,1,1.056,MORE
17,50,53,3,103,53,50,3.912023,3.970292,0.05826891,7.882315,3.970292,3.912023,1,1,1,1.1795,3,0.5555,MORE
17,52,50,2,102,50,52,3.951244,3.912023,0.03922071,7.863267,3.912023,3.951244,1,0,0,0.7344,1,0.8307,MORE
17,123,150,27,273,150,123,4.812184,5.010635,0.1984509,9.82282,5.010635,4.812184,1,1,1,0.7351,2,0.6678,MORE
17,150,153,3,303,153,150,5.010635,5.030438,0.01980263,10.04107,5.030438,5.010635,1,1,1,1.061,1,0.4476,MORE
17,162,150,12,312,162,150,5.087596,5.010635,0.07696104,10.09823,5.087596,5.010635,0,0,1,0.899,1,0.4212,MORE
17,100,88,12,188,88,100,4.60517,4.477337,0.1278334,9.082507,4.477337,4.60517,1,0,0,0.7104,1,0.6177,MORE
17,100,90,10,190,90,100,4.60517,4.49981,0.1053605,9.10498,4.49981,4.60517,1,0,0,1.0464,1,0.4048,MORE
17,44,50,6,94,50,44,3.78419,3.912023,0.1278334,7.696213,3.912023,3.78419,1,1,1,0.7506,1,0.8715,MORE
17,159,150,9,309,159,150,5.068904,5.010635,0.05826891,10.07954,5.068904,5.010635,0,0,1,1.1076,1,0.396,MORE
17,50,59,9,109,59,50,3.912023,4.077537,0.1655144,7.98956,4.077537,3.912023,1,1,1,0.8424,1,0.7326,MORE
17,114,100,14,214,114,100,4.736198,4.60517,0.1310283,9.341369,4.736198,4.60517,0,0,1,1.0088,1,0.3622,MORE
17,100,118,18,218,118,100,4.60517,4.770685,0.1655144,9.375855,4.770685,4.60517,1,1,1,0.9444,2,0.434,MORE
17,100,108,8,208,108,100,4.60517,4.682131,0.07696104,9.287301,4.682131,4.60517,1,1,1,1.0066,1,0.4674,MORE
17,132,150,18,282,150,132,4.882802,5.010635,0.1278334,9.893437,5.010635,4.882802,1,1,1,0.8724,1,0.3716,MORE
17,138,150,12,288,150,138,4.927254,5.010635,0.08338161,9.937889,5.010635,4.927254,1,1,1,0.8298,1,0.2865,MORE
17,150,171,21,321,171,150,5.010635,5.141664,0.1310283,10.1523,5.141664,5.010635,1,1,1,0.8112,1,0.3665,MORE
17,100,104,4,204,104,100,4.60517,4.644391,0.03922071,9.249561,4.644391,4.60517,1,1,1,0.6706,1,0.3841,MORE
18,144,150,6,294,144,150,4.969813,5.010635,0.04082199,9.980449,4.969813,5.010635,0,1,0,1.3915,2,1.0736,MORE
18,168,150,18,318,150,168,5.123964,5.010635,0.1133287,10.1346,5.010635,5.123964,1,0,0,0.9547,3,1.266,MORE
18,132,150,18,282,150,132,4.882802,5.010635,0.1278334,9.893437,5.010635,4.882802,1,1,1,2.2522,3,1.7846,MORE
18,46,50,4,96,50,46,3.828641,3.912023,0.08338161,7.740664,3.912023,3.828641,1,1,1,3.2724,1,1.7487,MORE
18,114,100,14,214,114,100,4.736198,4.60517,0.1310283,9.341369,4.736198,4.60517,0,0,1,1.449,3,1.2357,MORE
18,59,50,9,109,50,59,4.077537,3.912023,0.1655144,7.98956,3.912023,4.077537,1,0,0,1.2714,2,2.5185,MORE
18,50,47,3,97,50,47,3.912023,3.850148,0.0618754,7.762171,3.912023,3.850148,0,0,1,1.9243,1,1.4943,MORE
18,100,120,20,220,120,100,4.60517,4.787492,0.1823216,9.392662,4.787492,4.60517,1,1,1,0.8567,4,1.1932,MORE
18,56,50,6,106,56,50,4.025352,3.912023,0.1133287,7.937375,4.025352,3.912023,0,0,1,4.9605,1,1.6531,MORE
18,50,42,8,92,42,50,3.912023,3.73767,0.1743534,7.649693,3.73767,3.912023,1,0,0,2.9465,2,1.0657,MORE
18,92,100,8,192,100,92,4.521789,4.60517,0.08338161,9.126959,4.60517,4.521789,1,1,1,0.9817,3,1.1712,MORE
18,150,180,30,330,180,150,5.010635,5.192957,0.1823216,10.20359,5.192957,5.010635,1,1,1,1.2302,1,1.3642,MORE
18,100,112,12,212,112,100,4.60517,4.718499,0.1133287,9.323669,4.718499,4.60517,1,1,1,1.2591,2,1.5794,MORE
18,100,104,4,204,100,104,4.60517,4.644391,0.03922071,9.249561,4.60517,4.644391,0,1,0,4.3076,1,0.8857,MORE
18,100,84,16,184,84,100,4.60517,4.430817,0.1743534,9.035987,4.430817,4.60517,1,0,0,2.5415,2,0.9147,MORE
18,100,102,2,202,100,102,4.60517,4.624973,0.01980263,9.230143,4.60517,4.624973,0,1,0,0.9065,4,1.2297,MORE
18,150,165,15,315,165,150,5.010635,5.105945,0.09531018,10.11658,5.105945,5.010635,1,1,1,0.7473,4,0.9939,MORE
18,180,150,30,330,180,150,5.192957,5.010635,0.1823216,10.20359,5.192957,5.010635,0,0,1,4.3323,3,1.195,MORE
18,150,174,24,324,174,150,5.010635,5.159055,0.14842,10.16969,5.159055,5.010635,1,1,1,0.714,4,0.8899,MORE
18,102,100,2,202,102,100,4.624973,4.60517,0.01980263,9.230143,4.624973,4.60517,0,0,1,4.4824,2,0.9354,MORE
18,120,100,20,220,120,100,4.787492,4.60517,0.1823216,9.392662,4.787492,4.60517,0,0,1,1.0152,3,1.4946,MORE
18,94,100,6,194,100,94,4.543295,4.60517,0.0618754,9.148465,4.60517,4.543295,1,1,1,0.8159,4,0.8574,MORE
18,100,84,16,184,100,84,4.60517,4.430817,0.1743534,9.035987,4.60517,4.430817,0,0,1,3.326,3,1.1851,MORE
18,50,47,3,97,47,50,3.912023,3.850148,0.0618754,7.762171,3.850148,3.912023,1,0,0,2.9535,3,4.2693,MORE
18,50,52,2,102,52,50,3.912023,3.951244,0.03922071,7.863267,3.951244,3.912023,1,1,1,0.8483,4,0.9877,MORE
18,100,106,6,206,106,100,4.60517,4.663439,0.05826891,9.268609,4.663439,4.60517,1,1,1,1.0846,3,2.7382,MORE
18,59,50,9,109,50,59,4.077537,3.912023,0.1655144,7.98956,3.912023,4.077537,1,0,0,1.687,3,0.9567,MORE
18,88,100,12,188,100,88,4.477337,4.60517,0.1278334,9.082507,4.60517,4.477337,1,1,1,2.0607,2,1.5651,MORE
18,48,50,2,98,48,50,3.871201,3.912023,0.04082199,7.783224,3.871201,3.912023,0,1,0,1.3536,3,1.0859,MORE
18,45,50,5,95,50,45,3.806662,3.912023,0.1053605,7.718685,3.912023,3.806662,1,1,1,0.7271,4,1.6876,MORE
18,159,150,9,309,150,159,5.068904,5.010635,0.05826891,10.07954,5.010635,5.068904,1,0,0,4.479,1,1.4098,MORE
18,150,123,27,273,150,123,5.010635,4.812184,0.1984509,9.82282,5.010635,4.812184,0,0,1,1.0124,3,1.3468,MORE
18,100,106,6,206,106,100,4.60517,4.663439,0.05826891,9.268609,4.663439,4.60517,1,1,1,1.0176,2,2.3523,MORE
18,100,118,18,218,118,100,4.60517,4.770685,0.1655144,9.375855,4.770685,4.60517,1,1,1,1.9083,3,1.151,MORE
18,150,177,27,327,177,150,5.010635,5.17615,0.1655144,10.18679,5.17615,5.010635,1,1,1,1.0321,4,0.7143,MORE
18,80,100,20,180,100,80,4.382027,4.60517,0.2231436,8.987197,4.60517,4.382027,1,1,1,1.2103,4,1.5184,MORE
18,108,100,8,208,108,100,4.682131,4.60517,0.07696104,9.287301,4.682131,4.60517,0,0,1,0.935,4,0.9521,MORE
18,100,86,14,186,100,86,4.60517,4.454347,0.1508229,9.059517,4.60517,4.454347,0,0,1,2.3032,2,0.9023,MORE
18,50,41,9,91,50,41,3.912023,3.713572,0.1984509,7.625595,3.912023,3.713572,0,0,1,0.9063,4,0.9252,MORE
18,82,100,18,182,100,82,4.406719,4.60517,0.1984509,9.011889,4.60517,4.406719,1,1,1,1.3838,3,1.1385,MORE
18,50,57,7,107,57,50,3.912023,4.043051,0.1310283,7.955074,4.043051,3.912023,1,1,1,1.7598,2,1.0153,MORE
18,80,100,20,180,100,80,4.382027,4.60517,0.2231436,8.987197,4.60517,4.382027,1,1,1,0.749,4,0.89,MORE
18,150,159,9,309,150,159,5.010635,5.068904,0.05826891,10.07954,5.010635,5.068904,0,1,0,0.9381,3,0.9048,MORE
18,50,55,5,105,55,50,3.912023,4.007333,0.09531018,7.919356,4.007333,3.912023,1,1,1,2.0068,2,1.0823,MORE
18,50,49,1,99,50,49,3.912023,3.89182,0.02020271,7.803843,3.912023,3.89182,0,0,1,2.6141,1,0.7843,MORE
18,92,100,8,192,100,92,4.521789,4.60517,0.08338161,9.126959,4.60517,4.521789,1,1,1,3.3632,1,1.2187,MORE
18,120,150,30,270,150,120,4.787492,5.010635,0.2231436,9.798127,5.010635,4.787492,1,1,1,0.8563,4,0.7705,MORE
18,90,100,10,190,90,100,4.49981,4.60517,0.1053605,9.10498,4.49981,4.60517,0,1,0,2.9448,2,0.92,MORE
18,168,150,18,318,168,150,5.123964,5.010635,0.1133287,10.1346,5.123964,5.010635,0,0,1,3.2226,3,0.8669,MORE
18,50,49,1,99,49,50,3.912023,3.89182,0.02020271,7.803843,3.89182,3.912023,1,0,0,1.1088,1,1.869,MORE
18,150,156,6,306,150,156,5.010635,5.049856,0.03922071,10.06049,5.010635,5.049856,0,1,0,0.861,2,1.3105,MORE
18,150,144,6,294,150,144,5.010635,4.969813,0.04082199,9.980449,5.010635,4.969813,0,0,1,2.6407,1,0.9072,MORE
18,49,50,1,99,50,49,3.89182,3.912023,0.02020271,7.803843,3.912023,3.89182,1,1,1,2.661,2,0.6995,MORE
18,50,40,10,90,50,40,3.912023,3.688879,0.2231436,7.600902,3.912023,3.688879,0,0,1,0.8348,3,1.1686,MORE
18,100,98,2,198,100,98,4.60517,4.584967,0.02020271,9.190138,4.60517,4.584967,0,0,1,1.0235,3,0.9535,MORE
18,150,123,27,273,123,150,5.010635,4.812184,0.1984509,9.82282,4.812184,5.010635,1,0,0,2.7434,4,1.236,MORE
18,141,150,9,291,150,141,4.94876,5.010635,0.0618754,9.959395,5.010635,4.94876,1,1,1,2.5656,2,1.0038,MORE
18,104,100,4,204,104,100,4.644391,4.60517,0.03922071,9.249561,4.644391,4.60517,0,0,1,2.2962,2,0.4664,MORE
18,42,50,8,92,50,42,3.73767,3.912023,0.1743534,7.649693,3.912023,3.73767,1,1,1,0.7864,3,0.8443,MORE
18,150,171,21,321,171,150,5.010635,5.141664,0.1310283,10.1523,5.141664,5.010635,1,1,1,3.1044,2,0.4816,MORE
18,150,165,15,315,165,150,5.010635,5.105945,0.09531018,10.11658,5.105945,5.010635,1,1,1,0.724,4,0.8855,MORE
18,50,56,6,106,56,50,3.912023,4.025352,0.1133287,7.937375,4.025352,3.912023,1,1,1,0.799,4,0.8195,MORE
18,100,88,12,188,100,88,4.60517,4.477337,0.1278334,9.082507,4.60517,4.477337,0,0,1,0.933,2,1.1197,MORE
18,100,104,4,204,104,100,4.60517,4.644391,0.03922071,9.249561,4.644391,4.60517,1,1,1,1.5776,2,1.6324,MORE
18,50,46,4,96,50,46,3.912023,3.828641,0.08338161,7.740664,3.912023,3.828641,0,0,1,2.4225,3,0.8483,MORE
18,41,50,9,91,50,41,3.713572,3.912023,0.1984509,7.625595,3.912023,3.713572,1,1,1,0.7505,3,0.9347,MORE
18,165,150,15,315,165,150,5.105945,5.010635,0.09531018,10.11658,5.105945,5.010635,0,0,1,0.9751,2,1.3855,MORE
18,106,100,6,206,106,100,4.663439,4.60517,0.05826891,9.268609,4.663439,4.60517,0,0,1,3.6514,2,1.0686,MORE
18,150,129,21,279,150,129,5.010635,4.859812,0.1508229,9.870448,5.010635,4.859812,0,0,1,2.4446,3,0.8513,MORE
18,84,100,16,184,100,84,4.430817,4.60517,0.1743534,9.035987,4.60517,4.430817,1,1,1,1.0144,1,2.2135,MORE
18,150,138,12,288,150,138,5.010635,4.927254,0.08338161,9.937889,5.010635,4.927254,0,0,1,2.1509,1,0.8752,MORE
18,44,50,6,94,44,50,3.78419,3.912023,0.1278334,7.696213,3.78419,3.912023,0,1,0,2.4903,1,0.7688,MORE
18,171,150,21,321,171,150,5.141664,5.010635,0.1310283,10.1523,5.141664,5.010635,0,0,1,3.7462,1,0.9023,MORE
18,43,50,7,93,43,50,3.7612,3.912023,0.1508229,7.673223,3.7612,3.912023,0,1,0,2.0556,1,0.7348,MORE
18,100,98,2,198,98,100,4.60517,4.584967,0.02020271,9.190138,4.584967,4.60517,1,0,0,1.3222,3,0.9153,MORE
18,150,126,24,276,150,126,5.010635,4.836282,0.1743534,9.846917,5.010635,4.836282,0,0,1,2.837,2,0.7494,MORE
18,54,50,4,104,54,50,3.988984,3.912023,0.07696104,7.901007,3.988984,3.912023,0,0,1,3.0325,3,1.0641,MORE
18,50,48,2,98,50,48,3.912023,3.871201,0.04082199,7.783224,3.912023,3.871201,0,0,1,2.5057,1,1.5025,MORE
18,150,138,12,288,138,150,5.010635,4.927254,0.08338161,9.937889,4.927254,5.010635,1,0,0,1.692,3,0.9441,MORE
18,150,144,6,294,144,150,5.010635,4.969813,0.04082199,9.980449,4.969813,5.010635,1,0,0,2.3051,3,0.9308,MORE
18,50,60,10,110,60,50,3.912023,4.094345,0.1823216,8.006368,4.094345,3.912023,1,1,1,0.7797,4,0.8247,MORE
18,50,45,5,95,50,45,3.912023,3.806662,0.1053605,7.718685,3.912023,3.806662,0,0,1,1.0231,3,1.2323,MORE
18,132,150,18,282,150,132,4.882802,5.010635,0.1278334,9.893437,5.010635,4.882802,1,1,1,2.1354,2,0.8151,MORE
18,150,120,30,270,150,120,5.010635,4.787492,0.2231436,9.798127,5.010635,4.787492,0,0,1,0.7177,4,0.7796,MORE
18,126,150,24,276,150,126,4.836282,5.010635,0.1743534,9.846917,5.010635,4.836282,1,1,1,2.1057,2,0.5624,MORE
18,50,53,3,103,53,50,3.912023,3.970292,0.05826891,7.882315,3.970292,3.912023,1,1,1,1.3202,3,0.7823,MORE
18,144,150,6,294,150,144,4.969813,5.010635,0.04082199,9.980449,5.010635,4.969813,1,1,1,1.2752,1,1.1318,MORE
18,114,100,14,214,114,100,4.736198,4.60517,0.1310283,9.341369,4.736198,4.60517,0,0,1,2.1292,2,0.7505,MORE
18,40,50,10,90,50,40,3.688879,3.912023,0.2231436,7.600902,3.912023,3.688879,1,1,1,1.1235,2,0.8155,MORE
18,50,48,2,98,50,48,3.912023,3.871201,0.04082199,7.783224,3.912023,3.871201,0,0,1,0.6995,3,1.1171,MORE
18,150,132,18,282,150,132,5.010635,4.882802,0.1278334,9.893437,5.010635,4.882802,0,0,1,2.2038,2,1.1345,MORE
18,100,112,12,212,112,100,4.60517,4.718499,0.1133287,9.323669,4.718499,4.60517,1,1,1,1.4153,3,0.8906,MORE
18,153,150,3,303,150,153,5.030438,5.010635,0.01980263,10.04107,5.010635,5.030438,1,0,0,2.0851,3,13.8836,MORE
18,100,96,4,196,100,96,4.60517,4.564348,0.04082199,9.169518,4.60517,4.564348,0,0,1,1.115,3,1.0785,MORE
18,150,159,9,309,159,150,5.010635,5.068904,0.05826891,10.07954,5.068904,5.010635,1,1,1,1.9163,2,65.7489,MORE
18,56,50,6,106,56,50,4.025352,3.912023,0.1133287,7.937375,4.025352,3.912023,0,0,1,1.1842,3,1.3772,MORE
18,118,100,18,218,118,100,4.770685,4.60517,0.1655144,9.375855,4.770685,4.60517,0,0,1,2.0248,4,0.5921,MORE
18,50,58,8,108,58,50,3.912023,4.060443,0.14842,7.972466,4.060443,3.912023,1,1,1,1.3144,2,0.9391,MORE
18,100,116,16,216,116,100,4.60517,4.75359,0.14842,9.35876,4.75359,4.60517,1,1,1,0.7737,4,0.8469,MORE
18,141,150,9,291,150,141,4.94876,5.010635,0.0618754,9.959395,5.010635,4.94876,1,1,1,1.1616,3,1.0349,MORE
18,162,150,12,312,162,150,5.087596,5.010635,0.07696104,10.09823,5.087596,5.010635,0,0,1,2.2407,1,0.4676,MORE
18,50,46,4,96,50,46,3.912023,3.828641,0.08338161,7.740664,3.912023,3.828641,0,0,1,0.6966,3,0.8702,MORE
18,147,150,3,297,150,147,4.990433,5.010635,0.02020271,10.00107,5.010635,4.990433,1,1,1,0.9017,3,0.8818,MORE
18,45,50,5,95,50,45,3.806662,3.912023,0.1053605,7.718685,3.912023,3.806662,1,1,1,0.7799,3,0.7818,MORE
18,104,100,4,204,104,100,4.644391,4.60517,0.03922071,9.249561,4.644391,4.60517,0,0,1,1.4191,1,0.6692,MORE
18,50,42,8,92,42,50,3.912023,3.73767,0.1743534,7.649693,3.73767,3.912023,1,0,0,1.2279,2,0.7579,MORE
18,150,147,3,297,147,150,5.010635,4.990433,0.02020271,10.00107,4.990433,5.010635,1,0,0,2.253,2,5.8395,MORE
18,135,150,15,285,150,135,4.905275,5.010635,0.1053605,9.91591,5.010635,4.905275,1,1,1,1.0546,3,0.8379,MORE
18,118,100,18,218,118,100,4.770685,4.60517,0.1655144,9.375855,4.770685,4.60517,0,0,1,1.3159,2,0.7177,MORE
18,50,51,1,101,51,50,3.912023,3.931826,0.01980263,7.843849,3.931826,3.912023,1,1,1,1.3843,1,0.7161,MORE
18,100,92,8,192,100,92,4.60517,4.521789,0.08338161,9.126959,4.60517,4.521789,0,0,1,1.8692,1,0.4986,MORE
18,100,90,10,190,100,90,4.60517,4.49981,0.1053605,9.10498,4.60517,4.49981,0,0,1,2.222,2,0.53,MORE
18,50,54,4,104,54,50,3.912023,3.988984,0.07696104,7.901007,3.988984,3.912023,1,1,1,0.7264,3,0.7989,MORE
18,150,141,9,291,150,141,5.010635,4.94876,0.0618754,9.959395,5.010635,4.94876,0,0,1,0.8804,4,0.7655,MORE
18,100,92,8,192,92,100,4.60517,4.521789,0.08338161,9.126959,4.521789,4.60517,1,0,0,0.7929,3,0.6464,MORE
18,84,100,16,184,100,84,4.430817,4.60517,0.1743534,9.035987,4.60517,4.430817,1,1,1,0.7184,4,0.5912,MORE
18,100,114,14,214,114,100,4.60517,4.736198,0.1310283,9.341369,4.736198,4.60517,1,1,1,1.0897,3,0.8151,MORE
18,50,59,9,109,59,50,3.912023,4.077537,0.1655144,7.98956,4.077537,3.912023,1,1,1,1.494,2,0.6318,MORE
18,43,50,7,93,50,43,3.7612,3.912023,0.1508229,7.673223,3.912023,3.7612,1,1,1,3.6845,1,0.7838,MORE
18,53,50,3,103,53,50,3.970292,3.912023,0.05826891,7.882315,3.970292,3.912023,0,0,1,1.8948,1,0.735,MORE
18,159,150,9,309,159,150,5.068904,5.010635,0.05826891,10.07954,5.068904,5.010635,0,0,1,1.181,4,0.759,MORE
18,47,50,3,97,50,47,3.850148,3.912023,0.0618754,7.762171,3.912023,3.850148,1,1,1,1.0779,3,0.7163,MORE
18,156,150,6,306,156,150,5.049856,5.010635,0.03922071,10.06049,5.049856,5.010635,0,0,1,1.1018,2,0.5881,MORE
18,162,150,12,312,162,150,5.087596,5.010635,0.07696104,10.09823,5.087596,5.010635,0,0,1,1.001,3,0.6308,MORE
18,150,162,12,312,162,150,5.010635,5.087596,0.07696104,10.09823,5.087596,5.010635,1,1,1,0.9194,3,0.7855,MORE
18,123,150,27,273,150,123,4.812184,5.010635,0.1984509,9.82282,5.010635,4.812184,1,1,1,0.6775,4,0.5479,MORE
18,150,174,24,324,174,150,5.010635,5.159055,0.14842,10.16969,5.159055,5.010635,1,1,1,0.7584,2,0.6784,MORE
18,100,116,16,216,116,100,4.60517,4.75359,0.14842,9.35876,4.75359,4.60517,1,1,1,0.9774,2,0.5909,MORE
18,50,51,1,101,50,51,3.912023,3.931826,0.01980263,7.843849,3.912023,3.931826,0,1,0,0.8566,1,0.713,MORE
18,52,50,2,102,52,50,3.951244,3.912023,0.03922071,7.863267,3.951244,3.912023,0,0,1,2.8842,1,1.1086,MORE
18,98,100,2,198,98,100,4.584967,4.60517,0.02020271,9.190138,4.584967,4.60517,0,1,0,2.783,1,0.6819,MORE
18,102,100,2,202,102,100,4.624973,4.60517,0.01980263,9.230143,4.624973,4.60517,0,0,1,1.0065,3,0.5363,MORE
18,100,94,6,194,100,94,4.60517,4.543295,0.0618754,9.148465,4.60517,4.543295,0,0,1,2.0252,2,0.6318,MORE
18,106,100,6,206,100,106,4.663439,4.60517,0.05826891,9.268609,4.60517,4.663439,1,0,0,1.7195,1,1.0596,MORE
18,150,153,3,303,153,150,5.010635,5.030438,0.01980263,10.04107,5.030438,5.010635,1,1,1,1.2968,2,0.6483,MORE
18,110,100,10,210,110,100,4.70048,4.60517,0.09531018,9.305651,4.70048,4.60517,0,0,1,0.7271,3,0.802,MORE
18,50,43,7,93,50,43,3.912023,3.7612,0.1508229,7.673223,3.912023,3.7612,0,0,1,1.0866,3,1.8199,MORE
18,174,150,24,324,174,150,5.159055,5.010635,0.14842,10.16969,5.159055,5.010635,0,0,1,1.4523,2,0.7777,MORE
18,150,177,27,327,177,150,5.010635,5.17615,0.1655144,10.18679,5.17615,5.010635,1,1,1,0.8335,3,0.5739,MORE
18,50,40,10,90,50,40,3.912023,3.688879,0.2231436,7.600902,3.912023,3.688879,0,0,1,2.793,1,0.6691,MORE
18,41,50,9,91,50,41,3.713572,3.912023,0.1984509,7.625595,3.912023,3.713572,1,1,1,0.8544,3,0.5337,MORE
18,58,50,8,108,58,50,4.060443,3.912023,0.14842,7.972466,4.060443,3.912023,0,0,1,0.9356,4,0.7054,MORE
18,129,150,21,279,150,129,4.859812,5.010635,0.1508229,9.870448,5.010635,4.859812,1,1,1,0.8561,4,0.8022,MORE
18,50,43,7,93,50,43,3.912023,3.7612,0.1508229,7.673223,3.912023,3.7612,0,0,1,0.7937,3,1.1154,MORE
18,47,50,3,97,47,50,3.850148,3.912023,0.0618754,7.762171,3.850148,3.912023,0,1,0,1.3103,1,0.8626,MORE
18,90,100,10,190,100,90,4.49981,4.60517,0.1053605,9.10498,4.60517,4.49981,1,1,1,0.8835,3,0.5675,MORE
18,55,50,5,105,55,50,4.007333,3.912023,0.09531018,7.919356,4.007333,3.912023,0,0,1,0.9718,2,0.7605,MORE
18,112,100,12,212,112,100,4.718499,4.60517,0.1133287,9.323669,4.718499,4.60517,0,0,1,1.4072,2,1.0094,MORE
18,96,100,4,196,100,96,4.564348,4.60517,0.04082199,9.169518,4.60517,4.564348,1,1,1,2.0945,2,0.5908,MORE
18,57,50,7,107,57,50,4.043051,3.912023,0.1310283,7.955074,4.043051,3.912023,0,0,1,0.9691,2,0.6941,MORE
18,50,41,9,91,50,41,3.912023,3.713572,0.1984509,7.625595,3.912023,3.713572,0,0,1,1.5572,2,0.6988,MORE
18,50,59,9,109,59,50,3.912023,4.077537,0.1655144,7.98956,4.077537,3.912023,1,1,1,1.0017,3,0.735,MORE
18,171,150,21,321,171,150,5.141664,5.010635,0.1310283,10.1523,5.141664,5.010635,0,0,1,2.1561,2,0.5262,MORE
18,150,147,3,297,150,147,5.010635,4.990433,0.02020271,10.00107,5.010635,4.990433,0,0,1,0.9065,2,0.4963,MORE
18,180,150,30,330,180,150,5.192957,5.010635,0.1823216,10.20359,5.192957,5.010635,0,0,1,1.1342,2,0.4362,MORE
18,51,50,1,101,50,51,3.931826,3.912023,0.01980263,7.843849,3.912023,3.931826,1,0,0,2.1225,1,0.7166,MORE
18,100,94,6,194,94,100,4.60517,4.543295,0.0618754,9.148465,4.543295,4.60517,1,0,0,1.6577,1,0.6407,MORE
18,120,100,20,220,100,120,4.787492,4.60517,0.1823216,9.392662,4.60517,4.787492,1,0,0,2.0261,1,0.4138,MORE
18,150,135,15,285,135,150,5.010635,4.905275,0.1053605,9.91591,4.905275,5.010635,1,0,0,5.5108,1,1.0545,MORE
18,94,100,6,194,94,100,4.543295,4.60517,0.0618754,9.148465,4.543295,4.60517,0,1,0,1.4483,2,0.8572,MORE
18,60,50,10,110,60,50,4.094345,3.912023,0.1823216,8.006368,4.094345,3.912023,0,0,1,1.0808,3,0.8854,MORE
18,48,50,2,98,50,48,3.871201,3.912023,0.04082199,7.783224,3.912023,3.871201,1,1,1,1.0834,2,1.0696,MORE
18,150,168,18,318,168,150,5.010635,5.123964,0.1133287,10.1346,5.123964,5.010635,1,1,1,0.7537,4,0.731,MORE
18,150,132,18,282,150,132,5.010635,4.882802,0.1278334,9.893437,5.010635,4.882802,0,0,1,2.0235,2,0.5698,MORE
18,177,150,27,327,177,150,5.17615,5.010635,0.1655144,10.18679,5.17615,5.010635,0,0,1,0.8491,3,0.6993,MORE
18,49,50,1,99,50,49,3.89182,3.912023,0.02020271,7.803843,3.912023,3.89182,1,1,1,2.9471,1,0.3733,MORE
18,138,150,12,288,150,138,4.927254,5.010635,0.08338161,9.937889,5.010635,4.927254,1,1,1,1.3267,1,1.0323,MORE
18,100,88,12,188,100,88,4.60517,4.477337,0.1278334,9.082507,4.60517,4.477337,0,0,1,1.8538,1,0.7213,MORE
18,150,153,3,303,150,153,5.010635,5.030438,0.01980263,10.04107,5.010635,5.030438,0,1,0,1.8236,2,0.5521,MORE
18,100,110,10,210,110,100,4.60517,4.70048,0.09531018,9.305651,4.70048,4.60517,1,1,1,2.1652,2,0.7646,MORE
18,50,56,6,106,50,56,3.912023,4.025352,0.1133287,7.937375,3.912023,4.025352,0,1,0,2.7697,1,0.5647,MORE
18,150,129,21,279,150,129,5.010635,4.859812,0.1508229,9.870448,5.010635,4.859812,0,0,1,1.3277,2,1.002,MORE
18,50,53,3,103,53,50,3.912023,3.970292,0.05826891,7.882315,3.970292,3.912023,1,1,1,0.9747,2,0.7498,MORE
18,100,102,2,202,100,102,4.60517,4.624973,0.01980263,9.230143,4.60517,4.624973,0,1,0,0.8804,2,0.5312,MORE
18,153,150,3,303,153,150,5.030438,5.010635,0.01980263,10.04107,5.030438,5.010635,0,0,1,1.3992,1,0.6483,MORE
18,150,171,21,321,171,150,5.010635,5.141664,0.1310283,10.1523,5.141664,5.010635,1,1,1,0.815,3,0.4516,MORE
18,150,120,30,270,150,120,5.010635,4.787492,0.2231436,9.798127,5.010635,4.787492,0,0,1,0.9877,4,0.5972,MORE
18,100,110,10,210,110,100,4.60517,4.70048,0.09531018,9.305651,4.70048,4.60517,1,1,1,2.3727,2,0.6348,MORE
18,50,60,10,110,60,50,3.912023,4.094345,0.1823216,8.006368,4.094345,3.912023,1,1,1,0.8137,4,0.6972,MORE
18,42,50,8,92,50,42,3.73767,3.912023,0.1743534,7.649693,3.912023,3.73767,1,1,1,1.3937,3,0.8103,MORE
18,108,100,8,208,108,100,4.682131,4.60517,0.07696104,9.287301,4.682131,4.60517,0,0,1,0.9104,3,0.8349,MORE
18,150,162,12,312,150,162,5.010635,5.087596,0.07696104,10.09823,5.010635,5.087596,0,1,0,2.0585,4,0.7687,MORE
18,100,96,4,196,96,100,4.60517,4.564348,0.04082199,9.169518,4.564348,4.60517,1,0,0,3.3613,3,0.2502,MORE
18,50,55,5,105,55,50,3.912023,4.007333,0.09531018,7.919356,4.007333,3.912023,1,1,1,3.0825,2,0.4697,MORE
18,112,100,12,212,112,100,4.718499,4.60517,0.1133287,9.323669,4.718499,4.60517,0,0,1,1.1655,4,0.7235,MORE
18,57,50,7,107,50,57,4.043051,3.912023,0.1310283,7.955074,3.912023,4.043051,1,0,0,2.5107,1,0.2464,MORE
18,100,82,18,182,100,82,4.60517,4.406719,0.1984509,9.011889,4.60517,4.406719,0,0,1,0.9022,3,1.0168,MORE
18,165,150,15,315,150,165,5.105945,5.010635,0.09531018,10.11658,5.010635,5.105945,1,0,0,1.1566,3,1.1313,MORE
18,138,150,12,288,150,138,4.927254,5.010635,0.08338161,9.937889,5.010635,4.927254,1,1,1,1.0063,4,0.4642,MORE
18,96,100,4,196,96,100,4.564348,4.60517,0.04082199,9.169518,4.564348,4.60517,0,1,0,1.5652,2,0.5126,MORE
18,60,50,10,110,60,50,4.094345,3.912023,0.1823216,8.006368,4.094345,3.912023,0,0,1,1.7528,3,0.8822,MORE
18,50,58,8,108,58,50,3.912023,4.060443,0.14842,7.972466,4.060443,3.912023,1,1,1,0.8513,2,0.9046,MORE
18,100,118,18,218,118,100,4.60517,4.770685,0.1655144,9.375855,4.770685,4.60517,1,1,1,0.9182,3,0.7715,MORE
18,150,156,6,306,156,150,5.010635,5.049856,0.03922071,10.06049,5.049856,5.010635,1,1,1,1.2503,2,0.5973,MORE
18,82,100,18,182,100,82,4.406719,4.60517,0.1984509,9.011889,4.60517,4.406719,1,1,1,0.9812,3,0.6989,MORE
18,150,180,30,330,180,150,5.010635,5.192957,0.1823216,10.20359,5.192957,5.010635,1,1,1,0.9274,4,0.3831,MORE
18,100,114,14,214,114,100,4.60517,4.736198,0.1310283,9.341369,4.736198,4.60517,1,1,1,0.8377,3,0.64,MORE
18,50,52,2,102,50,52,3.912023,3.951244,0.03922071,7.863267,3.912023,3.951244,0,1,0,0.8836,2,0.7354,MORE
18,100,108,8,208,108,100,4.60517,4.682131,0.07696104,9.287301,4.682131,4.60517,1,1,1,1.2258,1,0.5979,MORE
18,156,150,6,306,156,150,5.049856,5.010635,0.03922071,10.06049,5.049856,5.010635,0,0,1,1.5676,1,0.4817,MORE
18,98,100,2,198,98,100,4.584967,4.60517,0.02020271,9.190138,4.584967,4.60517,0,1,0,1.0691,2,1.2682,MORE
18,150,126,24,276,150,126,5.010635,4.836282,0.1743534,9.846917,5.010635,4.836282,0,0,1,0.9717,3,0.7816,MORE
18,123,150,27,273,150,123,4.812184,5.010635,0.1984509,9.82282,5.010635,4.812184,1,1,1,0.9948,3,0.8377,MORE
18,100,82,18,182,100,82,4.60517,4.406719,0.1984509,9.011889,4.60517,4.406719,0,0,1,0.801,2,0.536,MORE
18,174,150,24,324,150,174,5.159055,5.010635,0.14842,10.16969,5.010635,5.159055,1,0,0,0.9231,2,0.5318,MORE
18,52,50,2,102,50,52,3.951244,3.912023,0.03922071,7.863267,3.912023,3.951244,1,0,0,1.0078,1,0.6162,MORE
18,50,54,4,104,54,50,3.912023,3.988984,0.07696104,7.901007,3.988984,3.912023,1,1,1,1.0285,2,0.6516,MORE
18,110,100,10,210,110,100,4.70048,4.60517,0.09531018,9.305651,4.70048,4.60517,0,0,1,0.8295,3,0.8318,MORE
18,55,50,5,105,55,50,4.007333,3.912023,0.09531018,7.919356,4.007333,3.912023,0,0,1,1.7627,1,0.3184,MORE
18,116,100,16,216,116,100,4.75359,4.60517,0.14842,9.35876,4.75359,4.60517,0,0,1,0.9334,3,0.4994,MORE
18,100,80,20,180,80,100,4.60517,4.382027,0.2231436,8.987197,4.382027,4.60517,1,0,0,2.8094,2,0.8234,MORE
18,126,150,24,276,150,126,4.836282,5.010635,0.1743534,9.846917,5.010635,4.836282,1,1,1,0.6592,3,0.547,MORE
18,150,135,15,285,150,135,5.010635,4.905275,0.1053605,9.91591,5.010635,4.905275,0,0,1,1.928,4,0.4263,MORE
18,50,44,6,94,44,50,3.912023,3.78419,0.1278334,7.696213,3.78419,3.912023,1,0,0,1.5339,2,0.2851,MORE
18,100,86,14,186,100,86,4.60517,4.454347,0.1508229,9.059517,4.60517,4.454347,0,0,1,0.8075,3,0.7481,MORE
18,58,50,8,108,50,58,4.060443,3.912023,0.14842,7.972466,3.912023,4.060443,1,0,0,1.1142,2,0.8297,MORE
18,86,100,14,186,100,86,4.454347,4.60517,0.1508229,9.059517,4.60517,4.454347,1,1,1,0.7522,4,0.4893,MORE
18,86,100,14,186,86,100,4.454347,4.60517,0.1508229,9.059517,4.454347,4.60517,0,1,0,1.3473,1,1.0977,MORE
18,50,57,7,107,50,57,3.912023,4.043051,0.1310283,7.955074,3.912023,4.043051,0,1,0,2.0364,3,0.5688,MORE
18,44,50,6,94,44,50,3.78419,3.912023,0.1278334,7.696213,3.78419,3.912023,0,1,0,1.7257,2,0.4605,MORE
18,46,50,4,96,46,50,3.828641,3.912023,0.08338161,7.740664,3.828641,3.912023,0,1,0,3.3651,2,0.4583,MORE
18,150,141,9,291,150,141,5.010635,4.94876,0.0618754,9.959395,5.010635,4.94876,0,0,1,1.1179,3,0.4658,MORE
18,51,50,1,101,50,51,3.931826,3.912023,0.01980263,7.843849,3.912023,3.931826,1,0,0,1.3872,2,0.6013,MORE
18,147,150,3,297,147,150,4.990433,5.010635,0.02020271,10.00107,4.990433,5.010635,0,1,0,1.0475,3,1.7836,MORE
18,88,100,12,188,88,100,4.477337,4.60517,0.1278334,9.082507,4.477337,4.60517,0,1,0,1.7316,2,0.4518,MORE
18,129,150,21,279,150,129,4.859812,5.010635,0.1508229,9.870448,5.010635,4.859812,1,1,1,0.8271,4,0.5697,MORE
18,100,120,20,220,120,100,4.60517,4.787492,0.1823216,9.392662,4.787492,4.60517,1,1,1,1.9101,2,0.4667,MORE
18,40,50,10,90,50,40,3.688879,3.912023,0.2231436,7.600902,3.912023,3.688879,1,1,1,0.8645,2,0.6163,MORE
18,50,45,5,95,50,45,3.912023,3.806662,0.1053605,7.718685,3.912023,3.806662,0,0,1,1.646,1,0.348,MORE
18,120,150,30,270,120,150,4.787492,5.010635,0.2231436,9.798127,4.787492,5.010635,0,1,0,1.075,3,0.4726,MORE
18,150,168,18,318,168,150,5.010635,5.123964,0.1133287,10.1346,5.123964,5.010635,1,1,1,0.8217,4,0.5308,MORE
18,100,108,8,208,108,100,4.60517,4.682131,0.07696104,9.287301,4.682131,4.60517,1,1,1,0.8438,2,0.4648,MORE
18,116,100,16,216,116,100,4.75359,4.60517,0.14842,9.35876,4.75359,4.60517,0,0,1,0.7414,4,0.532,MORE
18,50,44,6,94,50,44,3.912023,3.78419,0.1278334,7.696213,3.912023,3.78419,0,0,1,1.9179,3,0.514,MORE
18,100,80,20,180,100,80,4.60517,4.382027,0.2231436,8.987197,4.60517,4.382027,0,0,1,0.7711,2,0.4488,MORE
18,135,150,15,285,150,135,4.905275,5.010635,0.1053605,9.91591,5.010635,4.905275,1,1,1,1.091,3,1.7525,MORE
18,54,50,4,104,54,50,3.988984,3.912023,0.07696104,7.901007,3.988984,3.912023,0,0,1,1.5464,2,0.7365,MORE
18,177,150,27,327,150,177,5.17615,5.010635,0.1655144,10.18679,5.010635,5.17615,1,0,0,2.1495,1,0.3635,MORE
18,100,90,10,190,100,90,4.60517,4.49981,0.1053605,9.10498,4.60517,4.49981,0,0,1,1.2524,3,0.7851,MORE
18,53,50,3,103,53,50,3.970292,3.912023,0.05826891,7.882315,3.970292,3.912023,0,0,1,1.0821,1,0.8342,MORE
19,150,159,9,309,150,159,5.010635,5.068904,0.05826891,10.07954,5.010635,5.068904,0,1,0,2.4888,2,1.4982,MORE
19,120,100,20,220,120,100,4.787492,4.60517,0.1823216,9.392662,4.787492,4.60517,0,0,1,2.0794,3,1.4187,MORE
19,50,57,7,107,50,57,3.912023,4.043051,0.1310283,7.955074,3.912023,4.043051,0,1,0,1.9877,4,1.0349,MORE
19,57,50,7,107,57,50,4.043051,3.912023,0.1310283,7.955074,4.043051,3.912023,0,0,1,4.0219,1,2.3444,MORE
19,49,50,1,99,50,49,3.89182,3.912023,0.02020271,7.803843,3.912023,3.89182,1,1,1,1.9034,2,0.9235,MORE
19,84,100,16,184,100,84,4.430817,4.60517,0.1743534,9.035987,4.60517,4.430817,1,1,1,1.6014,4,1.5039,MORE
19,59,50,9,109,59,50,4.077537,3.912023,0.1655144,7.98956,4.077537,3.912023,0,0,1,1.0687,4,0.5706,MORE
19,50,60,10,110,60,50,3.912023,4.094345,0.1823216,8.006368,4.094345,3.912023,1,1,1,1.7527,3,1.3479,MORE
19,150,135,15,285,150,135,5.010635,4.905275,0.1053605,9.91591,5.010635,4.905275,0,0,1,2.5429,1,0.5288,MORE
19,44,50,6,94,44,50,3.78419,3.912023,0.1278334,7.696213,3.78419,3.912023,0,1,0,3.5767,2,0.9833,MORE
19,46,50,4,96,50,46,3.828641,3.912023,0.08338161,7.740664,3.912023,3.828641,1,1,1,2.4834,1,1.4652,MORE
19,118,100,18,218,118,100,4.770685,4.60517,0.1655144,9.375855,4.770685,4.60517,0,0,1,2.1644,2,1.079,MORE
19,80,100,20,180,100,80,4.382027,4.60517,0.2231436,8.987197,4.60517,4.382027,1,1,1,2.0434,3,0.5164,MORE
19,150,165,15,315,165,150,5.010635,5.105945,0.09531018,10.11658,5.105945,5.010635,1,1,1,2.119,3,0.6328,MORE
19,52,50,2,102,52,50,3.951244,3.912023,0.03922071,7.863267,3.951244,3.912023,0,0,1,2.0165,4,0.5383,MORE
19,132,150,18,282,150,132,4.882802,5.010635,0.1278334,9.893437,5.010635,4.882802,1,1,1,2.9339,4,1.0543,MORE
19,100,114,14,214,114,100,4.60517,4.736198,0.1310283,9.341369,4.736198,4.60517,1,1,1,1.917,4,0.6449,MORE
19,54,50,4,104,54,50,3.988984,3.912023,0.07696104,7.901007,3.988984,3.912023,0,0,1,1.8506,3,0.7,MORE
19,48,50,2,98,48,50,3.871201,3.912023,0.04082199,7.783224,3.871201,3.912023,0,1,0,2.5562,3,0.4303,MORE
19,50,58,8,108,50,58,3.912023,4.060443,0.14842,7.972466,3.912023,4.060443,0,1,0,5.5221,1,1.0684,MORE
19,96,100,4,196,100,96,4.564348,4.60517,0.04082199,9.169518,4.60517,4.564348,1,1,1,1.9645,3,0.5825,MORE
19,53,50,3,103,53,50,3.970292,3.912023,0.05826891,7.882315,3.970292,3.912023,0,0,1,2.1054,3,0.474,MORE
19,156,150,6,306,156,150,5.049856,5.010635,0.03922071,10.06049,5.049856,5.010635,0,0,1,1.8492,3,0.8297,MORE
19,144,150,6,294,144,150,4.969813,5.010635,0.04082199,9.980449,4.969813,5.010635,0,1,0,2.6768,2,0.3671,MORE
19,100,88,12,188,100,88,4.60517,4.477337,0.1278334,9.082507,4.60517,4.477337,0,0,1,2,3,0.3887,MORE
19,100,94,6,194,100,94,4.60517,4.543295,0.0618754,9.148465,4.60517,4.543295,0,0,1,2.0564,2,0.6472,MORE
19,177,150,27,327,177,150,5.17615,5.010635,0.1655144,10.18679,5.17615,5.010635,0,0,1,2.0114,3,0.8178,MORE
19,150,123,27,273,150,123,5.010635,4.812184,0.1984509,9.82282,5.010635,4.812184,0,0,1,2.4309,2,0.2834,MORE
19,174,150,24,324,174,150,5.159055,5.010635,0.14842,10.16969,5.159055,5.010635,0,0,1,2.0447,2,0.4007,MORE
19,82,100,18,182,100,82,4.406719,4.60517,0.1984509,9.011889,4.60517,4.406719,1,1,1,1.8879,1,0.6837,MORE
19,112,100,12,212,112,100,4.718499,4.60517,0.1133287,9.323669,4.718499,4.60517,0,0,1,2.2864,2,0.6193,MORE
19,171,150,21,321,171,150,5.141664,5.010635,0.1310283,10.1523,5.141664,5.010635,0,0,1,2.4674,2,0.567,MORE
19,150,126,24,276,150,126,5.010635,4.836282,0.1743534,9.846917,5.010635,4.836282,0,0,1,2.1088,2,0.58,MORE
19,108,100,8,208,108,100,4.682131,4.60517,0.07696104,9.287301,4.682131,4.60517,0,0,1,2.5015,2,0.4624,MORE
19,153,150,3,303,150,153,5.030438,5.010635,0.01980263,10.04107,5.010635,5.030438,1,0,0,1.7825,3,0.4959,MORE
19,150,162,12,312,162,150,5.010635,5.087596,0.07696104,10.09823,5.087596,5.010635,1,1,1,2.266,2,0.3671,MORE
19,88,100,12,188,100,88,4.477337,4.60517,0.1278334,9.082507,4.60517,4.477337,1,1,1,2.3612,2,0.5468,MORE
19,180,150,30,330,180,150,5.192957,5.010635,0.1823216,10.20359,5.192957,5.010635,0,0,1,1.5655,1,0.4497,MORE
19,147,150,3,297,150,147,4.990433,5.010635,0.02020271,10.00107,5.010635,4.990433,1,1,1,1.7342,2,0.6218,MORE
19,94,100,6,194,94,100,4.543295,4.60517,0.0618754,9.148465,4.543295,4.60517,0,1,0,1.6452,2,0.45,MORE
19,50,43,7,93,50,43,3.912023,3.7612,0.1508229,7.673223,3.912023,3.7612,0,0,1,1.9488,4,1.544,MORE
19,50,46,4,96,46,50,3.912023,3.828641,0.08338161,7.740664,3.828641,3.912023,1,0,0,2.135,3,1.0797,MORE
19,114,100,14,214,114,100,4.736198,4.60517,0.1310283,9.341369,4.736198,4.60517,0,0,1,2.2003,3,0.8215,MORE
19,100,102,2,202,100,102,4.60517,4.624973,0.01980263,9.230143,4.60517,4.624973,0,1,0,2.6767,2,0.6989,MORE
19,58,50,8,108,58,50,4.060443,3.912023,0.14842,7.972466,4.060443,3.912023,0,0,1,1.851,4,0.6338,MORE
19,100,114,14,214,114,100,4.60517,4.736198,0.1310283,9.341369,4.736198,4.60517,1,1,1,2.3901,1,0.4629,MORE
19,168,150,18,318,168,150,5.123964,5.010635,0.1133287,10.1346,5.123964,5.010635,0,0,1,2.0124,2,1.1786,MORE
19,45,50,5,95,45,50,3.806662,3.912023,0.1053605,7.718685,3.806662,3.912023,0,1,0,4.3989,1,0.2836,MORE
19,50,44,6,94,50,44,3.912023,3.78419,0.1278334,7.696213,3.912023,3.78419,0,0,1,1.6402,3,0.9025,MORE
19,94,100,6,194,94,100,4.543295,4.60517,0.0618754,9.148465,4.543295,4.60517,0,1,0,1.8777,2,0.5954,MORE
19,150,168,18,318,150,168,5.010635,5.123964,0.1133287,10.1346,5.010635,5.123964,0,1,0,2.0649,2,1.1491,MORE
19,150,120,30,270,150,120,5.010635,4.787492,0.2231436,9.798127,5.010635,4.787492,0,0,1,1.7618,4,2.1475,MORE
19,150,141,9,291,150,141,5.010635,4.94876,0.0618754,9.959395,5.010635,4.94876,0,0,1,2.5507,3,0.4139,MORE
19,55,50,5,105,55,50,4.007333,3.912023,0.09531018,7.919356,4.007333,3.912023,0,0,1,1.5117,2,0.4446,MORE
19,100,82,18,182,100,82,4.60517,4.406719,0.1984509,9.011889,4.60517,4.406719,0,0,1,2.7347,1,0.4162,MORE
19,51,50,1,101,51,50,3.931826,3.912023,0.01980263,7.843849,3.931826,3.912023,0,0,1,1.8655,2,0.4667,MORE
19,54,50,4,104,50,54,3.988984,3.912023,0.07696104,7.901007,3.912023,3.988984,1,0,0,1.5256,3,0.6149,MORE
19,150,129,21,279,129,150,5.010635,4.859812,0.1508229,9.870448,4.859812,5.010635,1,0,0,2.0065,2,1.416,MORE
19,50,60,10,110,60,50,3.912023,4.094345,0.1823216,8.006368,4.094345,3.912023,1,1,1,1.7554,3,0.863,MORE
19,50,41,9,91,50,41,3.912023,3.713572,0.1984509,7.625595,3.912023,3.713572,0,0,1,1.9166,4,0.5681,MORE
19,114,100,14,214,100,114,4.736198,4.60517,0.1310283,9.341369,4.60517,4.736198,1,0,0,1.756,3,0.6309,MORE
19,100,118,18,218,118,100,4.60517,4.770685,0.1655144,9.375855,4.770685,4.60517,1,1,1,1.7533,3,1.1207,MORE
19,129,150,21,279,129,150,4.859812,5.010635,0.1508229,9.870448,4.859812,5.010635,0,1,0,2.3605,2,0.1988,MORE
19,100,86,14,186,100,86,4.60517,4.454347,0.1508229,9.059517,4.60517,4.454347,0,0,1,2.6207,4,0.5487,MORE
19,90,100,10,190,100,90,4.49981,4.60517,0.1053605,9.10498,4.60517,4.49981,1,1,1,3.0694,1,0.384,MORE
19,50,58,8,108,58,50,3.912023,4.060443,0.14842,7.972466,4.060443,3.912023,1,1,1,1.8908,4,0.557,MORE
19,132,150,18,282,150,132,4.882802,5.010635,0.1278334,9.893437,5.010635,4.882802,1,1,1,2.0142,3,0.5369,MORE
19,129,150,21,279,150,129,4.859812,5.010635,0.1508229,9.870448,5.010635,4.859812,1,1,1,1.8123,3,0.7125,MORE
19,150,174,24,324,150,174,5.010635,5.159055,0.14842,10.16969,5.010635,5.159055,0,1,0,2.2583,2,0.8288,MORE
19,174,150,24,324,174,150,5.159055,5.010635,0.14842,10.16969,5.159055,5.010635,0,0,1,1.7989,4,0.5664,MORE
19,150,153,3,303,153,150,5.010635,5.030438,0.01980263,10.04107,5.030438,5.010635,1,1,1,1.885,3,0.5372,MORE
19,150,162,12,312,162,150,5.010635,5.087596,0.07696104,10.09823,5.087596,5.010635,1,1,1,2.4842,1,0.3895,MORE
19,50,53,3,103,50,53,3.912023,3.970292,0.05826891,7.882315,3.912023,3.970292,0,1,0,3.4177,4,1.1046,MORE
19,150,138,12,288,150,138,5.010635,4.927254,0.08338161,9.937889,5.010635,4.927254,0,0,1,1.9434,3,1.2724,MORE
19,141,150,9,291,150,141,4.94876,5.010635,0.0618754,9.959395,5.010635,4.94876,1,1,1,1.6335,2,0.4671,MORE
19,102,100,2,202,102,100,4.624973,4.60517,0.01980263,9.230143,4.624973,4.60517,0,0,1,2.4596,3,0.763,MORE
19,120,150,30,270,150,120,4.787492,5.010635,0.2231436,9.798127,5.010635,4.787492,1,1,1,1.5771,3,0.6057,MORE
19,162,150,12,312,162,150,5.087596,5.010635,0.07696104,10.09823,5.087596,5.010635,0,0,1,1.9191,2,0.4054,MORE
19,100,104,4,204,100,104,4.60517,4.644391,0.03922071,9.249561,4.60517,4.644391,0,1,0,2.574,1,0.2358,MORE
19,150,129,21,279,150,129,5.010635,4.859812,0.1508229,9.870448,5.010635,4.859812,0,0,1,2.8076,1,0.3659,MORE
19,104,100,4,204,104,100,4.644391,4.60517,0.03922071,9.249561,4.644391,4.60517,0,0,1,1.4075,4,0.9347,MORE
19,159,150,9,309,150,159,5.068904,5.010635,0.05826891,10.07954,5.010635,5.068904,1,0,0,1.5577,2,1.0726,MORE
19,50,42,8,92,42,50,3.912023,3.73767,0.1743534,7.649693,3.73767,3.912023,1,0,0,2.3333,1,0.4669,MORE
19,120,100,20,220,120,100,4.787492,4.60517,0.1823216,9.392662,4.787492,4.60517,0,0,1,1.6268,2,0.8995,MORE
19,180,150,30,330,180,150,5.192957,5.010635,0.1823216,10.20359,5.192957,5.010635,0,0,1,2.0482,3,0.3834,MORE
19,96,100,4,196,100,96,4.564348,4.60517,0.04082199,9.169518,4.60517,4.564348,1,1,1,1.6506,2,0.5699,MORE
19,50,43,7,93,50,43,3.912023,3.7612,0.1508229,7.673223,3.912023,3.7612,0,0,1,1.6215,4,0.4639,MORE
19,150,156,6,306,150,156,5.010635,5.049856,0.03922071,10.06049,5.010635,5.049856,0,1,0,1.7737,1,0.7171,MORE
19,40,50,10,90,50,40,3.688879,3.912023,0.2231436,7.600902,3.912023,3.688879,1,1,1,2.0945,3,0.597,MORE
19,100,96,4,196,100,96,4.60517,4.564348,0.04082199,9.169518,4.60517,4.564348,0,0,1,1.5268,2,0.5826,MORE
19,100,92,8,192,92,100,4.60517,4.521789,0.08338161,9.126959,4.521789,4.60517,1,0,0,1.5672,4,0.4508,MORE
19,50,59,9,109,50,59,3.912023,4.077537,0.1655144,7.98956,3.912023,4.077537,0,1,0,1.5158,2,0.4894,MORE
19,43,50,7,93,43,50,3.7612,3.912023,0.1508229,7.673223,3.7612,3.912023,0,1,0,2.2227,2,0.7158,MORE
19,50,47,3,97,47,50,3.912023,3.850148,0.0618754,7.762171,3.850148,3.912023,1,0,0,3.4583,1,0.3197,MORE
19,150,156,6,306,150,156,5.010635,5.049856,0.03922071,10.06049,5.010635,5.049856,0,1,0,2.1963,1,0.6469,MORE
19,50,56,6,106,56,50,3.912023,4.025352,0.1133287,7.937375,4.025352,3.912023,1,1,1,1.6169,2,0.9528,MORE
19,100,90,10,190,90,100,4.60517,4.49981,0.1053605,9.10498,4.49981,4.60517,1,0,0,1.4997,4,0.4489,MORE
19,150,165,15,315,165,150,5.010635,5.105945,0.09531018,10.11658,5.105945,5.010635,1,1,1,1.4575,3,0.5337,MORE
19,48,50,2,98,48,50,3.871201,3.912023,0.04082199,7.783224,3.871201,3.912023,0,1,0,2.1665,1,1.0651,MORE
19,150,132,18,282,132,150,5.010635,4.882802,0.1278334,9.893437,4.882802,5.010635,1,0,0,1.7136,1,1.1975,MORE
19,106,100,6,206,106,100,4.663439,4.60517,0.05826891,9.268609,4.663439,4.60517,0,0,1,1.7716,2,0.7505,MORE
19,82,100,18,182,100,82,4.406719,4.60517,0.1984509,9.011889,4.60517,4.406719,1,1,1,4.5629,1,0.2238,MORE
19,50,57,7,107,50,57,3.912023,4.043051,0.1310283,7.955074,3.912023,4.043051,0,1,0,1.8736,2,0.6833,MORE
19,92,100,8,192,100,92,4.521789,4.60517,0.08338161,9.126959,4.60517,4.521789,1,1,1,1.5347,4,0.5353,MORE
19,52,50,2,102,52,50,3.951244,3.912023,0.03922071,7.863267,3.951244,3.912023,0,0,1,1.4361,3,0.4834,MORE
19,100,106,6,206,100,106,4.60517,4.663439,0.05826891,9.268609,4.60517,4.663439,0,1,0,3.2731,2,0.6325,MORE
19,110,100,10,210,100,110,4.70048,4.60517,0.09531018,9.305651,4.60517,4.70048,1,0,0,1.6381,2,0.5969,MORE
19,100,116,16,216,116,100,4.60517,4.75359,0.14842,9.35876,4.75359,4.60517,1,1,1,1.4122,4,0.6304,MORE
19,50,55,5,105,50,55,3.912023,4.007333,0.09531018,7.919356,3.912023,4.007333,0,1,0,1.5343,3,0.4884,MORE
19,100,118,18,218,118,100,4.60517,4.770685,0.1655144,9.375855,4.770685,4.60517,1,1,1,1.266,4,0.6668,MORE
19,43,50,7,93,43,50,3.7612,3.912023,0.1508229,7.673223,3.7612,3.912023,0,1,0,1.6565,3,1.0983,MORE
19,55,50,5,105,50,55,4.007333,3.912023,0.09531018,7.919356,3.912023,4.007333,1,0,0,1.8205,3,0.8184,MORE
19,100,104,4,204,100,104,4.60517,4.644391,0.03922071,9.249561,4.60517,4.644391,0,1,0,1.6773,2,0.9467,MORE
19,150,144,6,294,144,150,5.010635,4.969813,0.04082199,9.980449,4.969813,5.010635,1,0,0,1.6391,2,0.5527,MORE
19,40,50,10,90,40,50,3.688879,3.912023,0.2231436,7.600902,3.688879,3.912023,0,1,0,1.4703,2,0.6556,MORE
19,60,50,10,110,60,50,4.094345,3.912023,0.1823216,8.006368,4.094345,3.912023,0,0,1,1.5073,3,0.4986,MORE
19,100,98,2,198,100,98,4.60517,4.584967,0.02020271,9.190138,4.60517,4.584967,0,0,1,1.6706,1,1.0508,MORE
19,86,100,14,186,100,86,4.454347,4.60517,0.1508229,9.059517,4.60517,4.454347,1,1,1,1.2649,3,0.4482,MORE
19,150,168,18,318,168,150,5.010635,5.123964,0.1133287,10.1346,5.123964,5.010635,1,1,1,1.3495,3,0.8856,MORE
19,150,144,6,294,150,144,5.010635,4.969813,0.04082199,9.980449,5.010635,4.969813,0,0,1,4.0023,2,1.0182,MORE
19,50,48,2,98,50,48,3.912023,3.871201,0.04082199,7.783224,3.912023,3.871201,0,0,1,1.2504,2,0.7254,MORE
19,50,47,3,97,50,47,3.912023,3.850148,0.0618754,7.762171,3.912023,3.850148,0,0,1,1.6066,3,0.5347,MORE
19,92,100,8,192,100,92,4.521789,4.60517,0.08338161,9.126959,4.60517,4.521789,1,1,1,1.6501,1,0.7368,MORE
19,100,120,20,220,120,100,4.60517,4.787492,0.1823216,9.392662,4.787492,4.60517,1,1,1,1.3199,4,0.7715,MORE
19,44,50,6,94,44,50,3.78419,3.912023,0.1278334,7.696213,3.78419,3.912023,0,1,0,2.4124,2,0.5236,MORE
19,165,150,15,315,150,165,5.105945,5.010635,0.09531018,10.11658,5.010635,5.105945,1,0,0,1.4457,2,1.0682,MORE
19,104,100,4,204,104,100,4.644391,4.60517,0.03922071,9.249561,4.644391,4.60517,0,0,1,2.875,1,0.6465,MORE
19,165,150,15,315,165,150,5.105945,5.010635,0.09531018,10.11658,5.105945,5.010635,0,0,1,1.2517,2,0.5171,MORE
19,80,100,20,180,100,80,4.382027,4.60517,0.2231436,8.987197,4.60517,4.382027,1,1,1,1.5055,2,0.5197,MORE
19,102,100,2,202,100,102,4.624973,4.60517,0.01980263,9.230143,4.60517,4.624973,1,0,0,2.0553,2,0.6333,MORE
19,150,171,21,321,150,171,5.010635,5.141664,0.1310283,10.1523,5.010635,5.141664,0,1,0,2.8031,1,1.1613,MORE
19,150,147,3,297,150,147,5.010635,4.990433,0.02020271,10.00107,5.010635,4.990433,0,0,1,2.3187,2,0.7312,MORE
19,88,100,12,188,100,88,4.477337,4.60517,0.1278334,9.082507,4.60517,4.477337,1,1,1,1.2628,2,1.4795,MORE
19,150,123,27,273,123,150,5.010635,4.812184,0.1984509,9.82282,4.812184,5.010635,1,0,0,1.3899,2,0.5213,MORE
19,50,42,8,92,50,42,3.912023,3.73767,0.1743534,7.649693,3.912023,3.73767,0,0,1,1.8706,4,0.9684,MORE
19,138,150,12,288,150,138,4.927254,5.010635,0.08338161,9.937889,5.010635,4.927254,1,1,1,1.1154,4,0.4442,MORE
19,50,51,1,101,50,51,3.912023,3.931826,0.01980263,7.843849,3.912023,3.931826,0,1,0,1.3206,3,0.7004,MORE
19,150,135,15,285,135,150,5.010635,4.905275,0.1053605,9.91591,4.905275,5.010635,1,0,0,1.9631,2,0.2026,MORE
19,171,150,21,321,150,171,5.141664,5.010635,0.1310283,10.1523,5.010635,5.141664,1,0,0,1.531,3,1.0189,MORE
19,100,80,20,180,100,80,4.60517,4.382027,0.2231436,8.987197,4.60517,4.382027,0,0,1,1.528,4,1.0554,MORE
19,168,150,18,318,168,150,5.123964,5.010635,0.1133287,10.1346,5.123964,5.010635,0,0,1,1.3663,3,0.4155,MORE
19,100,84,16,184,100,84,4.60517,4.430817,0.1743534,9.035987,4.60517,4.430817,0,0,1,1.2487,2,0.5456,MORE
19,49,50,1,99,49,50,3.89182,3.912023,0.02020271,7.803843,3.89182,3.912023,0,1,0,1.2889,3,0.5351,MORE
19,50,56,6,106,56,50,3.912023,4.025352,0.1133287,7.937375,4.025352,3.912023,1,1,1,1.3968,2,1.5015,MORE
19,135,150,15,285,150,135,4.905275,5.010635,0.1053605,9.91591,5.010635,4.905275,1,1,1,1.1777,3,0.4345,MORE
19,138,150,12,288,150,138,4.927254,5.010635,0.08338161,9.937889,5.010635,4.927254,1,1,1,1.4382,4,0.4989,MORE
19,147,150,3,297,147,150,4.990433,5.010635,0.02020271,10.00107,4.990433,5.010635,0,1,0,1.3891,3,0.5475,MORE
19,150,153,3,303,153,150,5.010635,5.030438,0.01980263,10.04107,5.030438,5.010635,1,1,1,1.1959,1,0.9293,MORE
19,100,108,8,208,108,100,4.60517,4.682131,0.07696104,9.287301,4.682131,4.60517,1,1,1,4.9868,1,0.9363,MORE
19,100,110,10,210,110,100,4.60517,4.70048,0.09531018,9.305651,4.70048,4.60517,1,1,1,1.3084,3,0.4631,MORE
19,135,150,15,285,150,135,4.905275,5.010635,0.1053605,9.91591,5.010635,4.905275,1,1,1,1.2777,4,0.5047,MORE
19,50,55,5,105,55,50,3.912023,4.007333,0.09531018,7.919356,4.007333,3.912023,1,1,1,3.6852,2,0.5052,MORE
19,50,41,9,91,50,41,3.912023,3.713572,0.1984509,7.625595,3.912023,3.713572,0,0,1,1.3131,2,1.4985,MORE
19,50,40,10,90,50,40,3.912023,3.688879,0.2231436,7.600902,3.912023,3.688879,0,0,1,1.2609,3,0.5168,MORE
19,150,177,27,327,177,150,5.010635,5.17615,0.1655144,10.18679,5.17615,5.010635,1,1,1,1.6529,4,1.0618,MORE
19,50,48,2,98,50,48,3.912023,3.871201,0.04082199,7.783224,3.912023,3.871201,0,0,1,1.2639,3,0.4502,MORE
19,84,100,16,184,100,84,4.430817,4.60517,0.1743534,9.035987,4.60517,4.430817,1,1,1,1.1862,3,0.5998,MORE
19,50,45,5,95,50,45,3.912023,3.806662,0.1053605,7.718685,3.912023,3.806662,0,0,1,1.2055,4,0.6691,MORE
19,150,126,24,276,150,126,5.010635,4.836282,0.1743534,9.846917,5.010635,4.836282,0,0,1,1.2895,3,0.4739,MORE
19,50,54,4,104,54,50,3.912023,3.988984,0.07696104,7.901007,3.988984,3.912023,1,1,1,1.2288,2,0.7962,MORE
19,53,50,3,103,50,53,3.970292,3.912023,0.05826891,7.882315,3.912023,3.970292,1,0,0,1.2726,2,0.4666,MORE
19,150,159,9,309,150,159,5.010635,5.068904,0.05826891,10.07954,5.010635,5.068904,0,1,0,1.3913,1,0.5171,MORE
19,159,150,9,309,159,150,5.068904,5.010635,0.05826891,10.07954,5.068904,5.010635,0,0,1,1.8882,2,0.7662,MORE
19,41,50,9,91,50,41,3.713572,3.912023,0.1984509,7.625595,3.912023,3.713572,1,1,1,1.9732,2,0.9632,MORE
19,50,52,2,102,50,52,3.912023,3.951244,0.03922071,7.863267,3.912023,3.951244,0,1,0,1.2388,3,0.6701,MORE
19,47,50,3,97,47,50,3.850148,3.912023,0.0618754,7.762171,3.850148,3.912023,0,1,0,1.4438,2,0.7186,MORE
19,123,150,27,273,150,123,4.812184,5.010635,0.1984509,9.82282,5.010635,4.812184,1,1,1,1.1961,4,0.5442,MORE
19,86,100,14,186,86,100,4.454347,4.60517,0.1508229,9.059517,4.454347,4.60517,0,1,0,1.3728,2,0.5334,MORE
19,50,44,6,94,50,44,3.912023,3.78419,0.1278334,7.696213,3.912023,3.78419,0,0,1,1.2248,4,0.6057,MORE
19,144,150,6,294,150,144,4.969813,5.010635,0.04082199,9.980449,5.010635,4.969813,1,1,1,2.1526,1,0.3203,MORE
19,156,150,6,306,156,150,5.049856,5.010635,0.03922071,10.06049,5.049856,5.010635,0,0,1,1.1784,4,0.5549,MORE
19,50,49,1,99,50,49,3.912023,3.89182,0.02020271,7.803843,3.912023,3.89182,0,0,1,1.4185,3,0.9326,MORE
19,110,100,10,210,110,100,4.70048,4.60517,0.09531018,9.305651,4.70048,4.60517,0,0,1,1.1928,4,0.6302,MORE
19,50,45,5,95,50,45,3.912023,3.806662,0.1053605,7.718685,3.912023,3.806662,0,0,1,1.3097,4,0.6465,MORE
19,126,150,24,276,150,126,4.836282,5.010635,0.1743534,9.846917,5.010635,4.836282,1,1,1,1.1114,3,0.5509,MORE
19,116,100,16,216,116,100,4.75359,4.60517,0.14842,9.35876,4.75359,4.60517,0,0,1,1.1731,3,0.813,MORE
19,120,150,30,270,150,120,4.787492,5.010635,0.2231436,9.798127,5.010635,4.787492,1,1,1,1.1523,3,1.066,MORE
19,150,180,30,330,180,150,5.010635,5.192957,0.1823216,10.20359,5.192957,5.010635,1,1,1,1.2006,4,0.9468,MORE
19,100,82,18,182,100,82,4.60517,4.406719,0.1984509,9.011889,4.60517,4.406719,0,0,1,1.1639,2,1.0674,MORE
19,90,100,10,190,100,90,4.49981,4.60517,0.1053605,9.10498,4.60517,4.49981,1,1,1,1.7309,2,1.1681,MORE
19,56,50,6,106,56,50,4.025352,3.912023,0.1133287,7.937375,4.025352,3.912023,0,0,1,1.3435,3,1.4632,MORE
19,100,88,12,188,88,100,4.60517,4.477337,0.1278334,9.082507,4.477337,4.60517,1,0,0,1.2294,3,0.6174,MORE
19,60,50,10,110,60,50,4.094345,3.912023,0.1823216,8.006368,4.094345,3.912023,0,0,1,1.1826,3,0.4745,MORE
19,42,50,8,92,42,50,3.73767,3.912023,0.1743534,7.649693,3.73767,3.912023,0,1,0,2.2335,2,0.6465,MORE
19,153,150,3,303,150,153,5.030438,5.010635,0.01980263,10.04107,5.010635,5.030438,1,0,0,1.1318,2,0.9386,MORE
19,45,50,5,95,50,45,3.806662,3.912023,0.1053605,7.718685,3.912023,3.806662,1,1,1,2.2675,1,0.9014,MORE
19,50,54,4,104,54,50,3.912023,3.988984,0.07696104,7.901007,3.988984,3.912023,1,1,1,1.274,3,1.1658,MORE
19,51,50,1,101,50,51,3.931826,3.912023,0.01980263,7.843849,3.912023,3.931826,1,0,0,1.3006,1,1.2696,MORE
19,50,49,1,99,50,49,3.912023,3.89182,0.02020271,7.803843,3.912023,3.89182,0,0,1,1.8485,2,2.0972,MORE
19,150,171,21,321,171,150,5.010635,5.141664,0.1310283,10.1523,5.141664,5.010635,1,1,1,0.9739,4,0.4028,MORE
19,100,84,16,184,100,84,4.60517,4.430817,0.1743534,9.035987,4.60517,4.430817,0,0,1,1.193,3,0.4339,MORE
19,50,40,10,90,50,40,3.912023,3.688879,0.2231436,7.600902,3.912023,3.688879,0,0,1,2.3771,2,0.8014,MORE
19,177,150,27,327,177,150,5.17615,5.010635,0.1655144,10.18679,5.17615,5.010635,0,0,1,1.2378,3,0.8285,MORE
19,150,141,9,291,150,141,5.010635,4.94876,0.0618754,9.959395,5.010635,4.94876,0,0,1,1.1422,4,0.865,MORE
19,50,59,9,109,59,50,3.912023,4.077537,0.1655144,7.98956,4.077537,3.912023,1,1,1,1.1333,3,0.9,MORE
19,162,150,12,312,162,150,5.087596,5.010635,0.07696104,10.09823,5.087596,5.010635,0,0,1,1.1828,3,0.5336,MORE
19,50,51,1,101,50,51,3.912023,3.931826,0.01980263,7.843849,3.912023,3.931826,0,1,0,2.3483,2,0.952,MORE
19,126,150,24,276,150,126,4.836282,5.010635,0.1743534,9.846917,5.010635,4.836282,1,1,1,2.0149,2,0.6959,MORE
19,118,100,18,218,118,100,4.770685,4.60517,0.1655144,9.375855,4.770685,4.60517,0,0,1,1.3919,2,0.7622,MORE
19,116,100,16,216,116,100,4.75359,4.60517,0.14842,9.35876,4.75359,4.60517,0,0,1,1.5207,3,1.083,MORE
19,100,108,8,208,108,100,4.60517,4.682131,0.07696104,9.287301,4.682131,4.60517,1,1,1,1.0382,3,0.4976,MORE
19,150,177,27,327,150,177,5.010635,5.17615,0.1655144,10.18679,5.010635,5.17615,0,1,0,1.2094,2,1.0793,MORE
19,150,120,30,270,150,120,5.010635,4.787492,0.2231436,9.798127,5.010635,4.787492,0,0,1,1.3843,4,0.5665,MORE
19,100,96,4,196,100,96,4.60517,4.564348,0.04082199,9.169518,4.60517,4.564348,0,0,1,1.5432,3,0.4825,MORE
19,150,147,3,297,150,147,5.010635,4.990433,0.02020271,10.00107,5.010635,4.990433,0,0,1,2.2756,1,0.266,MORE
19,100,92,8,192,92,100,4.60517,4.521789,0.08338161,9.126959,4.521789,4.60517,1,0,0,1.2686,2,1.0123,MORE
19,141,150,9,291,150,141,4.94876,5.010635,0.0618754,9.959395,5.010635,4.94876,1,1,1,1.1835,2,0.7397,MORE
19,100,112,12,212,100,112,4.60517,4.718499,0.1133287,9.323669,4.60517,4.718499,0,1,0,1.2724,2,0.6827,MORE
19,57,50,7,107,57,50,4.043051,3.912023,0.1310283,7.955074,4.043051,3.912023,0,0,1,2.7837,1,0.6676,MORE
19,150,174,24,324,174,150,5.010635,5.159055,0.14842,10.16969,5.159055,5.010635,1,1,1,1.004,4,0.5993,MORE
19,100,120,20,220,120,100,4.60517,4.787492,0.1823216,9.392662,4.787492,4.60517,1,1,1,1.1245,3,0.7327,MORE
19,100,102,2,202,102,100,4.60517,4.624973,0.01980263,9.230143,4.624973,4.60517,1,1,1,1.0788,4,0.4352,MORE
19,56,50,6,106,56,50,4.025352,3.912023,0.1133287,7.937375,4.025352,3.912023,0,0,1,1.4362,3,0.7791,MORE
19,100,98,2,198,100,98,4.60517,4.584967,0.02020271,9.190138,4.60517,4.584967,0,0,1,1.3815,2,0.5367,MORE
19,100,90,10,190,100,90,4.60517,4.49981,0.1053605,9.10498,4.60517,4.49981,0,0,1,3.8919,1,0.4367,MORE
19,100,112,12,212,112,100,4.60517,4.718499,0.1133287,9.323669,4.718499,4.60517,1,1,1,1.228,3,0.4529,MORE
19,47,50,3,97,50,47,3.850148,3.912023,0.0618754,7.762171,3.912023,3.850148,1,1,1,2.8085,1,0.5539,MORE
19,108,100,8,208,100,108,4.682131,4.60517,0.07696104,9.287301,4.60517,4.682131,1,0,0,1.9687,2,0.6795,MORE
19,100,94,6,194,94,100,4.60517,4.543295,0.0618754,9.148465,4.543295,4.60517,1,0,0,1.0418,3,0.4969,MORE
19,58,50,8,108,58,50,4.060443,3.912023,0.14842,7.972466,4.060443,3.912023,0,0,1,1.1793,4,0.3947,MORE
19,46,50,4,96,46,50,3.828641,3.912023,0.08338161,7.740664,3.828641,3.912023,0,1,0,1.629,2,0.5636,MORE
19,98,100,2,198,98,100,4.584967,4.60517,0.02020271,9.190138,4.584967,4.60517,0,1,0,1.9932,2,0.6305,MORE
19,112,100,12,212,112,100,4.718499,4.60517,0.1133287,9.323669,4.718499,4.60517,0,0,1,1.1275,3,0.4968,MORE
19,100,80,20,180,100,80,4.60517,4.382027,0.2231436,8.987197,4.60517,4.382027,0,0,1,1.2319,2,0.8664,MORE
19,100,110,10,210,110,100,4.60517,4.70048,0.09531018,9.305651,4.70048,4.60517,1,1,1,1.0194,4,0.9184,MORE
19,100,116,16,216,116,100,4.60517,4.75359,0.14842,9.35876,4.75359,4.60517,1,1,1,1.1829,2,2.1358,MORE
19,106,100,6,206,106,100,4.663439,4.60517,0.05826891,9.268609,4.663439,4.60517,0,0,1,1.8387,1,0.6304,MORE
19,150,180,30,330,180,150,5.010635,5.192957,0.1823216,10.20359,5.192957,5.010635,1,1,1,0.9117,4,0.5504,MORE
19,50,52,2,102,50,52,3.912023,3.951244,0.03922071,7.863267,3.912023,3.951244,0,1,0,1.2323,2,0.3695,MORE
19,150,138,12,288,138,150,5.010635,4.927254,0.08338161,9.937889,4.927254,5.010635,1,0,0,1.1977,2,0.6485,MORE
19,100,106,6,206,106,100,4.60517,4.663439,0.05826891,9.268609,4.663439,4.60517,1,1,1,1.1953,3,0.8126,MORE
19,41,50,9,91,50,41,3.713572,3.912023,0.1984509,7.625595,3.912023,3.713572,1,1,1,1.1611,2,0.7489,MORE
19,150,132,18,282,150,132,5.010635,4.882802,0.1278334,9.893437,5.010635,4.882802,0,0,1,1.3058,3,0.8035,MORE
19,98,100,2,198,98,100,4.584967,4.60517,0.02020271,9.190138,4.584967,4.60517,0,1,0,1.3831,2,0.616,MORE
19,100,86,14,186,100,86,4.60517,4.454347,0.1508229,9.059517,4.60517,4.454347,0,0,1,1.215,4,0.4729,MORE
19,50,46,4,96,50,46,3.912023,3.828641,0.08338161,7.740664,3.912023,3.828641,0,0,1,1.2947,3,0.4961,MORE
19,123,150,27,273,150,123,4.812184,5.010635,0.1984509,9.82282,5.010635,4.812184,1,1,1,1.2994,2,0.6473,MORE
19,59,50,9,109,59,50,4.077537,3.912023,0.1655144,7.98956,4.077537,3.912023,0,0,1,1.216,1,0.7005,MORE
19,50,53,3,103,50,53,3.912023,3.970292,0.05826891,7.882315,3.912023,3.970292,0,1,0,1.6252,2,0.5395,MORE
19,42,50,8,92,50,42,3.73767,3.912023,0.1743534,7.649693,3.912023,3.73767,1,1,1,1.1592,2,1.3839,MORE
20,100,90,10,190,100,90,4.60517,4.49981,0.1053605,9.10498,4.60517,4.49981,0,0,1,1.8962,4,1.323,MORE
20,50,44,6,94,50,44,3.912023,3.78419,0.1278334,7.696213,3.912023,3.78419,0,0,1,1.9439,3,0.7932,MORE
20,150,171,21,321,150,171,5.010635,5.141664,0.1310283,10.1523,5.010635,5.141664,0,1,0,1.6141,2,0.9209,MORE
20,100,84,16,184,100,84,4.60517,4.430817,0.1743534,9.035987,4.60517,4.430817,0,0,1,1.6318,4,0.8138,MORE
20,150,144,6,294,150,144,5.010635,4.969813,0.04082199,9.980449,5.010635,4.969813,0,0,1,1.5813,3,1.8058,MORE
20,150,132,18,282,150,132,5.010635,4.882802,0.1278334,9.893437,5.010635,4.882802,0,0,1,1.3555,4,0.6976,MORE
20,50,41,9,91,50,41,3.912023,3.713572,0.1984509,7.625595,3.912023,3.713572,0,0,1,1.6479,2,1.1673,MORE
20,100,120,20,220,120,100,4.60517,4.787492,0.1823216,9.392662,4.787492,4.60517,1,1,1,2.0498,3,0.5541,MORE
20,50,51,1,101,50,51,3.912023,3.931826,0.01980263,7.843849,3.912023,3.931826,0,1,0,2.4876,1,1.0303,MORE
20,98,100,2,198,98,100,4.584967,4.60517,0.02020271,9.190138,4.584967,4.60517,0,1,0,1.609,3,1.1168,MORE
20,43,50,7,93,50,43,3.7612,3.912023,0.1508229,7.673223,3.912023,3.7612,1,1,1,1.9363,3,1.1561,MORE
20,92,100,8,192,100,92,4.521789,4.60517,0.08338161,9.126959,4.60517,4.521789,1,1,1,1.9261,2,1.2059,MORE
20,50,42,8,92,50,42,3.912023,3.73767,0.1743534,7.649693,3.912023,3.73767,0,0,1,1.6799,4,1.0086,MORE
20,150,168,18,318,168,150,5.010635,5.123964,0.1133287,10.1346,5.123964,5.010635,1,1,1,2.6098,2,1.0177,MORE
20,52,50,2,102,52,50,3.951244,3.912023,0.03922071,7.863267,3.951244,3.912023,0,0,1,1.4841,3,0.7641,MORE
20,84,100,16,184,84,100,4.430817,4.60517,0.1743534,9.035987,4.430817,4.60517,0,1,0,2.148,2,1.2071,MORE
20,129,150,21,279,129,150,4.859812,5.010635,0.1508229,9.870448,4.859812,5.010635,0,1,0,1.7507,1,1.9929,MORE
20,114,100,14,214,114,100,4.736198,4.60517,0.1310283,9.341369,4.736198,4.60517,0,0,1,1.6159,3,1.0041,MORE
20,50,40,10,90,50,40,3.912023,3.688879,0.2231436,7.600902,3.912023,3.688879,0,0,1,1.5742,4,0.8427,MORE
20,50,60,10,110,50,60,3.912023,4.094345,0.1823216,8.006368,3.912023,4.094345,0,1,0,2.2699,2,0.801,MORE
20,120,100,20,220,120,100,4.787492,4.60517,0.1823216,9.392662,4.787492,4.60517,0,0,1,1.3668,4,0.788,MORE
20,54,50,4,104,54,50,3.988984,3.912023,0.07696104,7.901007,3.988984,3.912023,0,0,1,1.8141,1,1.0807,MORE
20,50,46,4,96,50,46,3.912023,3.828641,0.08338161,7.740664,3.912023,3.828641,0,0,1,1.7103,2,1.1057,MORE
20,90,100,10,190,100,90,4.49981,4.60517,0.1053605,9.10498,4.60517,4.49981,1,1,1,2.0744,2,1.135,MORE
20,80,100,20,180,100,80,4.382027,4.60517,0.2231436,8.987197,4.60517,4.382027,1,1,1,1.2682,4,0.8509,MORE
20,86,100,14,186,86,100,4.454347,4.60517,0.1508229,9.059517,4.454347,4.60517,0,1,0,1.5757,3,1.0829,MORE
20,100,98,2,198,100,98,4.60517,4.584967,0.02020271,9.190138,4.60517,4.584967,0,0,1,1.5254,3,0.9675,MORE
20,120,150,30,270,150,120,4.787492,5.010635,0.2231436,9.798127,5.010635,4.787492,1,1,1,1.4238,4,1.0542,MORE
20,144,150,6,294,144,150,4.969813,5.010635,0.04082199,9.980449,4.969813,5.010635,0,1,0,2.1772,1,1.1177,MORE
20,177,150,27,327,177,150,5.17615,5.010635,0.1655144,10.18679,5.17615,5.010635,0,0,1,1.4006,4,0.8346,MORE
20,150,141,9,291,150,141,5.010635,4.94876,0.0618754,9.959395,5.010635,4.94876,0,0,1,1.891,2,1.1667,MORE
20,138,150,12,288,150,138,4.927254,5.010635,0.08338161,9.937889,5.010635,4.927254,1,1,1,2.3807,2,0.9887,MORE
20,100,110,10,210,110,100,4.60517,4.70048,0.09531018,9.305651,4.70048,4.60517,1,1,1,1.5894,3,0.8123,MORE
20,88,100,12,188,88,100,4.477337,4.60517,0.1278334,9.082507,4.477337,4.60517,0,1,0,1.3937,3,1.7241,MORE
20,150,174,24,324,150,174,5.010635,5.159055,0.14842,10.16969,5.010635,5.159055,0,1,0,2.1914,2,1.0881,MORE
20,60,50,10,110,60,50,4.094345,3.912023,0.1823216,8.006368,4.094345,3.912023,0,0,1,1.398,3,1.1361,MORE
20,50,43,7,93,50,43,3.912023,3.7612,0.1508229,7.673223,3.912023,3.7612,0,0,1,1.9426,3,1.7494,MORE
20,86,100,14,186,100,86,4.454347,4.60517,0.1508229,9.059517,4.60517,4.454347,1,1,1,1.7597,2,1.5202,MORE
20,171,150,21,321,171,150,5.141664,5.010635,0.1310283,10.1523,5.141664,5.010635,0,0,1,1.447,4,1.0061,MORE
20,50,58,8,108,58,50,3.912023,4.060443,0.14842,7.972466,4.060443,3.912023,1,1,1,1.3979,4,1.0465,MORE
20,153,150,3,303,153,150,5.030438,5.010635,0.01980263,10.04107,5.030438,5.010635,0,0,1,1.2925,3,0.8998,MORE
20,50,48,2,98,48,50,3.912023,3.871201,0.04082199,7.783224,3.871201,3.912023,1,0,0,2.5929,1,0.9282,MORE
20,129,150,21,279,129,150,4.859812,5.010635,0.1508229,9.870448,4.859812,5.010635,0,1,0,1.9925,2,0.7999,MORE
20,100,114,14,214,114,100,4.60517,4.736198,0.1310283,9.341369,4.736198,4.60517,1,1,1,1.7074,3,0.8873,MORE
20,100,106,6,206,100,106,4.60517,4.663439,0.05826891,9.268609,4.60517,4.663439,0,1,0,2.934,2,0.5079,MORE
20,150,168,18,318,168,150,5.010635,5.123964,0.1133287,10.1346,5.123964,5.010635,1,1,1,1.5396,4,0.6994,MORE
20,150,180,30,330,180,150,5.010635,5.192957,0.1823216,10.20359,5.192957,5.010635,1,1,1,1.6386,3,0.8858,MORE
20,100,80,20,180,100,80,4.60517,4.382027,0.2231436,8.987197,4.60517,4.382027,0,0,1,1.3944,4,0.9215,MORE
20,150,159,9,309,150,159,5.010635,5.068904,0.05826891,10.07954,5.010635,5.068904,0,1,0,2.2071,2,0.8479,MORE
20,50,48,2,98,48,50,3.912023,3.871201,0.04082199,7.783224,3.871201,3.912023,1,0,0,1.9405,2,0.9382,MORE
20,100,92,8,192,92,100,4.60517,4.521789,0.08338161,9.126959,4.521789,4.60517,1,0,0,1.9955,3,1.0319,MORE
20,57,50,7,107,57,50,4.043051,3.912023,0.1310283,7.955074,4.043051,3.912023,0,0,1,1.5716,2,0.9116,MORE
20,153,150,3,303,153,150,5.030438,5.010635,0.01980263,10.04107,5.030438,5.010635,0,0,1,2.077,2,0.9156,MORE
20,100,116,16,216,100,116,4.60517,4.75359,0.14842,9.35876,4.60517,4.75359,0,1,0,2.1455,3,0.8531,MORE
20,150,171,21,321,171,150,5.010635,5.141664,0.1310283,10.1523,5.141664,5.010635,1,1,1,1.3004,4,1.1186,MORE
20,92,100,8,192,100,92,4.521789,4.60517,0.08338161,9.126959,4.60517,4.521789,1,1,1,1.5253,3,1.3863,MORE
20,177,150,27,327,177,150,5.17615,5.010635,0.1655144,10.18679,5.17615,5.010635,0,0,1,1.5441,4,0.8681,MORE
20,135,150,15,285,150,135,4.905275,5.010635,0.1053605,9.91591,5.010635,4.905275,1,1,1,2.1487,2,1.0042,MORE
20,120,150,30,270,150,120,4.787492,5.010635,0.2231436,9.798127,5.010635,4.787492,1,1,1,1.3497,3,0.7971,MORE
20,150,123,27,273,150,123,5.010635,4.812184,0.1984509,9.82282,5.010635,4.812184,0,0,1,1.3655,4,0.7878,MORE
20,49,50,1,99,50,49,3.89182,3.912023,0.02020271,7.803843,3.912023,3.89182,1,1,1,2.0062,1,1.3096,MORE
20,150,153,3,303,153,150,5.010635,5.030438,0.01980263,10.04107,5.030438,5.010635,1,1,1,1.6462,3,0.904,MORE
20,56,50,6,106,56,50,4.025352,3.912023,0.1133287,7.937375,4.025352,3.912023,0,0,1,1.8788,3,1.1839,MORE
20,150,153,3,303,153,150,5.010635,5.030438,0.01980263,10.04107,5.030438,5.010635,1,1,1,1.219,4,0.8297,MORE
20,112,100,12,212,112,100,4.718499,4.60517,0.1133287,9.323669,4.718499,4.60517,0,0,1,1.4102,3,0.8941,MORE
20,50,56,6,106,56,50,3.912023,4.025352,0.1133287,7.937375,4.025352,3.912023,1,1,1,1.8485,2,0.8911,MORE
20,159,150,9,309,159,150,5.068904,5.010635,0.05826891,10.07954,5.068904,5.010635,0,0,1,1.5221,4,0.856,MORE
20,45,50,5,95,50,45,3.806662,3.912023,0.1053605,7.718685,3.912023,3.806662,1,1,1,1.4444,4,1.0275,MORE
20,50,47,3,97,50,47,3.912023,3.850148,0.0618754,7.762171,3.912023,3.850148,0,0,1,3.0179,1,1.0506,MORE
20,50,52,2,102,50,52,3.912023,3.951244,0.03922071,7.863267,3.912023,3.951244,0,1,0,2.5788,2,1.035,MORE
20,47,50,3,97,47,50,3.850148,3.912023,0.0618754,7.762171,3.850148,3.912023,0,1,0,2.6427,1,1.0435,MORE
20,100,86,14,186,86,100,4.60517,4.454347,0.1508229,9.059517,4.454347,4.60517,1,0,0,2.8006,2,0.9047,MORE
20,118,100,18,218,100,118,4.770685,4.60517,0.1655144,9.375855,4.60517,4.770685,1,0,0,1.3191,2,2.6192,MORE
20,53,50,3,103,53,50,3.970292,3.912023,0.05826891,7.882315,3.970292,3.912023,0,0,1,1.3948,3,0.8852,MORE
20,100,106,6,206,106,100,4.60517,4.663439,0.05826891,9.268609,4.663439,4.60517,1,1,1,2.0733,2,0.9389,MORE
20,180,150,30,330,180,150,5.192957,5.010635,0.1823216,10.20359,5.192957,5.010635,0,0,1,2.3865,2,1.8533,MORE
20,50,52,2,102,52,50,3.912023,3.951244,0.03922071,7.863267,3.951244,3.912023,1,1,1,1.7681,3,1.8719,MORE
20,50,57,7,107,57,50,3.912023,4.043051,0.1310283,7.955074,4.043051,3.912023,1,1,1,1.2021,4,0.9502,MORE
20,58,50,8,108,58,50,4.060443,3.912023,0.14842,7.972466,4.060443,3.912023,0,0,1,1.9243,1,1.5667,MORE
20,100,82,18,182,100,82,4.60517,4.406719,0.1984509,9.011889,4.60517,4.406719,0,0,1,1.5991,4,0.8842,MORE
20,100,96,4,196,96,100,4.60517,4.564348,0.04082199,9.169518,4.564348,4.60517,1,0,0,2.3005,4,0.7448,MORE
20,120,100,20,220,120,100,4.787492,4.60517,0.1823216,9.392662,4.787492,4.60517,0,0,1,2.641,4,0.5598,MORE
20,174,150,24,324,174,150,5.159055,5.010635,0.14842,10.16969,5.159055,5.010635,0,0,1,1.5575,3,1.0048,MORE
20,110,100,10,210,110,100,4.70048,4.60517,0.09531018,9.305651,4.70048,4.60517,0,0,1,2.3311,2,1.0043,MORE
20,50,49,1,99,49,50,3.912023,3.89182,0.02020271,7.803843,3.89182,3.912023,1,0,0,2.8624,2,1.1045,MORE
20,50,40,10,90,50,40,3.912023,3.688879,0.2231436,7.600902,3.912023,3.688879,0,0,1,1.3881,3,0.9821,MORE
20,159,150,9,309,150,159,5.068904,5.010635,0.05826891,10.07954,5.010635,5.068904,1,0,0,3.483,2,1.1978,MORE
20,50,53,3,103,50,53,3.912023,3.970292,0.05826891,7.882315,3.912023,3.970292,0,1,0,2.7731,2,1.0182,MORE
20,100,118,18,218,118,100,4.60517,4.770685,0.1655144,9.375855,4.770685,4.60517,1,1,1,1.4222,3,0.8347,MORE
20,150,138,12,288,150,138,5.010635,4.927254,0.08338161,9.937889,5.010635,4.927254,0,0,1,2.0759,4,1.0723,MORE
20,50,44,6,94,50,44,3.912023,3.78419,0.1278334,7.696213,3.912023,3.78419,0,0,1,1.9639,2,1.004,MORE
20,150,156,6,306,150,156,5.010635,5.049856,0.03922071,10.06049,5.010635,5.049856,0,1,0,1.53,3,1.3345,MORE
20,150,156,6,306,156,150,5.010635,5.049856,0.03922071,10.06049,5.049856,5.010635,1,1,1,2.5311,3,0.9036,MORE
20,40,50,10,90,50,40,3.688879,3.912023,0.2231436,7.600902,3.912023,3.688879,1,1,1,1.2397,4,0.9379,MORE
20,147,150,3,297,147,150,4.990433,5.010635,0.02020271,10.00107,4.990433,5.010635,0,1,0,2.5268,2,1.1516,MORE
20,168,150,18,318,168,150,5.123964,5.010635,0.1133287,10.1346,5.123964,5.010635,0,0,1,1.3723,3,0.8353,MORE
20,165,150,15,315,165,150,5.105945,5.010635,0.09531018,10.11658,5.105945,5.010635,0,0,1,2.1085,1,2.4457,MORE
20,150,129,21,279,150,129,5.010635,4.859812,0.1508229,9.870448,5.010635,4.859812,0,0,1,1.4089,4,1.0174,MORE
20,144,150,6,294,144,150,4.969813,5.010635,0.04082199,9.980449,4.969813,5.010635,0,1,0,4.0897,2,0.9122,MORE
20,96,100,4,196,100,96,4.564348,4.60517,0.04082199,9.169518,4.60517,4.564348,1,1,1,1.5547,3,1.0881,MORE
20,50,59,9,109,59,50,3.912023,4.077537,0.1655144,7.98956,4.077537,3.912023,1,1,1,1.9629,3,1.0577,MORE
20,100,98,2,198,100,98,4.60517,4.584967,0.02020271,9.190138,4.60517,4.584967,0,0,1,2.6165,2,1.1838,MORE
20,100,88,12,188,88,100,4.60517,4.477337,0.1278334,9.082507,4.477337,4.60517,1,0,0,1.417,3,1.0129,MORE
20,150,174,24,324,174,150,5.010635,5.159055,0.14842,10.16969,5.159055,5.010635,1,1,1,1.4275,4,0.8668,MORE
20,100,108,8,208,100,108,4.60517,4.682131,0.07696104,9.287301,4.60517,4.682131,0,1,0,4.3959,2,0.9205,MORE
20,41,50,9,91,41,50,3.713572,3.912023,0.1984509,7.625595,3.713572,3.912023,0,1,0,3.5497,1,1.1362,MORE
20,150,162,12,312,162,150,5.010635,5.087596,0.07696104,10.09823,5.087596,5.010635,1,1,1,1.469,3,0.9148,MORE
20,150,144,6,294,150,144,5.010635,4.969813,0.04082199,9.980449,5.010635,4.969813,0,0,1,1.3092,4,0.8797,MORE
20,126,150,24,276,150,126,4.836282,5.010635,0.1743534,9.846917,5.010635,4.836282,1,1,1,1.1725,4,0.9543,MORE
20,50,54,4,104,54,50,3.912023,3.988984,0.07696104,7.901007,3.988984,3.912023,1,1,1,1.5634,2,1.0709,MORE
20,100,94,6,194,100,94,4.60517,4.543295,0.0618754,9.148465,4.60517,4.543295,0,0,1,1.3831,3,0.9713,MORE
20,50,46,4,96,50,46,3.912023,3.828641,0.08338161,7.740664,3.912023,3.828641,0,0,1,2.3163,2,1.3764,MORE
20,100,118,18,218,118,100,4.60517,4.770685,0.1655144,9.375855,4.770685,4.60517,1,1,1,1.2176,3,0.9347,MORE
20,150,135,15,285,150,135,5.010635,4.905275,0.1053605,9.91591,5.010635,4.905275,0,0,1,1.2949,3,0.937,MORE
20,100,112,12,212,112,100,4.60517,4.718499,0.1133287,9.323669,4.718499,4.60517,1,1,1,3.6692,2,1.0054,MORE
20,96,100,4,196,96,100,4.564348,4.60517,0.04082199,9.169518,4.564348,4.60517,0,1,0,1.8953,1,1.5362,MORE
20,50,60,10,110,60,50,3.912023,4.094345,0.1823216,8.006368,4.094345,3.912023,1,1,1,2.2034,2,1.0741,MORE
20,50,49,1,99,50,49,3.912023,3.89182,0.02020271,7.803843,3.912023,3.89182,0,0,1,2.5908,2,1.0875,MORE
20,150,138,12,288,150,138,5.010635,4.927254,0.08338161,9.937889,5.010635,4.927254,0,0,1,2.6147,3,0.9006,MORE
20,50,54,4,104,54,50,3.912023,3.988984,0.07696104,7.901007,3.988984,3.912023,1,1,1,2.4912,2,0.9015,MORE
20,100,80,20,180,100,80,4.60517,4.382027,0.2231436,8.987197,4.60517,4.382027,0,0,1,2.3936,4,0.6473,MORE
20,132,150,18,282,150,132,4.882802,5.010635,0.1278334,9.893437,5.010635,4.882802,1,1,1,1.9032,2,1.5519,MORE
20,50,55,5,105,50,55,3.912023,4.007333,0.09531018,7.919356,3.912023,4.007333,0,1,0,2.3834,2,0.941,MORE
20,150,159,9,309,150,159,5.010635,5.068904,0.05826891,10.07954,5.010635,5.068904,0,1,0,1.836,3,0.8,MORE
20,100,96,4,196,100,96,4.60517,4.564348,0.04082199,9.169518,4.60517,4.564348,0,0,1,1.5592,3,0.9573,MORE
20,150,132,18,282,150,132,5.010635,4.882802,0.1278334,9.893437,5.010635,4.882802,0,0,1,1.728,4,0.7675,MORE
20,50,47,3,97,50,47,3.912023,3.850148,0.0618754,7.762171,3.912023,3.850148,0,0,1,3.3771,1,1.0418,MORE
20,90,100,10,190,100,90,4.49981,4.60517,0.1053605,9.10498,4.60517,4.49981,1,1,1,1.342,3,1.6015,MORE
20,102,100,2,202,102,100,4.624973,4.60517,0.01980263,9.230143,4.624973,4.60517,0,0,1,1.2045,3,1.1506,MORE
20,100,84,16,184,100,84,4.60517,4.430817,0.1743534,9.035987,4.60517,4.430817,0,0,1,1.5175,2,1.7401,MORE
20,132,150,18,282,150,132,4.882802,5.010635,0.1278334,9.893437,5.010635,4.882802,1,1,1,1.1257,4,0.9854,MORE
20,147,150,3,297,147,150,4.990433,5.010635,0.02020271,10.00107,4.990433,5.010635,0,1,0,3.4824,1,1.1818,MORE
20,52,50,2,102,52,50,3.951244,3.912023,0.03922071,7.863267,3.951244,3.912023,0,0,1,1.9267,3,1.1683,MORE
20,150,162,12,312,150,162,5.010635,5.087596,0.07696104,10.09823,5.010635,5.087596,0,1,0,1.5429,3,0.9642,MORE
20,46,50,4,96,50,46,3.828641,3.912023,0.08338161,7.740664,3.912023,3.828641,1,1,1,1.354,2,1.1555,MORE
20,150,177,27,327,177,150,5.010635,5.17615,0.1655144,10.18679,5.17615,5.010635,1,1,1,1.3844,4,0.9057,MORE
20,50,58,8,108,58,50,3.912023,4.060443,0.14842,7.972466,4.060443,3.912023,1,1,1,1.5673,2,1.4197,MORE
20,50,59,9,109,59,50,3.912023,4.077537,0.1655144,7.98956,4.077537,3.912023,1,1,1,2.4171,2,0.991,MORE
20,51,50,1,101,51,50,3.931826,3.912023,0.01980263,7.843849,3.931826,3.912023,0,0,1,1.5004,1,1.2846,MORE
20,60,50,10,110,60,50,4.094345,3.912023,0.1823216,8.006368,4.094345,3.912023,0,0,1,1.9059,2,1.0517,MORE
20,116,100,16,216,116,100,4.75359,4.60517,0.14842,9.35876,4.75359,4.60517,0,0,1,1.557,3,1.7356,MORE
20,141,150,9,291,141,150,4.94876,5.010635,0.0618754,9.959395,4.94876,5.010635,0,1,0,3.6517,1,1.1349,MORE
20,106,100,6,206,106,100,4.663439,4.60517,0.05826891,9.268609,4.663439,4.60517,0,0,1,3.0381,2,0.8998,MORE
20,116,100,16,216,116,100,4.75359,4.60517,0.14842,9.35876,4.75359,4.60517,0,0,1,4.4279,2,0.8978,MORE
20,123,150,27,273,150,123,4.812184,5.010635,0.1984509,9.82282,5.010635,4.812184,1,1,1,1.4212,3,0.8056,MORE
20,168,150,18,318,168,150,5.123964,5.010635,0.1133287,10.1346,5.123964,5.010635,0,0,1,1.2043,4,1.1142,MORE
20,150,147,3,297,150,147,5.010635,4.990433,0.02020271,10.00107,5.010635,4.990433,0,0,1,2.9089,2,0.9344,MORE
20,98,100,2,198,100,98,4.584967,4.60517,0.02020271,9.190138,4.60517,4.584967,1,1,1,1.2262,3,0.8354,MORE
20,50,51,1,101,51,50,3.912023,3.931826,0.01980263,7.843849,3.931826,3.912023,1,1,1,3.7846,1,1.2358,MORE
20,55,50,5,105,55,50,4.007333,3.912023,0.09531018,7.919356,4.007333,3.912023,0,0,1,1.4976,3,0.9373,MORE
20,45,50,5,95,50,45,3.806662,3.912023,0.1053605,7.718685,3.912023,3.806662,1,1,1,1.7957,2,0.9785,MORE
20,171,150,21,321,171,150,5.141664,5.010635,0.1310283,10.1523,5.141664,5.010635,0,0,1,2.3878,4,0.8652,MORE
20,57,50,7,107,57,50,4.043051,3.912023,0.1310283,7.955074,4.043051,3.912023,0,0,1,3.7987,2,0.851,MORE
20,150,126,24,276,150,126,5.010635,4.836282,0.1743534,9.846917,5.010635,4.836282,0,0,1,1.2221,4,0.7887,MORE
20,100,102,2,202,102,100,4.60517,4.624973,0.01980263,9.230143,4.624973,4.60517,1,1,1,1.5929,3,0.8736,MORE
20,50,42,8,92,50,42,3.912023,3.73767,0.1743534,7.649693,3.912023,3.73767,0,0,1,2.431,2,1.072,MORE
20,135,150,15,285,150,135,4.905275,5.010635,0.1053605,9.91591,5.010635,4.905275,1,1,1,2.8502,2,0.96,MORE
20,56,50,6,106,56,50,4.025352,3.912023,0.1133287,7.937375,4.025352,3.912023,0,0,1,1.4264,3,0.8866,MORE
20,150,147,3,297,150,147,5.010635,4.990433,0.02020271,10.00107,5.010635,4.990433,0,0,1,1.8612,3,0.9481,MORE
20,104,100,4,204,104,100,4.644391,4.60517,0.03922071,9.249561,4.644391,4.60517,0,0,1,4.6173,1,1.1001,MORE
20,43,50,7,93,50,43,3.7612,3.912023,0.1508229,7.673223,3.912023,3.7612,1,1,1,2.1636,2,0.8701,MORE
20,58,50,8,108,58,50,4.060443,3.912023,0.14842,7.972466,4.060443,3.912023,0,0,1,1.5288,3,0.8402,MORE
20,50,53,3,103,53,50,3.912023,3.970292,0.05826891,7.882315,3.970292,3.912023,1,1,1,1.5945,2,1.003,MORE
20,50,56,6,106,56,50,3.912023,4.025352,0.1133287,7.937375,4.025352,3.912023,1,1,1,1.4261,3,0.7346,MORE
20,150,141,9,291,150,141,5.010635,4.94876,0.0618754,9.959395,5.010635,4.94876,0,0,1,1.3663,4,0.87,MORE
20,174,150,24,324,174,150,5.159055,5.010635,0.14842,10.16969,5.159055,5.010635,0,0,1,1.6747,4,0.8054,MORE
20,100,88,12,188,100,88,4.60517,4.477337,0.1278334,9.082507,4.60517,4.477337,0,0,1,2.7579,2,0.4462,MORE
20,150,135,15,285,150,135,5.010635,4.905275,0.1053605,9.91591,5.010635,4.905275,0,0,1,1.8978,3,0.4146,MORE
20,100,116,16,216,116,100,4.60517,4.75359,0.14842,9.35876,4.75359,4.60517,1,1,1,1.2174,3,0.8633,MORE
20,141,150,9,291,141,150,4.94876,5.010635,0.0618754,9.959395,4.94876,5.010635,0,1,0,3.0513,2,1.2149,MORE
20,42,50,8,92,50,42,3.73767,3.912023,0.1743534,7.649693,3.912023,3.73767,1,1,1,3.4614,1,1.0549,MORE
20,162,150,12,312,162,150,5.087596,5.010635,0.07696104,10.09823,5.087596,5.010635,0,0,1,1.1703,4,0.8836,MORE
20,59,50,9,109,59,50,4.077537,3.912023,0.1655144,7.98956,4.077537,3.912023,0,0,1,1.3063,2,0.8834,MORE
20,100,86,14,186,86,100,4.60517,4.454347,0.1508229,9.059517,4.454347,4.60517,1,0,0,1.4711,2,1.0069,MORE
20,150,123,27,273,150,123,5.010635,4.812184,0.1984509,9.82282,5.010635,4.812184,0,0,1,1.144,3,0.8161,MORE
20,150,165,15,315,150,165,5.010635,5.105945,0.09531018,10.11658,5.010635,5.105945,0,1,0,2.6409,2,1.0047,MORE
20,59,50,9,109,59,50,4.077537,3.912023,0.1655144,7.98956,4.077537,3.912023,0,0,1,2.0505,2,0.862,MORE
20,100,110,10,210,110,100,4.60517,4.70048,0.09531018,9.305651,4.70048,4.60517,1,1,1,1.386,3,0.813,MORE
20,138,150,12,288,138,150,4.927254,5.010635,0.08338161,9.937889,4.927254,5.010635,0,1,0,2.8481,2,2.2759,MORE
20,106,100,6,206,106,100,4.663439,4.60517,0.05826891,9.268609,4.663439,4.60517,0,0,1,1.749,3,0.7364,MORE
20,180,150,30,330,150,180,5.192957,5.010635,0.1823216,10.20359,5.010635,5.192957,1,0,0,2.8852,3,0.8169,MORE
20,48,50,2,98,48,50,3.871201,3.912023,0.04082199,7.783224,3.871201,3.912023,0,1,0,3.3741,2,0.867,MORE
20,53,50,3,103,53,50,3.970292,3.912023,0.05826891,7.882315,3.970292,3.912023,0,0,1,1.9152,1,1.055,MORE
20,41,50,9,91,50,41,3.713572,3.912023,0.1984509,7.625595,3.912023,3.713572,1,1,1,1.639,2,1.0211,MORE
20,42,50,8,92,50,42,3.73767,3.912023,0.1743534,7.649693,3.912023,3.73767,1,1,1,1.8216,2,0.9092,MORE
20,150,126,24,276,150,126,5.010635,4.836282,0.1743534,9.846917,5.010635,4.836282,0,0,1,1.1767,4,0.8523,MORE
20,50,57,7,107,57,50,3.912023,4.043051,0.1310283,7.955074,4.043051,3.912023,1,1,1,1.5426,3,0.884,MORE
20,55,50,5,105,55,50,4.007333,3.912023,0.09531018,7.919356,4.007333,3.912023,0,0,1,1.3661,2,1.069,MORE
20,100,112,12,212,112,100,4.60517,4.718499,0.1133287,9.323669,4.718499,4.60517,1,1,1,3.3095,1,1.2254,MORE
20,46,50,4,96,50,46,3.828641,3.912023,0.08338161,7.740664,3.912023,3.828641,1,1,1,1.2917,2,1.0074,MORE
20,100,102,2,202,100,102,4.60517,4.624973,0.01980263,9.230143,4.60517,4.624973,0,1,0,1.1608,3,0.8252,MORE
20,100,82,18,182,100,82,4.60517,4.406719,0.1984509,9.011889,4.60517,4.406719,0,0,1,1.2325,3,0.9526,MORE
20,50,45,5,95,45,50,3.912023,3.806662,0.1053605,7.718685,3.806662,3.912023,1,0,0,3.7681,1,1.1404,MORE
20,49,50,1,99,49,50,3.89182,3.912023,0.02020271,7.803843,3.89182,3.912023,0,1,0,1.5231,2,1.1067,MORE
20,51,50,1,101,51,50,3.931826,3.912023,0.01980263,7.843849,3.931826,3.912023,0,0,1,2.5827,2,1.2237,MORE
20,94,100,6,194,100,94,4.543295,4.60517,0.0618754,9.148465,4.60517,4.543295,1,1,1,1.5592,2,1.6709,MORE
20,50,43,7,93,50,43,3.912023,3.7612,0.1508229,7.673223,3.912023,3.7612,0,0,1,1.3228,3,1.1047,MORE
20,114,100,14,214,114,100,4.736198,4.60517,0.1310283,9.341369,4.736198,4.60517,0,0,1,2.9426,1,1.3846,MORE
20,100,114,14,214,114,100,4.60517,4.736198,0.1310283,9.341369,4.736198,4.60517,1,1,1,1.5824,2,0.8834,MORE
20,100,92,8,192,100,92,4.60517,4.521789,0.08338161,9.126959,4.60517,4.521789,0,0,1,1.2674,3,0.8532,MORE
20,150,120,30,270,150,120,5.010635,4.787492,0.2231436,9.798127,5.010635,4.787492,0,0,1,1.639,4,0.8238,MORE
20,80,100,20,180,100,80,4.382027,4.60517,0.2231436,8.987197,4.60517,4.382027,1,1,1,1.2764,3,0.9872,MORE
20,100,104,4,204,100,104,4.60517,4.644391,0.03922071,9.249561,4.60517,4.644391,0,1,0,1.648,3,0.8067,MORE
20,156,150,6,306,156,150,5.049856,5.010635,0.03922071,10.06049,5.049856,5.010635,0,0,1,3.232,1,1.185,MORE
20,104,100,4,204,104,100,4.644391,4.60517,0.03922071,9.249561,4.644391,4.60517,0,0,1,2.8976,2,0.8543,MORE
20,150,180,30,330,180,150,5.010635,5.192957,0.1823216,10.20359,5.192957,5.010635,1,1,1,1.3147,3,0.8797,MORE
20,110,100,10,210,110,100,4.70048,4.60517,0.09531018,9.305651,4.70048,4.60517,0,0,1,1.1259,3,0.8521,MORE
20,112,100,12,212,112,100,4.718499,4.60517,0.1133287,9.323669,4.718499,4.60517,0,0,1,1.9579,2,0.8675,MORE
20,50,45,5,95,45,50,3.912023,3.806662,0.1053605,7.718685,3.806662,3.912023,1,0,0,2.3415,2,1.0014,MORE
20,44,50,6,94,50,44,3.78419,3.912023,0.1278334,7.696213,3.912023,3.78419,1,1,1,1.1349,3,0.8981,MORE
20,100,94,6,194,100,94,4.60517,4.543295,0.0618754,9.148465,4.60517,4.543295,0,0,1,3.5357,1,1.1044,MORE
20,156,150,6,306,156,150,5.049856,5.010635,0.03922071,10.06049,5.049856,5.010635,0,0,1,1.7497,3,0.8824,MORE
20,40,50,10,90,50,40,3.688879,3.912023,0.2231436,7.600902,3.912023,3.688879,1,1,1,1.36,4,1.1865,MORE
20,126,150,24,276,150,126,4.836282,5.010635,0.1743534,9.846917,5.010635,4.836282,1,1,1,4.9738,1,1.0166,MORE
20,162,150,12,312,162,150,5.087596,5.010635,0.07696104,10.09823,5.087596,5.010635,0,0,1,1.3095,3,1.5753,MORE
20,123,150,27,273,150,123,4.812184,5.010635,0.1984509,9.82282,5.010635,4.812184,1,1,1,1.2435,4,0.8572,MORE
20,84,100,16,184,100,84,4.430817,4.60517,0.1743534,9.035987,4.60517,4.430817,1,1,1,1.1937,3,1.0184,MORE
20,108,100,8,208,108,100,4.682131,4.60517,0.07696104,9.287301,4.682131,4.60517,0,0,1,2.1234,2,1.0899,MORE
20,82,100,18,182,100,82,4.406719,4.60517,0.1984509,9.011889,4.60517,4.406719,1,1,1,1.5203,3,1.0532,MORE
20,47,50,3,97,50,47,3.850148,3.912023,0.0618754,7.762171,3.912023,3.850148,1,1,1,2.5721,2,1.0591,MORE
20,50,41,9,91,50,41,3.912023,3.713572,0.1984509,7.625595,3.912023,3.713572,0,0,1,1.1621,4,0.9866,MORE
20,82,100,18,182,100,82,4.406719,4.60517,0.1984509,9.011889,4.60517,4.406719,1,1,1,1.1509,4,0.9988,MORE
20,100,108,8,208,108,100,4.60517,4.682131,0.07696104,9.287301,4.682131,4.60517,1,1,1,1.3658,2,1.7745,MORE
20,100,120,20,220,120,100,4.60517,4.787492,0.1823216,9.392662,4.787492,4.60517,1,1,1,1.2757,2,1.2877,MORE
20,150,129,21,279,150,129,5.010635,4.859812,0.1508229,9.870448,5.010635,4.859812,0,0,1,1.246,3,0.9893,MORE
20,94,100,6,194,100,94,4.543295,4.60517,0.0618754,9.148465,4.60517,4.543295,1,1,1,1.2462,3,1.0816,MORE
20,48,50,2,98,50,48,3.871201,3.912023,0.04082199,7.783224,3.912023,3.871201,1,1,1,2.0127,1,1.355,MORE
20,44,50,6,94,44,50,3.78419,3.912023,0.1278334,7.696213,3.78419,3.912023,0,1,0,3.0637,2,1.0633,MORE
20,100,90,10,190,100,90,4.60517,4.49981,0.1053605,9.10498,4.60517,4.49981,0,0,1,1.4394,3,0.8091,MORE
20,118,100,18,218,118,100,4.770685,4.60517,0.1655144,9.375855,4.770685,4.60517,0,0,1,1.4473,3,0.9759,MORE
20,150,165,15,315,165,150,5.010635,5.105945,0.09531018,10.11658,5.105945,5.010635,1,1,1,3.6768,2,1.5021,MORE
20,100,104,4,204,100,104,4.60517,4.644391,0.03922071,9.249561,4.60517,4.644391,0,1,0,3.1993,2,0.9626,MORE
20,50,55,5,105,55,50,3.912023,4.007333,0.09531018,7.919356,4.007333,3.912023,1,1,1,2.9545,1,2.0566,MORE
20,150,177,27,327,150,177,5.010635,5.17615,0.1655144,10.18679,5.010635,5.17615,0,1,0,3.3355,1,1.1423,MORE
20,102,100,2,202,100,102,4.624973,4.60517,0.01980263,9.230143,4.60517,4.624973,1,0,0,1.3785,2,1.0886,MORE
20,165,150,15,315,165,150,5.105945,5.010635,0.09531018,10.11658,5.105945,5.010635,0,0,1,1.7662,2,1.0687,MORE
20,88,100,12,188,100,88,4.477337,4.60517,0.1278334,9.082507,4.60517,4.477337,1,1,1,1.4267,3,0.9941,MORE
20,54,50,4,104,54,50,3.988984,3.912023,0.07696104,7.901007,3.988984,3.912023,0,0,1,2.3819,2,1.0196,MORE
20,108,100,8,208,108,100,4.682131,4.60517,0.07696104,9.287301,4.682131,4.60517,0,0,1,1.3154,3,1.3542,MORE
20,150,120,30,270,150,120,5.010635,4.787492,0.2231436,9.798127,5.010635,4.787492,0,0,1,1.4044,4,0.8984,MORE
21,100,80,20,180,100,80,4.60517,4.382027,0.2231436,8.987197,4.60517,4.382027,0,0,1,2.7393,1,3.5235,MORE
21,100,114,14,214,114,100,4.60517,4.736198,0.1310283,9.341369,4.736198,4.60517,1,1,1,4.6906,2,1.6483,MORE
21,100,110,10,210,100,110,4.60517,4.70048,0.09531018,9.305651,4.60517,4.70048,0,1,0,2.695,3,2.0018,MORE
21,42,50,8,92,50,42,3.73767,3.912023,0.1743534,7.649693,3.912023,3.73767,1,1,1,2.3904,4,1.3172,MORE
21,96,100,4,196,100,96,4.564348,4.60517,0.04082199,9.169518,4.60517,4.564348,1,1,1,2.2369,3,1.5883,MORE
21,50,42,8,92,50,42,3.912023,3.73767,0.1743534,7.649693,3.912023,3.73767,0,0,1,2.024,3,1.2395,MORE
21,82,100,18,182,82,100,4.406719,4.60517,0.1984509,9.011889,4.406719,4.60517,0,1,0,2.2594,2,1.1993,MORE
21,50,52,2,102,50,52,3.912023,3.951244,0.03922071,7.863267,3.912023,3.951244,0,1,0,1.8582,2,1.3641,MORE
21,50,56,6,106,50,56,3.912023,4.025352,0.1133287,7.937375,3.912023,4.025352,0,1,0,5.6529,1,1.1704,MORE
21,56,50,6,106,56,50,4.025352,3.912023,0.1133287,7.937375,4.025352,3.912023,0,0,1,1.6337,2,0.9754,MORE
21,162,150,12,312,162,150,5.087596,5.010635,0.07696104,10.09823,5.087596,5.010635,0,0,1,1.568,3,0.4836,MORE
21,50,53,3,103,53,50,3.912023,3.970292,0.05826891,7.882315,3.970292,3.912023,1,1,1,2.5668,4,1.4885,MORE
21,100,98,2,198,100,98,4.60517,4.584967,0.02020271,9.190138,4.60517,4.584967,0,0,1,1.5664,2,0.5825,MORE
21,112,100,12,212,112,100,4.718499,4.60517,0.1133287,9.323669,4.718499,4.60517,0,0,1,1.5401,2,0.4161,MORE
21,106,100,6,206,106,100,4.663439,4.60517,0.05826891,9.268609,4.663439,4.60517,0,0,1,1.4925,2,0.4072,MORE
21,156,150,6,306,156,150,5.049856,5.010635,0.03922071,10.06049,5.049856,5.010635,0,0,1,1.5253,2,0.3137,MORE
21,100,92,8,192,100,92,4.60517,4.521789,0.08338161,9.126959,4.60517,4.521789,0,0,1,1.5837,1,0.4257,MORE
21,177,150,27,327,177,150,5.17615,5.010635,0.1655144,10.18679,5.17615,5.010635,0,0,1,1.5997,4,2.7481,MORE
21,49,50,1,99,49,50,3.89182,3.912023,0.02020271,7.803843,3.89182,3.912023,0,1,0,1.7031,2,0.3413,MORE
21,100,94,6,194,100,94,4.60517,4.543295,0.0618754,9.148465,4.60517,4.543295,0,0,1,1.5623,2,0.3733,MORE
21,150,171,21,321,150,171,5.010635,5.141664,0.1310283,10.1523,5.010635,5.141664,0,1,0,1.4048,2,0.3189,MORE
21,50,51,1,101,51,50,3.912023,3.931826,0.01980263,7.843849,3.931826,3.912023,1,1,1,2.3246,3,0.3565,MORE
21,50,55,5,105,55,50,3.912023,4.007333,0.09531018,7.919356,4.007333,3.912023,1,1,1,1.9441,3,0.3377,MORE
21,100,80,20,180,100,80,4.60517,4.382027,0.2231436,8.987197,4.60517,4.382027,0,0,1,1.6272,1,0.3506,MORE
21,150,168,18,318,168,150,5.010635,5.123964,0.1133287,10.1346,5.123964,5.010635,1,1,1,2.2189,3,0.5304,MORE
21,100,96,4,196,100,96,4.60517,4.564348,0.04082199,9.169518,4.60517,4.564348,0,0,1,1.7705,4,0.5816,MORE
21,150,129,21,279,150,129,5.010635,4.859812,0.1508229,9.870448,5.010635,4.859812,0,0,1,1.5521,2,0.4651,MORE
21,100,98,2,198,100,98,4.60517,4.584967,0.02020271,9.190138,4.60517,4.584967,0,0,1,1.3395,2,0.2665,MORE
21,138,150,12,288,138,150,4.927254,5.010635,0.08338161,9.937889,4.927254,5.010635,0,1,0,0.7543,2,0.0509,MORE
21,55,50,5,105,50,55,4.007333,3.912023,0.09531018,7.919356,3.912023,4.007333,1,0,0,2.0042,2,0.3031,MORE
21,88,100,12,188,88,100,4.477337,4.60517,0.1278334,9.082507,4.477337,4.60517,0,1,0,1.7818,2,0.2007,MORE
21,141,150,9,291,150,141,4.94876,5.010635,0.0618754,9.959395,5.010635,4.94876,1,1,1,1.8052,2,0.3977,MORE
21,114,100,14,214,114,100,4.736198,4.60517,0.1310283,9.341369,4.736198,4.60517,0,0,1,1.3137,2,0.1539,MORE
21,102,100,2,202,102,100,4.624973,4.60517,0.01980263,9.230143,4.624973,4.60517,0,0,1,1.3303,2,0.0995,MORE
21,150,147,3,297,150,147,5.010635,4.990433,0.02020271,10.00107,5.010635,4.990433,0,0,1,0.6663,2,0.0672,MORE
21,50,47,3,97,47,50,3.912023,3.850148,0.0618754,7.762171,3.850148,3.912023,1,0,0,1.5655,2,0.2252,MORE
21,60,50,10,110,60,50,4.094345,3.912023,0.1823216,8.006368,4.094345,3.912023,0,0,1,1.408,2,0.0535,MORE
21,180,150,30,330,180,150,5.192957,5.010635,0.1823216,10.20359,5.192957,5.010635,0,0,1,1.0635,2,0.0343,MORE
21,135,150,15,285,150,135,4.905275,5.010635,0.1053605,9.91591,5.010635,4.905275,1,1,1,1.5308,2,0.085,MORE
21,46,50,4,96,50,46,3.828641,3.912023,0.08338161,7.740664,3.912023,3.828641,1,1,1,1.4422,4,0.5502,MORE
21,50,41,9,91,50,41,3.912023,3.713572,0.1984509,7.625595,3.912023,3.713572,0,0,1,1.9944,2,1.1875,MORE
21,123,150,27,273,150,123,4.812184,5.010635,0.1984509,9.82282,5.010635,4.812184,1,1,1,1.8759,1,0.4168,MORE
21,59,50,9,109,59,50,4.077537,3.912023,0.1655144,7.98956,4.077537,3.912023,0,0,1,1.7359,3,0.4481,MORE
21,50,60,10,110,60,50,3.912023,4.094345,0.1823216,8.006368,4.094345,3.912023,1,1,1,1.6843,4,0.4504,MORE
21,100,108,8,208,100,108,4.60517,4.682131,0.07696104,9.287301,4.60517,4.682131,0,1,0,1.8526,3,0.4002,MORE
21,174,150,24,324,174,150,5.159055,5.010635,0.14842,10.16969,5.159055,5.010635,0,0,1,1.2673,3,0.2036,MORE
21,150,174,24,324,174,150,5.010635,5.159055,0.14842,10.16969,5.159055,5.010635,1,1,1,1.6094,4,0.2897,MORE
21,165,150,15,315,165,150,5.105945,5.010635,0.09531018,10.11658,5.105945,5.010635,0,0,1,1.776,3,0.1339,MORE
21,100,104,4,204,100,104,4.60517,4.644391,0.03922071,9.249561,4.60517,4.644391,0,1,0,1.0096,3,0.2496,MORE
21,100,112,12,212,112,100,4.60517,4.718499,0.1133287,9.323669,4.718499,4.60517,1,1,1,1.4351,3,0.1686,MORE
21,50,54,4,104,54,50,3.912023,3.988984,0.07696104,7.901007,3.988984,3.912023,1,1,1,1.7397,2,0.2346,MORE
21,150,120,30,270,150,120,5.010635,4.787492,0.2231436,9.798127,5.010635,4.787492,0,0,1,1.4906,2,0.1271,MORE
21,50,45,5,95,45,50,3.912023,3.806662,0.1053605,7.718685,3.806662,3.912023,1,0,0,1.4433,4,0.4035,MORE
21,50,57,7,107,57,50,3.912023,4.043051,0.1310283,7.955074,4.043051,3.912023,1,1,1,1.5523,4,0.3865,MORE
21,153,150,3,303,153,150,5.030438,5.010635,0.01980263,10.04107,5.030438,5.010635,0,0,1,1.5545,2,0.334,MORE
21,100,102,2,202,100,102,4.60517,4.624973,0.01980263,9.230143,4.60517,4.624973,0,1,0,1.5464,2,0.0508,MORE
21,116,100,16,216,100,116,4.75359,4.60517,0.14842,9.35876,4.60517,4.75359,1,0,0,1.609,3,0.1534,MORE
21,150,132,18,282,132,150,5.010635,4.882802,0.1278334,9.893437,4.882802,5.010635,1,0,0,1.1189,2,0.1602,MORE
21,144,150,6,294,150,144,4.969813,5.010635,0.04082199,9.980449,5.010635,4.969813,1,1,1,0.6671,2,0.0164,MORE
21,43,50,7,93,50,43,3.7612,3.912023,0.1508229,7.673223,3.912023,3.7612,1,1,1,0.8118,2,6e-04,MORE
21,44,50,6,94,50,44,3.78419,3.912023,0.1278334,7.696213,3.912023,3.78419,1,1,1,0.8089,2,0.004,MORE
21,150,135,15,285,150,135,5.010635,4.905275,0.1053605,9.91591,5.010635,4.905275,0,0,1,1.8726,1,1.5644,MORE
21,150,138,12,288,150,138,5.010635,4.927254,0.08338161,9.937889,5.010635,4.927254,0,0,1,1.3102,1,0.9514,MORE
21,150,141,9,291,150,141,5.010635,4.94876,0.0618754,9.959395,5.010635,4.94876,0,0,1,0.9663,1,4e-04,MORE
21,50,40,10,90,50,40,3.912023,3.688879,0.2231436,7.600902,3.912023,3.688879,0,0,1,1.3094,1,0.9568,MORE
21,50,42,8,92,42,50,3.912023,3.73767,0.1743534,7.649693,3.73767,3.912023,1,0,0,2.1993,4,0.9841,MORE
21,60,50,10,110,50,60,4.094345,3.912023,0.1823216,8.006368,3.912023,4.094345,1,0,0,1.369,3,1.0329,MORE
21,50,41,9,91,50,41,3.912023,3.713572,0.1984509,7.625595,3.912023,3.713572,0,0,1,1.0816,3,0.0514,MORE
21,43,50,7,93,43,50,3.7612,3.912023,0.1508229,7.673223,3.7612,3.912023,0,1,0,1.0133,4,1.8411,MORE
21,50,54,4,104,54,50,3.912023,3.988984,0.07696104,7.901007,3.988984,3.912023,1,1,1,3.2669,4,0.5339,MORE
21,100,86,14,186,86,100,4.60517,4.454347,0.1508229,9.059517,4.454347,4.60517,1,0,0,1.342,3,0.0227,MORE
21,150,177,27,327,177,150,5.010635,5.17615,0.1655144,10.18679,5.17615,5.010635,1,1,1,1.1461,3,0.0204,MORE
21,108,100,8,208,108,100,4.682131,4.60517,0.07696104,9.287301,4.682131,4.60517,0,0,1,1.6389,2,0.1885,MORE
21,168,150,18,318,168,150,5.123964,5.010635,0.1133287,10.1346,5.123964,5.010635,0,0,1,0.9365,2,4e-04,MORE
21,150,126,24,276,150,126,5.010635,4.836282,0.1743534,9.846917,5.010635,4.836282,0,0,1,0.7916,2,4e-04,MORE
21,150,147,3,297,150,147,5.010635,4.990433,0.02020271,10.00107,5.010635,4.990433,0,0,1,0.6499,2,0.0019,MORE
21,150,171,21,321,171,150,5.010635,5.141664,0.1310283,10.1523,5.141664,5.010635,1,1,1,1.2799,2,0.0145,MORE
21,50,58,8,108,58,50,3.912023,4.060443,0.14842,7.972466,4.060443,3.912023,1,1,1,0.8715,2,4e-04,MORE
21,45,50,5,95,45,50,3.806662,3.912023,0.1053605,7.718685,3.806662,3.912023,0,1,0,1.8304,2,0.0052,MORE
21,129,150,21,279,150,129,4.859812,5.010635,0.1508229,9.870448,5.010635,4.859812,1,1,1,1.3034,2,1.2304,MORE
21,147,150,3,297,147,150,4.990433,5.010635,0.02020271,10.00107,4.990433,5.010635,0,1,0,2.0671,2,0.3548,MORE
21,50,59,9,109,50,59,3.912023,4.077537,0.1655144,7.98956,3.912023,4.077537,0,1,0,0.8761,2,0.0311,MORE
21,41,50,9,91,41,50,3.713572,3.912023,0.1984509,7.625595,3.713572,3.912023,0,1,0,1.0633,1,0.5415,MORE
21,135,150,15,285,150,135,4.905275,5.010635,0.1053605,9.91591,5.010635,4.905275,1,1,1,1.3367,4,0.8727,MORE
21,50,59,9,109,50,59,3.912023,4.077537,0.1655144,7.98956,3.912023,4.077537,0,1,0,1.4623,3,0.3832,MORE
21,150,138,12,288,150,138,5.010635,4.927254,0.08338161,9.937889,5.010635,4.927254,0,0,1,1.1771,2,0.0034,MORE
21,44,50,6,94,50,44,3.78419,3.912023,0.1278334,7.696213,3.912023,3.78419,1,1,1,1.4569,2,0.0339,MORE
21,100,92,8,192,100,92,4.60517,4.521789,0.08338161,9.126959,4.60517,4.521789,0,0,1,1.5318,1,0.0503,MORE
21,150,144,6,294,150,144,5.010635,4.969813,0.04082199,9.980449,5.010635,4.969813,0,0,1,2.5351,4,0.2165,MORE
21,100,116,16,216,116,100,4.60517,4.75359,0.14842,9.35876,4.75359,4.60517,1,1,1,1.4266,4,0.0755,MORE
21,104,100,4,204,104,100,4.644391,4.60517,0.03922071,9.249561,4.644391,4.60517,0,0,1,1.2937,2,0.0182,MORE
21,100,114,14,214,100,114,4.60517,4.736198,0.1310283,9.341369,4.60517,4.736198,0,1,0,0.7774,3,0.0187,MORE
21,51,50,1,101,51,50,3.931826,3.912023,0.01980263,7.843849,3.931826,3.912023,0,0,1,1.4617,2,0.0166,MORE
21,150,153,3,303,150,153,5.010635,5.030438,0.01980263,10.04107,5.010635,5.030438,0,1,0,0.6823,2,0.0163,MORE
21,108,100,8,208,108,100,4.682131,4.60517,0.07696104,9.287301,4.682131,4.60517,0,0,1,0.8576,2,0.0033,MORE
21,141,150,9,291,141,150,4.94876,5.010635,0.0618754,9.959395,4.94876,5.010635,0,1,0,0.6677,2,6e-04,MORE
21,50,44,6,94,50,44,3.912023,3.78419,0.1278334,7.696213,3.912023,3.78419,0,0,1,0.5449,2,0.0149,MORE
21,100,120,20,220,100,120,4.60517,4.787492,0.1823216,9.392662,4.60517,4.787492,0,1,0,0.6302,2,6e-04,MORE
21,150,153,3,303,150,153,5.010635,5.030438,0.01980263,10.04107,5.010635,5.030438,0,1,0,0.9533,2,0.0099,MORE
21,123,150,27,273,150,123,4.812184,5.010635,0.1984509,9.82282,5.010635,4.812184,1,1,1,1.8011,3,0.0235,MORE
21,177,150,27,327,177,150,5.17615,5.010635,0.1655144,10.18679,5.17615,5.010635,0,0,1,1.1444,2,5e-04,MORE
21,159,150,9,309,159,150,5.068904,5.010635,0.05826891,10.07954,5.068904,5.010635,0,0,1,0.8802,2,7e-04,MORE
21,50,56,6,106,56,50,3.912023,4.025352,0.1133287,7.937375,4.025352,3.912023,1,1,1,1.5547,3,0.0013,MORE
21,57,50,7,107,57,50,4.043051,3.912023,0.1310283,7.955074,4.043051,3.912023,0,0,1,0.829,2,1.0807,MORE
21,49,50,1,99,49,50,3.89182,3.912023,0.02020271,7.803843,3.89182,3.912023,0,1,0,1.7987,1,0.0503,MORE
21,50,51,1,101,51,50,3.912023,3.931826,0.01980263,7.843849,3.931826,3.912023,1,1,1,1.6586,2,6e-04,MORE
21,50,47,3,97,50,47,3.912023,3.850148,0.0618754,7.762171,3.912023,3.850148,0,0,1,0.9653,2,0.6829,MORE
21,48,50,2,98,48,50,3.871201,3.912023,0.04082199,7.783224,3.871201,3.912023,0,1,0,0.7458,2,0.0105,MORE
21,106,100,6,206,106,100,4.663439,4.60517,0.05826891,9.268609,4.663439,4.60517,0,0,1,0.5851,2,0.0034,MORE
21,100,110,10,210,110,100,4.60517,4.70048,0.09531018,9.305651,4.70048,4.60517,1,1,1,1.3133,2,0.0101,MORE
21,168,150,18,318,168,150,5.123964,5.010635,0.1133287,10.1346,5.123964,5.010635,0,0,1,1.2341,2,0.4168,MORE
21,118,100,18,218,118,100,4.770685,4.60517,0.1655144,9.375855,4.770685,4.60517,0,0,1,0.5933,2,6e-04,MORE
21,100,106,6,206,100,106,4.60517,4.663439,0.05826891,9.268609,4.60517,4.663439,0,1,0,0.4691,2,1.4712,MORE
21,171,150,21,321,171,150,5.141664,5.010635,0.1310283,10.1523,5.141664,5.010635,0,0,1,0.6461,2,0.9006,MORE
21,45,50,5,95,45,50,3.806662,3.912023,0.1053605,7.718685,3.806662,3.912023,0,1,0,0.7741,2,0.0235,MORE
21,100,82,18,182,100,82,4.60517,4.406719,0.1984509,9.011889,4.60517,4.406719,0,0,1,0.5705,2,0.0034,MORE
21,159,150,9,309,159,150,5.068904,5.010635,0.05826891,10.07954,5.068904,5.010635,0,0,1,0.5576,2,4e-04,MORE
21,150,120,30,270,150,120,5.010635,4.787492,0.2231436,9.798127,5.010635,4.787492,0,0,1,0.4606,2,0.0192,MORE
21,50,60,10,110,60,50,3.912023,4.094345,0.1823216,8.006368,4.094345,3.912023,1,1,1,1.4277,2,0.024,MORE
21,100,108,8,208,100,108,4.60517,4.682131,0.07696104,9.287301,4.60517,4.682131,0,1,0,0.5474,2,0.9143,MORE
21,54,50,4,104,54,50,3.988984,3.912023,0.07696104,7.901007,3.988984,3.912023,0,0,1,1.3167,3,1.2229,MORE
21,110,100,10,210,110,100,4.70048,4.60517,0.09531018,9.305651,4.70048,4.60517,0,0,1,0.698,2,0.0509,MORE
21,100,86,14,186,100,86,4.60517,4.454347,0.1508229,9.059517,4.60517,4.454347,0,0,1,1.611,2,0.2649,MORE
21,50,49,1,99,50,49,3.912023,3.89182,0.02020271,7.803843,3.912023,3.89182,0,0,1,1.16,1,0.0349,MORE
21,100,116,16,216,100,116,4.60517,4.75359,0.14842,9.35876,4.60517,4.75359,0,1,0,1.6365,4,0.6163,MORE
21,53,50,3,103,53,50,3.970292,3.912023,0.05826891,7.882315,3.970292,3.912023,0,0,1,0.8757,2,0.0843,MORE
21,50,49,1,99,50,49,3.912023,3.89182,0.02020271,7.803843,3.912023,3.89182,0,0,1,0.6657,3,0.0503,MORE
21,171,150,21,321,171,150,5.141664,5.010635,0.1310283,10.1523,5.141664,5.010635,0,0,1,1.646,1,0.0027,MORE
21,150,159,9,309,150,159,5.010635,5.068904,0.05826891,10.07954,5.010635,5.068904,0,1,0,1.0747,2,0.0669,MORE
21,100,94,6,194,94,100,4.60517,4.543295,0.0618754,9.148465,4.543295,4.60517,1,0,0,1.6181,4,0.448,MORE
21,98,100,2,198,98,100,4.584967,4.60517,0.02020271,9.190138,4.584967,4.60517,0,1,0,1.5112,2,0.0338,MORE
21,50,57,7,107,57,50,3.912023,4.043051,0.1310283,7.955074,4.043051,3.912023,1,1,1,1.402,2,0.2702,MORE
21,150,129,21,279,150,129,5.010635,4.859812,0.1508229,9.870448,5.010635,4.859812,0,0,1,1.2095,1,0.0339,MORE
21,150,168,18,318,168,150,5.010635,5.123964,0.1133287,10.1346,5.123964,5.010635,1,1,1,1.3804,2,5e-04,MORE
21,174,150,24,324,174,150,5.159055,5.010635,0.14842,10.16969,5.159055,5.010635,0,0,1,0.6706,2,0.8042,MORE
21,80,100,20,180,100,80,4.382027,4.60517,0.2231436,8.987197,4.60517,4.382027,1,1,1,1.4092,3,0.1876,MORE
21,59,50,9,109,50,59,4.077537,3.912023,0.1655144,7.98956,3.912023,4.077537,1,0,0,1.3189,3,3e-04,MORE
21,50,52,2,102,52,50,3.912023,3.951244,0.03922071,7.863267,3.951244,3.912023,1,1,1,0.6604,3,0.034,MORE
21,150,144,6,294,144,150,5.010635,4.969813,0.04082199,9.980449,4.969813,5.010635,1,0,0,0.8684,2,1.7164,MORE
21,100,118,18,218,118,100,4.60517,4.770685,0.1655144,9.375855,4.770685,4.60517,1,1,1,1.1854,2,5e-04,MORE
21,100,104,4,204,104,100,4.60517,4.644391,0.03922071,9.249561,4.644391,4.60517,1,1,1,1.1897,2,6e-04,MORE
21,100,96,4,196,96,100,4.60517,4.564348,0.04082199,9.169518,4.564348,4.60517,1,0,0,1.1736,2,0.0315,MORE
21,90,100,10,190,100,90,4.49981,4.60517,0.1053605,9.10498,4.60517,4.49981,1,1,1,0.8801,2,0.784,MORE
21,120,150,30,270,150,120,4.787492,5.010635,0.2231436,9.798127,5.010635,4.787492,1,1,1,1.3387,3,0.6164,MORE
21,150,180,30,330,180,150,5.010635,5.192957,0.1823216,10.20359,5.192957,5.010635,1,1,1,0.9401,2,0.5802,MORE
21,165,150,15,315,150,165,5.105945,5.010635,0.09531018,10.11658,5.010635,5.105945,1,0,0,1.6253,3,0.338,MORE
21,84,100,16,184,100,84,4.430817,4.60517,0.1743534,9.035987,4.60517,4.430817,1,1,1,0.7097,2,0.6995,MORE
21,50,48,2,98,50,48,3.912023,3.871201,0.04082199,7.783224,3.912023,3.871201,0,0,1,1.7354,3,0.057,MORE
21,118,100,18,218,118,100,4.770685,4.60517,0.1655144,9.375855,4.770685,4.60517,0,0,1,2.1307,4,3.2633,MORE
21,150,162,12,312,150,162,5.010635,5.087596,0.07696104,10.09823,5.010635,5.087596,0,1,0,1.8124,4,0.9429,MORE
21,80,100,20,180,80,100,4.382027,4.60517,0.2231436,8.987197,4.382027,4.60517,0,1,0,2.774,4,0.947,MORE
21,150,165,15,315,165,150,5.010635,5.105945,0.09531018,10.11658,5.105945,5.010635,1,1,1,2.4465,4,1.9811,MORE
21,82,100,18,182,100,82,4.406719,4.60517,0.1984509,9.011889,4.60517,4.406719,1,1,1,2.0561,3,0.7832,MORE
21,50,53,3,103,50,53,3.912023,3.970292,0.05826891,7.882315,3.912023,3.970292,0,1,0,3.248,2,0.5339,MORE
21,50,46,4,96,46,50,3.912023,3.828641,0.08338161,7.740664,3.828641,3.912023,1,0,0,1.8382,4,0.6309,MORE
21,42,50,8,92,50,42,3.73767,3.912023,0.1743534,7.649693,3.912023,3.73767,1,1,1,1.4393,3,0.667,MORE
21,100,120,20,220,120,100,4.60517,4.787492,0.1823216,9.392662,4.787492,4.60517,1,1,1,1.5768,4,0.6165,MORE
21,150,156,6,306,156,150,5.010635,5.049856,0.03922071,10.06049,5.049856,5.010635,1,1,1,1.6957,4,0.5497,MORE
21,150,177,27,327,150,177,5.010635,5.17615,0.1655144,10.18679,5.010635,5.17615,0,1,0,1.8649,3,0.6043,MORE
21,100,102,2,202,102,100,4.60517,4.624973,0.01980263,9.230143,4.624973,4.60517,1,1,1,1.4715,4,0.5855,MORE
21,94,100,6,194,94,100,4.543295,4.60517,0.0618754,9.148465,4.543295,4.60517,0,1,0,2.0286,3,0.6308,MORE
21,132,150,18,282,150,132,4.882802,5.010635,0.1278334,9.893437,5.010635,4.882802,1,1,1,1.724,4,2.1119,MORE
21,100,112,12,212,112,100,4.60517,4.718499,0.1133287,9.323669,4.718499,4.60517,1,1,1,1.456,1,0.7673,MORE
21,138,150,12,288,150,138,4.927254,5.010635,0.08338161,9.937889,5.010635,4.927254,1,1,1,1.4303,2,0.6992,MORE
21,92,100,8,192,100,92,4.521789,4.60517,0.08338161,9.126959,4.60517,4.521789,1,1,1,1.7391,3,0.8038,MORE
21,54,50,4,104,50,54,3.988984,3.912023,0.07696104,7.901007,3.912023,3.988984,1,0,0,2.2417,4,0.6695,MORE
21,100,88,12,188,100,88,4.60517,4.477337,0.1278334,9.082507,4.60517,4.477337,0,0,1,2.0303,3,0.6807,MORE
21,88,100,12,188,100,88,4.477337,4.60517,0.1278334,9.082507,4.60517,4.477337,1,1,1,1.7254,3,2.2018,MORE
21,50,43,7,93,43,50,3.912023,3.7612,0.1508229,7.673223,3.7612,3.912023,1,0,0,1.8593,4,0.6999,MORE
21,129,150,21,279,150,129,4.859812,5.010635,0.1508229,9.870448,5.010635,4.859812,1,1,1,1.7693,4,0.5225,MORE
21,132,150,18,282,150,132,4.882802,5.010635,0.1278334,9.893437,5.010635,4.882802,1,1,1,1.5665,4,0.5731,MORE
21,96,100,4,196,96,100,4.564348,4.60517,0.04082199,9.169518,4.564348,4.60517,0,1,0,1.6578,3,0.5579,MORE
21,50,40,10,90,50,40,3.912023,3.688879,0.2231436,7.600902,3.912023,3.688879,0,0,1,1.6764,3,0.5665,MORE
21,100,106,6,206,106,100,4.60517,4.663439,0.05826891,9.268609,4.663439,4.60517,1,1,1,1.6211,4,0.5556,MORE
21,100,118,18,218,118,100,4.60517,4.770685,0.1655144,9.375855,4.770685,4.60517,1,1,1,1.6131,4,0.5829,MORE
21,120,100,20,220,120,100,4.787492,4.60517,0.1823216,9.392662,4.787492,4.60517,0,0,1,1.7071,4,0.548,MORE
21,100,88,12,188,100,88,4.60517,4.477337,0.1278334,9.082507,4.60517,4.477337,0,0,1,2.0552,3,0.6832,MORE
21,50,44,6,94,50,44,3.912023,3.78419,0.1278334,7.696213,3.912023,3.78419,0,0,1,1.8123,4,0.5846,MORE
21,58,50,8,108,58,50,4.060443,3.912023,0.14842,7.972466,4.060443,3.912023,0,0,1,1.8416,4,0.5498,MORE
21,53,50,3,103,50,53,3.970292,3.912023,0.05826891,7.882315,3.912023,3.970292,1,0,0,1.7313,3,1.9563,MORE
21,57,50,7,107,57,50,4.043051,3.912023,0.1310283,7.955074,4.043051,3.912023,0,0,1,1.8146,3,0.5561,MORE
21,144,150,6,294,150,144,4.969813,5.010635,0.04082199,9.980449,5.010635,4.969813,1,1,1,1.7094,4,0.5669,MORE
21,102,100,2,202,102,100,4.624973,4.60517,0.01980263,9.230143,4.624973,4.60517,0,0,1,1.7933,4,0.5667,MORE
21,90,100,10,190,100,90,4.49981,4.60517,0.1053605,9.10498,4.60517,4.49981,1,1,1,1.7628,4,0.6698,MORE
21,153,150,3,303,153,150,5.030438,5.010635,0.01980263,10.04107,5.030438,5.010635,0,0,1,1.6521,2,0.5903,MORE
21,156,150,6,306,156,150,5.049856,5.010635,0.03922071,10.06049,5.049856,5.010635,0,0,1,1.5969,1,0.5836,MORE
21,150,165,15,315,150,165,5.010635,5.105945,0.09531018,10.11658,5.010635,5.105945,0,1,0,1.6941,3,0.7222,MORE
21,150,174,24,324,150,174,5.010635,5.159055,0.14842,10.16969,5.010635,5.159055,0,1,0,1.8088,4,0.5168,MORE
21,41,50,9,91,50,41,3.713572,3.912023,0.1984509,7.625595,3.912023,3.713572,1,1,1,1.686,3,0.8664,MORE
21,50,45,5,95,50,45,3.912023,3.806662,0.1053605,7.718685,3.912023,3.806662,0,0,1,2.296,4,0.584,MORE
21,104,100,4,204,104,100,4.644391,4.60517,0.03922071,9.249561,4.644391,4.60517,0,0,1,1.7966,4,0.7653,MORE
21,150,141,9,291,150,141,5.010635,4.94876,0.0618754,9.959395,5.010635,4.94876,0,0,1,1.8667,3,0.5661,MORE
21,126,150,24,276,150,126,4.836282,5.010635,0.1743534,9.846917,5.010635,4.836282,1,1,1,1.5239,4,0.6662,MORE
21,98,100,2,198,98,100,4.584967,4.60517,0.02020271,9.190138,4.584967,4.60517,0,1,0,1.6151,3,0.5426,MORE
21,48,50,2,98,50,48,3.871201,3.912023,0.04082199,7.783224,3.912023,3.871201,1,1,1,1.5996,4,0.5666,MORE
21,147,150,3,297,147,150,4.990433,5.010635,0.02020271,10.00107,4.990433,5.010635,0,1,0,1.6293,3,0.55,MORE
21,50,55,5,105,55,50,3.912023,4.007333,0.09531018,7.919356,4.007333,3.912023,1,1,1,1.6369,4,0.5735,MORE
21,86,100,14,186,100,86,4.454347,4.60517,0.1508229,9.059517,4.60517,4.454347,1,1,1,1.581,2,0.6806,MORE
21,150,159,9,309,159,150,5.010635,5.068904,0.05826891,10.07954,5.068904,5.010635,1,1,1,1.6722,4,0.5811,MORE
21,150,162,12,312,150,162,5.010635,5.087596,0.07696104,10.09823,5.010635,5.087596,0,1,0,1.7947,3,0.6737,MORE
21,116,100,16,216,116,100,4.75359,4.60517,0.14842,9.35876,4.75359,4.60517,0,0,1,1.7428,2,0.7144,MORE
21,40,50,10,90,50,40,3.688879,3.912023,0.2231436,7.600902,3.912023,3.688879,1,1,1,1.5427,4,0.6334,MORE
21,114,100,14,214,114,100,4.736198,4.60517,0.1310283,9.341369,4.736198,4.60517,0,0,1,2.3129,4,0.5827,MORE
21,51,50,1,101,51,50,3.931826,3.912023,0.01980263,7.843849,3.931826,3.912023,0,0,1,2.8747,2,1.0526,MORE
21,55,50,5,105,55,50,4.007333,3.912023,0.09531018,7.919356,4.007333,3.912023,0,0,1,1.5578,1,0.7031,MORE
21,86,100,14,186,86,100,4.454347,4.60517,0.1508229,9.059517,4.454347,4.60517,0,1,0,1.8766,4,1.122,MORE
21,120,150,30,270,150,120,4.787492,5.010635,0.2231436,9.798127,5.010635,4.787492,1,1,1,1.5517,4,0.8864,MORE
21,150,132,18,282,150,132,5.010635,4.882802,0.1278334,9.893437,5.010635,4.882802,0,0,1,1.4988,4,0.5664,MORE
21,40,50,10,90,50,40,3.688879,3.912023,0.2231436,7.600902,3.912023,3.688879,1,1,1,1.2582,4,1.0327,MORE
21,84,100,16,184,100,84,4.430817,4.60517,0.1743534,9.035987,4.60517,4.430817,1,1,1,1.4184,3,0.7837,MORE
21,150,135,15,285,135,150,5.010635,4.905275,0.1053605,9.91591,4.905275,5.010635,1,0,0,1.3587,2,0.7672,MORE
21,110,100,10,210,100,110,4.70048,4.60517,0.09531018,9.305651,4.60517,4.70048,1,0,0,1.2853,4,0.5978,MORE
21,47,50,3,97,50,47,3.850148,3.912023,0.0618754,7.762171,3.912023,3.850148,1,1,1,1.1391,3,1.5497,MORE
21,150,123,27,273,150,123,5.010635,4.812184,0.1984509,9.82282,5.010635,4.812184,0,0,1,1.9546,2,0.7064,MORE
21,100,90,10,190,100,90,4.60517,4.49981,0.1053605,9.10498,4.60517,4.49981,0,0,1,2.4816,3,0.6858,MORE
21,100,84,16,184,100,84,4.60517,4.430817,0.1743534,9.035987,4.60517,4.430817,0,0,1,1.5061,3,0.6229,MORE
21,112,100,12,212,112,100,4.718499,4.60517,0.1133287,9.323669,4.718499,4.60517,0,0,1,1.6289,1,0.6846,MORE
21,52,50,2,102,50,52,3.951244,3.912023,0.03922071,7.863267,3.912023,3.951244,1,0,0,1.5694,4,0.7332,MORE
21,50,48,2,98,48,50,3.912023,3.871201,0.04082199,7.783224,3.871201,3.912023,1,0,0,1.4858,4,0.5882,MORE
21,120,100,20,220,120,100,4.787492,4.60517,0.1823216,9.392662,4.787492,4.60517,0,0,1,1.6152,3,0.5834,MORE
21,150,123,27,273,123,150,5.010635,4.812184,0.1984509,9.82282,4.812184,5.010635,1,0,0,1.7869,4,0.6415,MORE
21,162,150,12,312,162,150,5.087596,5.010635,0.07696104,10.09823,5.087596,5.010635,0,0,1,1.6253,4,0.5504,MORE
21,52,50,2,102,50,52,3.951244,3.912023,0.03922071,7.863267,3.912023,3.951244,1,0,0,1.4743,3,0.781,MORE
21,50,58,8,108,50,58,3.912023,4.060443,0.14842,7.972466,3.912023,4.060443,0,1,0,2.8789,4,0.7833,MORE
21,58,50,8,108,58,50,4.060443,3.912023,0.14842,7.972466,4.060443,3.912023,0,0,1,1.6617,4,0.7028,MORE
21,46,50,4,96,50,46,3.828641,3.912023,0.08338161,7.740664,3.912023,3.828641,1,1,1,3.1565,3,0.5332,MORE
21,100,90,10,190,90,100,4.60517,4.49981,0.1053605,9.10498,4.49981,4.60517,1,0,0,1.5604,3,0.3248,MORE
21,92,100,8,192,92,100,4.521789,4.60517,0.08338161,9.126959,4.521789,4.60517,0,1,0,1.7788,3,0.3002,MORE
21,94,100,6,194,94,100,4.543295,4.60517,0.0618754,9.148465,4.543295,4.60517,0,1,0,0.5979,3,4e-04,MORE
21,150,180,30,330,180,150,5.010635,5.192957,0.1823216,10.20359,5.192957,5.010635,1,1,1,1.2684,3,0.0211,MORE
21,150,126,24,276,150,126,5.010635,4.836282,0.1743534,9.846917,5.010635,4.836282,0,0,1,0.817,3,0.0044,MORE
21,100,82,18,182,82,100,4.60517,4.406719,0.1984509,9.011889,4.406719,4.60517,1,0,0,1.1087,3,0.021,MORE
21,126,150,24,276,150,126,4.836282,5.010635,0.1743534,9.846917,5.010635,4.836282,1,1,1,0.7536,3,0.0072,MORE
21,150,156,6,306,150,156,5.010635,5.049856,0.03922071,10.06049,5.010635,5.049856,0,1,0,0.6329,3,0.0178,MORE
21,180,150,30,330,180,150,5.192957,5.010635,0.1823216,10.20359,5.192957,5.010635,0,0,1,0.4967,3,4e-04,MORE
21,50,46,4,96,46,50,3.912023,3.828641,0.08338161,7.740664,3.828641,3.912023,1,0,0,1.1332,3,0.027,MORE
21,100,84,16,184,100,84,4.60517,4.430817,0.1743534,9.035987,4.60517,4.430817,0,0,1,0.7243,3,0.0149,MORE
21,47,50,3,97,47,50,3.850148,3.912023,0.0618754,7.762171,3.850148,3.912023,0,1,0,0.9772,3,7e-04,MORE
21,50,43,7,93,43,50,3.912023,3.7612,0.1508229,7.673223,3.7612,3.912023,1,0,0,1.1974,3,0.0088,MORE
21,56,50,6,106,56,50,4.025352,3.912023,0.1133287,7.937375,4.025352,3.912023,0,0,1,0.5858,3,0.0178,MORE
22,129,150,21,279,150,129,4.859812,5.010635,0.1508229,9.870448,5.010635,4.859812,1,1,1,1.2908,3,3.1106,MORE
22,50,53,3,103,53,50,3.912023,3.970292,0.05826891,7.882315,3.970292,3.912023,1,1,1,1.4283,3,0.7342,MORE
22,100,106,6,206,106,100,4.60517,4.663439,0.05826891,9.268609,4.663439,4.60517,1,1,1,0.9725,3,0.7542,MORE
22,46,50,4,96,50,46,3.828641,3.912023,0.08338161,7.740664,3.912023,3.828641,1,1,1,1.5255,3,0.5012,MORE
22,50,47,3,97,50,47,3.912023,3.850148,0.0618754,7.762171,3.912023,3.850148,0,0,1,1.3004,2,0.6841,MORE
22,51,50,1,101,50,51,3.931826,3.912023,0.01980263,7.843849,3.912023,3.931826,1,0,0,0.841,2,1.2527,MORE
22,120,100,20,220,100,120,4.787492,4.60517,0.1823216,9.392662,4.60517,4.787492,1,0,0,0.8844,3,0.8736,MORE
22,102,100,2,202,100,102,4.624973,4.60517,0.01980263,9.230143,4.60517,4.624973,1,0,0,1.1481,3,0.637,MORE
22,50,42,8,92,50,42,3.912023,3.73767,0.1743534,7.649693,3.912023,3.73767,0,0,1,1.2611,2,0.5177,MORE
22,44,50,6,94,50,44,3.78419,3.912023,0.1278334,7.696213,3.912023,3.78419,1,1,1,0.8863,3,0.6471,MORE
22,100,114,14,214,114,100,4.60517,4.736198,0.1310283,9.341369,4.736198,4.60517,1,1,1,0.8036,3,0.6523,MORE
22,100,80,20,180,100,80,4.60517,4.382027,0.2231436,8.987197,4.60517,4.382027,0,0,1,1.0964,2,0.6092,MORE
22,50,54,4,104,50,54,3.912023,3.988984,0.07696104,7.901007,3.912023,3.988984,0,1,0,1.4317,2,0.4842,MORE
22,92,100,8,192,100,92,4.521789,4.60517,0.08338161,9.126959,4.60517,4.521789,1,1,1,0.8769,3,0.5084,MORE
22,100,98,2,198,100,98,4.60517,4.584967,0.02020271,9.190138,4.60517,4.584967,0,0,1,1.4063,3,0.4501,MORE
22,100,102,2,202,102,100,4.60517,4.624973,0.01980263,9.230143,4.624973,4.60517,1,1,1,1.0077,3,0.7511,MORE
22,100,120,20,220,120,100,4.60517,4.787492,0.1823216,9.392662,4.787492,4.60517,1,1,1,1.2081,2,0.6507,MORE
22,100,96,4,196,96,100,4.60517,4.564348,0.04082199,9.169518,4.564348,4.60517,1,0,0,1.3674,3,0.4506,MORE
22,92,100,8,192,100,92,4.521789,4.60517,0.08338161,9.126959,4.60517,4.521789,1,1,1,0.9895,3,0.5755,MORE
22,150,177,27,327,177,150,5.010635,5.17615,0.1655144,10.18679,5.17615,5.010635,1,1,1,1.1444,3,0.7931,MORE
22,144,150,6,294,150,144,4.969813,5.010635,0.04082199,9.980449,5.010635,4.969813,1,1,1,1.8217,3,0.5002,MORE
22,123,150,27,273,150,123,4.812184,5.010635,0.1984509,9.82282,5.010635,4.812184,1,1,1,1.0702,2,0.5121,MORE
22,100,112,12,212,112,100,4.60517,4.718499,0.1133287,9.323669,4.718499,4.60517,1,1,1,1.2487,3,0.5263,MORE
22,126,150,24,276,150,126,4.836282,5.010635,0.1743534,9.846917,5.010635,4.836282,1,1,1,1.1483,3,0.8002,MORE
22,150,159,9,309,159,150,5.010635,5.068904,0.05826891,10.07954,5.068904,5.010635,1,1,1,1.149,3,0.4479,MORE
22,100,88,12,188,100,88,4.60517,4.477337,0.1278334,9.082507,4.60517,4.477337,0,0,1,1.2049,2,0.5691,MORE
22,153,150,3,303,153,150,5.030438,5.010635,0.01980263,10.04107,5.030438,5.010635,0,0,1,1.1373,3,0.6749,MORE
22,100,90,10,190,100,90,4.60517,4.49981,0.1053605,9.10498,4.60517,4.49981,0,0,1,1.3086,2,0.5355,MORE
22,55,50,5,105,55,50,4.007333,3.912023,0.09531018,7.919356,4.007333,3.912023,0,0,1,1.4135,3,0.5339,MORE
22,50,46,4,96,46,50,3.912023,3.828641,0.08338161,7.740664,3.828641,3.912023,1,0,0,1.3214,3,0.3813,MORE
22,58,50,8,108,50,58,4.060443,3.912023,0.14842,7.972466,3.912023,4.060443,1,0,0,1.2641,3,0.3752,MORE
22,50,59,9,109,59,50,3.912023,4.077537,0.1655144,7.98956,4.077537,3.912023,1,1,1,0.9183,3,0.4922,MORE
22,90,100,10,190,100,90,4.49981,4.60517,0.1053605,9.10498,4.60517,4.49981,1,1,1,1.354,3,1.0083,MORE
22,48,50,2,98,50,48,3.871201,3.912023,0.04082199,7.783224,3.912023,3.871201,1,1,1,1.4829,4,1.1769,MORE
22,150,162,12,312,162,150,5.010635,5.087596,0.07696104,10.09823,5.087596,5.010635,1,1,1,1.3914,3,0.7318,MORE
22,116,100,16,216,100,116,4.75359,4.60517,0.14842,9.35876,4.60517,4.75359,1,0,0,1.8814,1,0.5813,MORE
22,96,100,4,196,96,100,4.564348,4.60517,0.04082199,9.169518,4.564348,4.60517,0,1,0,1.2663,2,0.6315,MORE
22,174,150,24,324,174,150,5.159055,5.010635,0.14842,10.16969,5.159055,5.010635,0,0,1,1.0341,3,0.8732,MORE
22,100,82,18,182,100,82,4.60517,4.406719,0.1984509,9.011889,4.60517,4.406719,0,0,1,1.2596,2,0.4833,MORE
22,53,50,3,103,50,53,3.970292,3.912023,0.05826891,7.882315,3.912023,3.970292,1,0,0,1.1805,4,0.3751,MORE
22,54,50,4,104,50,54,3.988984,3.912023,0.07696104,7.901007,3.912023,3.988984,1,0,0,1.8182,1,0.6492,MORE
22,50,47,3,97,50,47,3.912023,3.850148,0.0618754,7.762171,3.912023,3.850148,0,0,1,1.3574,1,0.7,MORE
22,45,50,5,95,50,45,3.806662,3.912023,0.1053605,7.718685,3.912023,3.806662,1,1,1,1.089,4,0.3094,MORE
22,150,165,15,315,165,150,5.010635,5.105945,0.09531018,10.11658,5.105945,5.010635,1,1,1,0.9938,2,0.4004,MORE
22,150,132,18,282,150,132,5.010635,4.882802,0.1278334,9.893437,5.010635,4.882802,0,0,1,1.334,2,0.667,MORE
22,82,100,18,182,100,82,4.406719,4.60517,0.1984509,9.011889,4.60517,4.406719,1,1,1,1.018,4,1.1265,MORE
22,56,50,6,106,50,56,4.025352,3.912023,0.1133287,7.937375,3.912023,4.025352,1,0,0,1.8052,3,0.3689,MORE
22,100,84,16,184,100,84,4.60517,4.430817,0.1743534,9.035987,4.60517,4.430817,0,0,1,1.0043,2,0.6871,MORE
22,50,57,7,107,57,50,3.912023,4.043051,0.1310283,7.955074,4.043051,3.912023,1,1,1,1.1452,3,0.9576,MORE
22,100,84,16,184,84,100,4.60517,4.430817,0.1743534,9.035987,4.430817,4.60517,1,0,0,1.0105,4,0.4024,MORE
22,46,50,4,96,50,46,3.828641,3.912023,0.08338161,7.740664,3.912023,3.828641,1,1,1,1.2093,3,0.7224,MORE
22,100,118,18,218,118,100,4.60517,4.770685,0.1655144,9.375855,4.770685,4.60517,1,1,1,1.0122,3,0.4852,MORE
22,50,59,9,109,59,50,3.912023,4.077537,0.1655144,7.98956,4.077537,3.912023,1,1,1,1.3627,3,0.7153,MORE
22,57,50,7,107,50,57,4.043051,3.912023,0.1310283,7.955074,3.912023,4.043051,1,0,0,2.7944,1,0.4538,MORE
22,108,100,8,208,108,100,4.682131,4.60517,0.07696104,9.287301,4.682131,4.60517,0,0,1,1.3011,2,0.5846,MORE
22,159,150,9,309,159,150,5.068904,5.010635,0.05826891,10.07954,5.068904,5.010635,0,0,1,1.45,2,0.4502,MORE
22,100,92,8,192,100,92,4.60517,4.521789,0.08338161,9.126959,4.60517,4.521789,0,0,1,1.7869,2,0.4015,MORE
22,100,88,12,188,100,88,4.60517,4.477337,0.1278334,9.082507,4.60517,4.477337,0,0,1,1.3776,4,0.7133,MORE
22,100,98,2,198,98,100,4.60517,4.584967,0.02020271,9.190138,4.584967,4.60517,1,0,0,1.2091,3,0.4195,MORE
22,159,150,9,309,150,159,5.068904,5.010635,0.05826891,10.07954,5.010635,5.068904,1,0,0,0.9821,3,0.5004,MORE
22,50,51,1,101,51,50,3.912023,3.931826,0.01980263,7.843849,3.931826,3.912023,1,1,1,1.3216,3,0.4355,MORE
22,56,50,6,106,56,50,4.025352,3.912023,0.1133287,7.937375,4.025352,3.912023,0,0,1,1.1005,3,0.7985,MORE
22,100,108,8,208,100,108,4.60517,4.682131,0.07696104,9.287301,4.60517,4.682131,0,1,0,1.6192,2,0.384,MORE
22,100,112,12,212,112,100,4.60517,4.718499,0.1133287,9.323669,4.718499,4.60517,1,1,1,0.8657,3,0.3649,MORE
22,100,118,18,218,118,100,4.60517,4.770685,0.1655144,9.375855,4.770685,4.60517,1,1,1,1.0406,4,0.3763,MORE
22,150,168,18,318,168,150,5.010635,5.123964,0.1133287,10.1346,5.123964,5.010635,1,1,1,1.088,3,0.6436,MORE
22,120,100,20,220,120,100,4.787492,4.60517,0.1823216,9.392662,4.787492,4.60517,0,0,1,1.0511,2,0.6503,MORE
22,80,100,20,180,100,80,4.382027,4.60517,0.2231436,8.987197,4.60517,4.382027,1,1,1,0.9622,4,0.4312,MORE
22,100,90,10,190,100,90,4.60517,4.49981,0.1053605,9.10498,4.60517,4.49981,0,0,1,1.2884,2,0.5059,MORE
22,84,100,16,184,100,84,4.430817,4.60517,0.1743534,9.035987,4.60517,4.430817,1,1,1,0.9527,4,0.5129,MORE
22,58,50,8,108,58,50,4.060443,3.912023,0.14842,7.972466,4.060443,3.912023,0,0,1,1.1031,1,0.4341,MORE
22,50,52,2,102,52,50,3.912023,3.951244,0.03922071,7.863267,3.951244,3.912023,1,1,1,0.8754,3,1.0683,MORE
22,114,100,14,214,114,100,4.736198,4.60517,0.1310283,9.341369,4.736198,4.60517,0,0,1,1.1383,3,0.8889,MORE
22,150,141,9,291,141,150,5.010635,4.94876,0.0618754,9.959395,4.94876,5.010635,1,0,0,1.1394,3,0.3847,MORE
22,88,100,12,188,100,88,4.477337,4.60517,0.1278334,9.082507,4.60517,4.477337,1,1,1,1.5093,2,0.4698,MORE
22,177,150,27,327,177,150,5.17615,5.010635,0.1655144,10.18679,5.17615,5.010635,0,0,1,1.1518,2,0.5924,MORE
22,150,120,30,270,150,120,5.010635,4.787492,0.2231436,9.798127,5.010635,4.787492,0,0,1,1.1041,1,1.4265,MORE
22,40,50,10,90,50,40,3.688879,3.912023,0.2231436,7.600902,3.912023,3.688879,1,1,1,1.2196,4,0.3347,MORE
22,49,50,1,99,49,50,3.89182,3.912023,0.02020271,7.803843,3.89182,3.912023,0,1,0,1.2816,2,0.4664,MORE
22,59,50,9,109,59,50,4.077537,3.912023,0.1655144,7.98956,4.077537,3.912023,0,0,1,0.9433,2,0.6334,MORE
22,43,50,7,93,50,43,3.7612,3.912023,0.1508229,7.673223,3.912023,3.7612,1,1,1,1.4625,2,0.505,MORE
22,112,100,12,212,100,112,4.718499,4.60517,0.1133287,9.323669,4.60517,4.718499,1,0,0,1.389,3,0.4592,MORE
22,165,150,15,315,165,150,5.105945,5.010635,0.09531018,10.11658,5.105945,5.010635,0,0,1,1.887,2,0.5393,MORE
22,100,86,14,186,86,100,4.60517,4.454347,0.1508229,9.059517,4.454347,4.60517,1,0,0,1.5235,3,0.448,MORE
22,100,116,16,216,116,100,4.60517,4.75359,0.14842,9.35876,4.75359,4.60517,1,1,1,0.9072,3,0.6539,MORE
22,150,156,6,306,156,150,5.010635,5.049856,0.03922071,10.06049,5.049856,5.010635,1,1,1,1.1725,2,0.538,MORE
22,100,104,4,204,100,104,4.60517,4.644391,0.03922071,9.249561,4.60517,4.644391,0,1,0,1.2646,2,0.3173,MORE
22,94,100,6,194,100,94,4.543295,4.60517,0.0618754,9.148465,4.60517,4.543295,1,1,1,1.0196,3,0.5426,MORE
22,114,100,14,214,114,100,4.736198,4.60517,0.1310283,9.341369,4.736198,4.60517,0,0,1,1.1336,2,0.4249,MORE
22,150,135,15,285,150,135,5.010635,4.905275,0.1053605,9.91591,5.010635,4.905275,0,0,1,1.133,2,0.3587,MORE
22,50,49,1,99,50,49,3.912023,3.89182,0.02020271,7.803843,3.912023,3.89182,0,0,1,1.5448,2,0.5315,MORE
22,50,54,4,104,54,50,3.912023,3.988984,0.07696104,7.901007,3.988984,3.912023,1,1,1,1.0393,4,0.7944,MORE
22,150,129,21,279,150,129,5.010635,4.859812,0.1508229,9.870448,5.010635,4.859812,0,0,1,1.6423,2,0.6761,MORE
22,150,147,3,297,147,150,5.010635,4.990433,0.02020271,10.00107,4.990433,5.010635,1,0,0,1.0247,3,0.7098,MORE
22,98,100,2,198,100,98,4.584967,4.60517,0.02020271,9.190138,4.60517,4.584967,1,1,1,1.222,4,0.4853,MORE
22,50,60,10,110,60,50,3.912023,4.094345,0.1823216,8.006368,4.094345,3.912023,1,1,1,1.4064,2,0.4858,MORE
22,98,100,2,198,100,98,4.584967,4.60517,0.02020271,9.190138,4.60517,4.584967,1,1,1,1.0899,3,0.5258,MORE
22,150,135,15,285,135,150,5.010635,4.905275,0.1053605,9.91591,4.905275,5.010635,1,0,0,1.9271,3,0.5726,MORE
22,132,150,18,282,150,132,4.882802,5.010635,0.1278334,9.893437,5.010635,4.882802,1,1,1,1.078,2,0.8188,MORE
22,90,100,10,190,90,100,4.49981,4.60517,0.1053605,9.10498,4.49981,4.60517,0,1,0,1.5542,2,0.4101,MORE
22,86,100,14,186,100,86,4.454347,4.60517,0.1508229,9.059517,4.60517,4.454347,1,1,1,1.0744,3,0.4437,MORE
22,171,150,21,321,171,150,5.141664,5.010635,0.1310283,10.1523,5.141664,5.010635,0,0,1,1.237,2,0.7032,MORE
22,94,100,6,194,100,94,4.543295,4.60517,0.0618754,9.148465,4.60517,4.543295,1,1,1,1.0516,3,0.3978,MORE
22,150,141,9,291,141,150,5.010635,4.94876,0.0618754,9.959395,4.94876,5.010635,1,0,0,1.0115,3,0.4179,MORE
22,150,129,21,279,150,129,5.010635,4.859812,0.1508229,9.870448,5.010635,4.859812,0,0,1,1.4982,2,0.4339,MORE
22,50,41,9,91,50,41,3.912023,3.713572,0.1984509,7.625595,3.912023,3.713572,0,0,1,1.3259,2,0.7031,MORE
22,150,138,12,288,150,138,5.010635,4.927254,0.08338161,9.937889,5.010635,4.927254,0,0,1,1.3076,3,0.6505,MORE
22,100,108,8,208,100,108,4.60517,4.682131,0.07696104,9.287301,4.60517,4.682131,0,1,0,1.0372,2,0.5072,MORE
22,42,50,8,92,50,42,3.73767,3.912023,0.1743534,7.649693,3.912023,3.73767,1,1,1,1.1004,3,0.3173,MORE
22,43,50,7,93,50,43,3.7612,3.912023,0.1508229,7.673223,3.912023,3.7612,1,1,1,1.7017,1,0.4573,MORE
22,108,100,8,208,108,100,4.682131,4.60517,0.07696104,9.287301,4.682131,4.60517,0,0,1,1.1713,2,0.4341,MORE
22,86,100,14,186,100,86,4.454347,4.60517,0.1508229,9.059517,4.60517,4.454347,1,1,1,1.2202,3,0.332,MORE
22,150,138,12,288,150,138,5.010635,4.927254,0.08338161,9.937889,5.010635,4.927254,0,0,1,1.1414,2,0.3552,MORE
22,118,100,18,218,118,100,4.770685,4.60517,0.1655144,9.375855,4.770685,4.60517,0,0,1,1.1692,3,0.567,MORE
22,100,92,8,192,100,92,4.60517,4.521789,0.08338161,9.126959,4.60517,4.521789,0,0,1,1.1682,3,0.4098,MORE
22,150,159,9,309,159,150,5.010635,5.068904,0.05826891,10.07954,5.068904,5.010635,1,1,1,1.1415,3,0.3847,MORE
22,150,174,24,324,174,150,5.010635,5.159055,0.14842,10.16969,5.159055,5.010635,1,1,1,0.9443,2,0.5296,MORE
22,129,150,21,279,150,129,4.859812,5.010635,0.1508229,9.870448,5.010635,4.859812,1,1,1,1.4371,3,0.2375,MORE
22,50,49,1,99,50,49,3.912023,3.89182,0.02020271,7.803843,3.912023,3.89182,0,0,1,1.0615,4,0.7123,MORE
22,118,100,18,218,118,100,4.770685,4.60517,0.1655144,9.375855,4.770685,4.60517,0,0,1,1.169,2,0.3345,MORE
22,50,51,1,101,50,51,3.912023,3.931826,0.01980263,7.843849,3.912023,3.931826,0,1,0,1.5703,3,0.4001,MORE
22,88,100,12,188,100,88,4.477337,4.60517,0.1278334,9.082507,4.60517,4.477337,1,1,1,1.1351,3,0.4386,MORE
22,52,50,2,102,50,52,3.951244,3.912023,0.03922071,7.863267,3.912023,3.951244,1,0,0,1.3313,3,0.3023,MORE
22,106,100,6,206,106,100,4.663439,4.60517,0.05826891,9.268609,4.663439,4.60517,0,0,1,1.0373,2,0.2503,MORE
22,144,150,6,294,150,144,4.969813,5.010635,0.04082199,9.980449,5.010635,4.969813,1,1,1,0.9559,3,0.251,MORE
22,150,153,3,303,153,150,5.010635,5.030438,0.01980263,10.04107,5.030438,5.010635,1,1,1,1.0026,2,0.4809,MORE
22,84,100,16,184,100,84,4.430817,4.60517,0.1743534,9.035987,4.60517,4.430817,1,1,1,0.9674,3,0.3352,MORE
22,50,44,6,94,50,44,3.912023,3.78419,0.1278334,7.696213,3.912023,3.78419,0,0,1,1.2192,2,0.3013,MORE
22,150,123,27,273,150,123,5.010635,4.812184,0.1984509,9.82282,5.010635,4.812184,0,0,1,1.7432,2,0.2663,MORE
22,126,150,24,276,150,126,4.836282,5.010635,0.1743534,9.846917,5.010635,4.836282,1,1,1,1.0562,3,0.2193,MORE
22,55,50,5,105,55,50,4.007333,3.912023,0.09531018,7.919356,4.007333,3.912023,0,0,1,1.0932,2,0.4849,MORE
22,47,50,3,97,50,47,3.850148,3.912023,0.0618754,7.762171,3.912023,3.850148,1,1,1,1.5986,3,0.2526,MORE
22,41,50,9,91,50,41,3.713572,3.912023,0.1984509,7.625595,3.912023,3.713572,1,1,1,0.9562,3,0.2837,MORE
22,106,100,6,206,100,106,4.663439,4.60517,0.05826891,9.268609,4.60517,4.663439,1,0,0,0.9162,3,0.1502,MORE
22,50,55,5,105,50,55,3.912023,4.007333,0.09531018,7.919356,3.912023,4.007333,0,1,0,1.0817,2,0.2631,MORE
22,120,150,30,270,150,120,4.787492,5.010635,0.2231436,9.798127,5.010635,4.787492,1,1,1,0.8488,3,0.3846,MORE
22,50,52,2,102,50,52,3.912023,3.951244,0.03922071,7.863267,3.912023,3.951244,0,1,0,0.9995,2,0.2742,MORE
22,100,114,14,214,114,100,4.60517,4.736198,0.1310283,9.341369,4.736198,4.60517,1,1,1,0.9871,4,0.8359,MORE
22,50,58,8,108,50,58,3.912023,4.060443,0.14842,7.972466,3.912023,4.060443,0,1,0,1.0192,2,0.2657,MORE
22,150,153,3,303,153,150,5.010635,5.030438,0.01980263,10.04107,5.030438,5.010635,1,1,1,1.3483,3,0.2156,MORE
22,112,100,12,212,112,100,4.718499,4.60517,0.1133287,9.323669,4.718499,4.60517,0,0,1,1.0191,2,0.6235,MORE
22,120,150,30,270,150,120,4.787492,5.010635,0.2231436,9.798127,5.010635,4.787492,1,1,1,0.8203,4,0.716,MORE
22,100,96,4,196,100,96,4.60517,4.564348,0.04082199,9.169518,4.60517,4.564348,0,0,1,1.0209,1,0.5971,MORE
22,162,150,12,312,162,150,5.087596,5.010635,0.07696104,10.09823,5.087596,5.010635,0,0,1,0.9952,2,0.4152,MORE
22,150,171,21,321,171,150,5.010635,5.141664,0.1310283,10.1523,5.141664,5.010635,1,1,1,0.9237,3,0.3258,MORE
22,48,50,2,98,48,50,3.871201,3.912023,0.04082199,7.783224,3.871201,3.912023,0,1,0,1.2445,3,0.5261,MORE
22,96,100,4,196,100,96,4.564348,4.60517,0.04082199,9.169518,4.60517,4.564348,1,1,1,1.068,4,0.6743,MORE
22,150,174,24,324,174,150,5.010635,5.159055,0.14842,10.16969,5.159055,5.010635,1,1,1,0.9489,4,0.3585,MORE
22,110,100,10,210,110,100,4.70048,4.60517,0.09531018,9.305651,4.70048,4.60517,0,0,1,1.358,2,0.3842,MORE
22,50,41,9,91,50,41,3.912023,3.713572,0.1984509,7.625595,3.912023,3.713572,0,0,1,1.0619,4,0.6848,MORE
22,156,150,6,306,156,150,5.049856,5.010635,0.03922071,10.06049,5.049856,5.010635,0,0,1,0.9517,4,0.569,MORE
22,156,150,6,306,156,150,5.049856,5.010635,0.03922071,10.06049,5.049856,5.010635,0,0,1,1.9859,2,0.5106,MORE
22,165,150,15,315,165,150,5.105945,5.010635,0.09531018,10.11658,5.105945,5.010635,0,0,1,1.0345,4,0.6212,MORE
22,135,150,15,285,150,135,4.905275,5.010635,0.1053605,9.91591,5.010635,4.905275,1,1,1,1.1457,4,0.354,MORE
22,150,147,3,297,150,147,5.010635,4.990433,0.02020271,10.00107,5.010635,4.990433,0,0,1,1.5907,3,0.4008,MORE
22,53,50,3,103,53,50,3.970292,3.912023,0.05826891,7.882315,3.970292,3.912023,0,0,1,1.075,2,0.5869,MORE
22,100,82,18,182,100,82,4.60517,4.406719,0.1984509,9.011889,4.60517,4.406719,0,0,1,0.9461,4,0.3671,MORE
22,100,102,2,202,100,102,4.60517,4.624973,0.01980263,9.230143,4.60517,4.624973,0,1,0,1.9154,1,0.4525,MORE
22,174,150,24,324,174,150,5.159055,5.010635,0.14842,10.16969,5.159055,5.010635,0,0,1,1.2434,3,0.6073,MORE
22,50,40,10,90,50,40,3.912023,3.688879,0.2231436,7.600902,3.912023,3.688879,0,0,1,1.2142,2,0.6664,MORE
22,150,132,18,282,150,132,5.010635,4.882802,0.1278334,9.893437,5.010635,4.882802,0,0,1,1.3959,4,0.5139,MORE
22,177,150,27,327,150,177,5.17615,5.010635,0.1655144,10.18679,5.010635,5.17615,1,0,0,1.605,2,0.7892,MORE
22,110,100,10,210,110,100,4.70048,4.60517,0.09531018,9.305651,4.70048,4.60517,0,0,1,1.0173,2,0.5843,MORE
22,100,86,14,186,86,100,4.60517,4.454347,0.1508229,9.059517,4.454347,4.60517,1,0,0,1.0862,3,0.3053,MORE
22,150,171,21,321,171,150,5.010635,5.141664,0.1310283,10.1523,5.141664,5.010635,1,1,1,0.7192,4,0.4923,MORE
22,104,100,4,204,100,104,4.644391,4.60517,0.03922071,9.249561,4.60517,4.644391,1,0,0,1.1026,4,0.2436,MORE
22,50,48,2,98,50,48,3.912023,3.871201,0.04082199,7.783224,3.912023,3.871201,0,0,1,1.1623,1,0.4253,MORE
22,50,57,7,107,57,50,3.912023,4.043051,0.1310283,7.955074,4.043051,3.912023,1,1,1,1.0646,3,0.4888,MORE
22,50,42,8,92,50,42,3.912023,3.73767,0.1743534,7.649693,3.912023,3.73767,0,0,1,0.9847,2,0.421,MORE
22,50,40,10,90,50,40,3.912023,3.688879,0.2231436,7.600902,3.912023,3.688879,0,0,1,0.9799,3,0.4043,MORE
22,100,116,16,216,116,100,4.60517,4.75359,0.14842,9.35876,4.75359,4.60517,1,1,1,0.8698,3,0.5003,MORE
22,50,53,3,103,50,53,3.912023,3.970292,0.05826891,7.882315,3.912023,3.970292,0,1,0,1.1704,1,0.4502,MORE
22,47,50,3,97,47,50,3.850148,3.912023,0.0618754,7.762171,3.850148,3.912023,0,1,0,1.1676,3,0.723,MORE
22,180,150,30,330,180,150,5.192957,5.010635,0.1823216,10.20359,5.192957,5.010635,0,0,1,1.1162,4,0.4713,MORE
22,150,126,24,276,150,126,5.010635,4.836282,0.1743534,9.846917,5.010635,4.836282,0,0,1,1.0748,3,0.9958,MORE
22,100,106,6,206,106,100,4.60517,4.663439,0.05826891,9.268609,4.663439,4.60517,1,1,1,0.9464,4,0.5574,MORE
22,150,123,27,273,123,150,5.010635,4.812184,0.1984509,9.82282,4.812184,5.010635,1,0,0,1.8301,3,0.4202,MORE
22,54,50,4,104,54,50,3.988984,3.912023,0.07696104,7.901007,3.988984,3.912023,0,0,1,1.0513,2,0.6006,MORE
22,50,56,6,106,56,50,3.912023,4.025352,0.1133287,7.937375,4.025352,3.912023,1,1,1,1.2967,3,0.3701,MORE
22,100,80,20,180,100,80,4.60517,4.382027,0.2231436,8.987197,4.60517,4.382027,0,0,1,0.9019,2,0.4999,MORE
22,150,120,30,270,150,120,5.010635,4.787492,0.2231436,9.798127,5.010635,4.787492,0,0,1,1.0812,3,0.3699,MORE
22,50,43,7,93,50,43,3.912023,3.7612,0.1508229,7.673223,3.912023,3.7612,0,0,1,1.1652,2,0.5884,MORE
22,150,156,6,306,156,150,5.010635,5.049856,0.03922071,10.06049,5.049856,5.010635,1,1,1,1.0658,3,0.6322,MORE
22,171,150,21,321,171,150,5.141664,5.010635,0.1310283,10.1523,5.141664,5.010635,0,0,1,1.4201,2,0.3656,MORE
22,50,60,10,110,60,50,3.912023,4.094345,0.1823216,8.006368,4.094345,3.912023,1,1,1,0.7665,3,0.7659,MORE
22,40,50,10,90,50,40,3.688879,3.912023,0.2231436,7.600902,3.912023,3.688879,1,1,1,0.9822,3,0.3773,MORE
22,100,94,6,194,100,94,4.60517,4.543295,0.0618754,9.148465,4.60517,4.543295,0,0,1,1.2115,2,0.3164,MORE
22,162,150,12,312,162,150,5.087596,5.010635,0.07696104,10.09823,5.087596,5.010635,0,0,1,1.3244,2,0.3824,MORE
22,49,50,1,99,50,49,3.89182,3.912023,0.02020271,7.803843,3.912023,3.89182,1,1,1,1.0877,3,0.237,MORE
22,150,168,18,318,168,150,5.010635,5.123964,0.1133287,10.1346,5.123964,5.010635,1,1,1,0.7398,2,0.484,MORE
22,50,44,6,94,50,44,3.912023,3.78419,0.1278334,7.696213,3.912023,3.78419,0,0,1,1.1101,2,0.3814,MORE
22,100,110,10,210,110,100,4.60517,4.70048,0.09531018,9.305651,4.70048,4.60517,1,1,1,0.8375,3,0.3339,MORE
22,57,50,7,107,57,50,4.043051,3.912023,0.1310283,7.955074,4.043051,3.912023,0,0,1,1.0053,4,0.6796,MORE
22,138,150,12,288,150,138,4.927254,5.010635,0.08338161,9.937889,5.010635,4.927254,1,1,1,0.7171,1,0.7649,MORE
22,135,150,15,285,150,135,4.905275,5.010635,0.1053605,9.91591,5.010635,4.905275,1,1,1,1.2369,3,0.4826,MORE
22,82,100,18,182,100,82,4.406719,4.60517,0.1984509,9.011889,4.60517,4.406719,1,1,1,0.9882,2,0.4493,MORE
22,100,94,6,194,100,94,4.60517,4.543295,0.0618754,9.148465,4.60517,4.543295,0,0,1,1.1939,3,0.268,MORE
22,150,144,6,294,144,150,5.010635,4.969813,0.04082199,9.980449,4.969813,5.010635,1,0,0,0.9897,3,0.4341,MORE
22,59,50,9,109,59,50,4.077537,3.912023,0.1655144,7.98956,4.077537,3.912023,0,0,1,0.9148,2,0.4564,MORE
22,147,150,3,297,150,147,4.990433,5.010635,0.02020271,10.00107,5.010635,4.990433,1,1,1,0.8395,4,0.7855,MORE
22,150,126,24,276,150,126,5.010635,4.836282,0.1743534,9.846917,5.010635,4.836282,0,0,1,1.1211,3,0.4018,MORE
22,41,50,9,91,50,41,3.713572,3.912023,0.1984509,7.625595,3.912023,3.713572,1,1,1,0.8958,4,0.3667,MORE
22,50,43,7,93,43,50,3.912023,3.7612,0.1508229,7.673223,3.7612,3.912023,1,0,0,1.3732,2,0.5252,MORE
22,116,100,16,216,116,100,4.75359,4.60517,0.14842,9.35876,4.75359,4.60517,0,0,1,0.9864,4,0.4057,MORE
22,50,58,8,108,58,50,3.912023,4.060443,0.14842,7.972466,4.060443,3.912023,1,1,1,1.0887,2,0.393,MORE
22,102,100,2,202,100,102,4.624973,4.60517,0.01980263,9.230143,4.60517,4.624973,1,0,0,0.9422,1,0.7665,MORE
22,132,150,18,282,150,132,4.882802,5.010635,0.1278334,9.893437,5.010635,4.882802,1,1,1,0.6988,4,0.3556,MORE
22,147,150,3,297,150,147,4.990433,5.010635,0.02020271,10.00107,5.010635,4.990433,1,1,1,1.0047,2,0.3531,MORE
22,141,150,9,291,150,141,4.94876,5.010635,0.0618754,9.959395,5.010635,4.94876,1,1,1,0.9049,3,0.4317,MORE
22,100,110,10,210,110,100,4.60517,4.70048,0.09531018,9.305651,4.70048,4.60517,1,1,1,1.0839,3,0.6502,MORE
22,80,100,20,180,100,80,4.382027,4.60517,0.2231436,8.987197,4.60517,4.382027,1,1,1,0.8387,2,0.821,MORE
22,50,48,2,98,48,50,3.912023,3.871201,0.04082199,7.783224,3.871201,3.912023,1,0,0,1.3838,2,0.372,MORE
22,141,150,9,291,150,141,4.94876,5.010635,0.0618754,9.959395,5.010635,4.94876,1,1,1,2.2567,2,0.624,MORE
22,50,55,5,105,50,55,3.912023,4.007333,0.09531018,7.919356,3.912023,4.007333,0,1,0,0.9316,4,0.6067,MORE
22,150,177,27,327,177,150,5.010635,5.17615,0.1655144,10.18679,5.17615,5.010635,1,1,1,0.9497,4,0.2376,MORE
22,42,50,8,92,42,50,3.73767,3.912023,0.1743534,7.649693,3.73767,3.912023,0,1,0,1.1771,2,0.4003,MORE
22,150,162,12,312,162,150,5.010635,5.087596,0.07696104,10.09823,5.087596,5.010635,1,1,1,0.9745,2,0.337,MORE
22,100,120,20,220,120,100,4.60517,4.787492,0.1823216,9.392662,4.787492,4.60517,1,1,1,0.9502,4,0.3825,MORE
22,150,180,30,330,180,150,5.010635,5.192957,0.1823216,10.20359,5.192957,5.010635,1,1,1,0.6184,4,0.2986,MORE
22,153,150,3,303,153,150,5.030438,5.010635,0.01980263,10.04107,5.030438,5.010635,0,0,1,1.2638,2,0.2668,MORE
22,100,104,4,204,100,104,4.60517,4.644391,0.03922071,9.249561,4.60517,4.644391,0,1,0,1.3223,1,0.4687,MORE
22,168,150,18,318,150,168,5.123964,5.010635,0.1133287,10.1346,5.010635,5.123964,1,0,0,1.7801,1,0.4364,MORE
22,150,144,6,294,144,150,5.010635,4.969813,0.04082199,9.980449,4.969813,5.010635,1,0,0,0.8217,2,0.4295,MORE
22,168,150,18,318,168,150,5.123964,5.010635,0.1133287,10.1346,5.123964,5.010635,0,0,1,1.233,2,0.592,MORE
22,138,150,12,288,150,138,4.927254,5.010635,0.08338161,9.937889,5.010635,4.927254,1,1,1,0.9564,3,0.4397,MORE
22,180,150,30,330,180,150,5.192957,5.010635,0.1823216,10.20359,5.192957,5.010635,0,0,1,1.2352,2,0.4186,MORE
22,50,56,6,106,56,50,3.912023,4.025352,0.1133287,7.937375,4.025352,3.912023,1,1,1,0.9442,3,0.6099,MORE
22,50,46,4,96,50,46,3.912023,3.828641,0.08338161,7.740664,3.912023,3.828641,0,0,1,1.1195,2,0.4687,MORE
22,123,150,27,273,150,123,4.812184,5.010635,0.1984509,9.82282,5.010635,4.812184,1,1,1,0.7012,4,0.6239,MORE
22,50,45,5,95,50,45,3.912023,3.806662,0.1053605,7.718685,3.912023,3.806662,0,0,1,1.3958,2,0.2702,MORE
22,60,50,10,110,60,50,4.094345,3.912023,0.1823216,8.006368,4.094345,3.912023,0,0,1,1.2175,2,0.5021,MORE
22,150,165,15,315,165,150,5.010635,5.105945,0.09531018,10.11658,5.105945,5.010635,1,1,1,1.0397,3,0.3982,MORE
22,52,50,2,102,52,50,3.951244,3.912023,0.03922071,7.863267,3.951244,3.912023,0,0,1,1.0814,2,0.2648,MORE
22,50,45,5,95,45,50,3.912023,3.806662,0.1053605,7.718685,3.806662,3.912023,1,0,0,1.4345,2,0.4496,MORE
22,44,50,6,94,50,44,3.78419,3.912023,0.1278334,7.696213,3.912023,3.78419,1,1,1,0.6497,4,0.6155,MORE
22,60,50,10,110,60,50,4.094345,3.912023,0.1823216,8.006368,4.094345,3.912023,0,0,1,0.9537,2,0.2197,MORE
22,104,100,4,204,100,104,4.644391,4.60517,0.03922071,9.249561,4.60517,4.644391,1,0,0,0.9065,4,0.4656,MORE
22,51,50,1,101,51,50,3.931826,3.912023,0.01980263,7.843849,3.931826,3.912023,0,0,1,1.0629,4,0.3247,MORE
22,150,180,30,330,180,150,5.010635,5.192957,0.1823216,10.20359,5.192957,5.010635,1,1,1,0.7462,4,0.4883,MORE
22,45,50,5,95,45,50,3.806662,3.912023,0.1053605,7.718685,3.806662,3.912023,0,1,0,0.9912,2,0.2349,MORE
23,50,45,5,95,50,45,3.912023,3.806662,0.1053605,7.718685,3.912023,3.806662,0,0,1,1.38,2,0.7162,MORE
23,58,50,8,108,50,58,4.060443,3.912023,0.14842,7.972466,3.912023,4.060443,1,0,0,0.9676,3,1.5498,MORE
23,165,150,15,315,165,150,5.105945,5.010635,0.09531018,10.11658,5.105945,5.010635,0,0,1,1.1186,4,2.0074,MORE
23,150,135,15,285,135,150,5.010635,4.905275,0.1053605,9.91591,4.905275,5.010635,1,0,0,1.0209,3,1.457,MORE
23,51,50,1,101,51,50,3.931826,3.912023,0.01980263,7.843849,3.931826,3.912023,0,0,1,1.3854,1,1.4499,MORE
23,104,100,4,204,100,104,4.644391,4.60517,0.03922071,9.249561,4.60517,4.644391,1,0,0,1.1301,2,0.7837,MORE
23,174,150,24,324,174,150,5.159055,5.010635,0.14842,10.16969,5.159055,5.010635,0,0,1,1.3026,3,1.7594,MORE
23,57,50,7,107,50,57,4.043051,3.912023,0.1310283,7.955074,3.912023,4.043051,1,0,0,1.567,2,1.9399,MORE
23,50,57,7,107,57,50,3.912023,4.043051,0.1310283,7.955074,4.043051,3.912023,1,1,1,1.3304,4,2.4267,MORE
23,56,50,6,106,56,50,4.025352,3.912023,0.1133287,7.937375,4.025352,3.912023,0,0,1,1.219,1,0.9987,MORE
23,150,159,9,309,159,150,5.010635,5.068904,0.05826891,10.07954,5.068904,5.010635,1,1,1,1.2786,2,0.8392,MORE
23,50,40,10,90,40,50,3.912023,3.688879,0.2231436,7.600902,3.688879,3.912023,1,0,0,1.2861,4,0.8179,MORE
23,153,150,3,303,153,150,5.030438,5.010635,0.01980263,10.04107,5.030438,5.010635,0,0,1,1.1627,3,0.7582,MORE
23,150,138,12,288,150,138,5.010635,4.927254,0.08338161,9.937889,5.010635,4.927254,0,0,1,1.3019,2,0.6408,MORE
23,150,123,27,273,150,123,5.010635,4.812184,0.1984509,9.82282,5.010635,4.812184,0,0,1,1.2359,3,1.1558,MORE
23,177,150,27,327,177,150,5.17615,5.010635,0.1655144,10.18679,5.17615,5.010635,0,0,1,1.3489,1,0.8673,MORE
23,150,126,24,276,150,126,5.010635,4.836282,0.1743534,9.846917,5.010635,4.836282,0,0,1,1.3771,2,0.5838,MORE
23,100,92,8,192,92,100,4.60517,4.521789,0.08338161,9.126959,4.521789,4.60517,1,0,0,1.2335,3,0.9399,MORE
23,100,94,6,194,100,94,4.60517,4.543295,0.0618754,9.148465,4.60517,4.543295,0,0,1,1.4993,2,0.8335,MORE
23,50,56,6,106,56,50,3.912023,4.025352,0.1133287,7.937375,4.025352,3.912023,1,1,1,1.5101,4,0.6093,MORE
23,129,150,21,279,150,129,4.859812,5.010635,0.1508229,9.870448,5.010635,4.859812,1,1,1,1.457,4,1.2515,MORE
23,100,80,20,180,100,80,4.60517,4.382027,0.2231436,8.987197,4.60517,4.382027,0,0,1,1.1155,3,0.6314,MORE
23,49,50,1,99,50,49,3.89182,3.912023,0.02020271,7.803843,3.912023,3.89182,1,1,1,1.2335,1,0.6215,MORE
23,88,100,12,188,100,88,4.477337,4.60517,0.1278334,9.082507,4.60517,4.477337,1,1,1,1.2822,2,0.6814,MORE
23,45,50,5,95,50,45,3.806662,3.912023,0.1053605,7.718685,3.912023,3.806662,1,1,1,1.1858,4,0.6011,MORE
23,123,150,27,273,150,123,4.812184,5.010635,0.1984509,9.82282,5.010635,4.812184,1,1,1,1.1584,3,1.0293,MORE
23,144,150,6,294,144,150,4.969813,5.010635,0.04082199,9.980449,4.969813,5.010635,0,1,0,1.0242,4,1.3237,MORE
23,55,50,5,105,50,55,4.007333,3.912023,0.09531018,7.919356,3.912023,4.007333,1,0,0,1.0337,3,1.2324,MORE
23,132,150,18,282,150,132,4.882802,5.010635,0.1278334,9.893437,5.010635,4.882802,1,1,1,1.1884,4,0.5836,MORE
23,171,150,21,321,171,150,5.141664,5.010635,0.1310283,10.1523,5.141664,5.010635,0,0,1,0.9653,2,0.646,MORE
23,126,150,24,276,150,126,4.836282,5.010635,0.1743534,9.846917,5.010635,4.836282,1,1,1,1.1888,1,1.4747,MORE
23,102,100,2,202,102,100,4.624973,4.60517,0.01980263,9.230143,4.624973,4.60517,0,0,1,1.1204,2,0.7171,MORE
23,48,50,2,98,48,50,3.871201,3.912023,0.04082199,7.783224,3.871201,3.912023,0,1,0,1.6865,1,0.5739,MORE
23,150,171,21,321,150,171,5.010635,5.141664,0.1310283,10.1523,5.010635,5.141664,0,1,0,1.1986,2,0.4655,MORE
23,100,112,12,212,100,112,4.60517,4.718499,0.1133287,9.323669,4.60517,4.718499,0,1,0,1.3432,2,0.4665,MORE
23,112,100,12,212,112,100,4.718499,4.60517,0.1133287,9.323669,4.718499,4.60517,0,0,1,1.0144,3,0.6997,MORE
23,53,50,3,103,53,50,3.970292,3.912023,0.05826891,7.882315,3.970292,3.912023,0,0,1,1.2331,4,0.4754,MORE
23,129,150,21,279,150,129,4.859812,5.010635,0.1508229,9.870448,5.010635,4.859812,1,1,1,1.3491,3,0.4489,MORE
23,80,100,20,180,100,80,4.382027,4.60517,0.2231436,8.987197,4.60517,4.382027,1,1,1,1.0483,4,0.5622,MORE
23,50,41,9,91,50,41,3.912023,3.713572,0.1984509,7.625595,3.912023,3.713572,0,0,1,1.2724,2,0.6181,MORE
23,50,44,6,94,50,44,3.912023,3.78419,0.1278334,7.696213,3.912023,3.78419,0,0,1,1.3382,2,0.8051,MORE
23,150,144,6,294,150,144,5.010635,4.969813,0.04082199,9.980449,5.010635,4.969813,0,0,1,1.02,4,0.5015,MORE
23,100,98,2,198,100,98,4.60517,4.584967,0.02020271,9.190138,4.60517,4.584967,0,0,1,1.3117,1,0.6252,MORE
23,150,123,27,273,150,123,5.010635,4.812184,0.1984509,9.82282,5.010635,4.812184,0,0,1,1.0282,4,0.4928,MORE
23,100,84,16,184,100,84,4.60517,4.430817,0.1743534,9.035987,4.60517,4.430817,0,0,1,1.6022,3,0.5674,MORE
23,150,174,24,324,150,174,5.010635,5.159055,0.14842,10.16969,5.010635,5.159055,0,1,0,1.3822,2,0.7492,MORE
23,43,50,7,93,50,43,3.7612,3.912023,0.1508229,7.673223,3.912023,3.7612,1,1,1,1.2186,4,0.4479,MORE
23,50,52,2,102,52,50,3.912023,3.951244,0.03922071,7.863267,3.951244,3.912023,1,1,1,1.2964,4,0.4847,MORE
23,53,50,3,103,50,53,3.970292,3.912023,0.05826891,7.882315,3.912023,3.970292,1,0,0,1.3268,3,0.506,MORE
23,171,150,21,321,171,150,5.141664,5.010635,0.1310283,10.1523,5.141664,5.010635,0,0,1,0.9036,4,0.4342,MORE
23,50,47,3,97,47,50,3.912023,3.850148,0.0618754,7.762171,3.850148,3.912023,1,0,0,1.3359,1,0.8854,MORE
23,100,90,10,190,100,90,4.60517,4.49981,0.1053605,9.10498,4.60517,4.49981,0,0,1,1.4296,2,0.7348,MORE
23,50,51,1,101,51,50,3.912023,3.931826,0.01980263,7.843849,3.931826,3.912023,1,1,1,1.0834,4,0.4039,MORE
23,100,110,10,210,100,110,4.60517,4.70048,0.09531018,9.305651,4.60517,4.70048,0,1,0,1.0281,3,0.4989,MORE
23,50,46,4,96,46,50,3.912023,3.828641,0.08338161,7.740664,3.828641,3.912023,1,0,0,1.2194,4,0.4875,MORE
23,100,98,2,198,98,100,4.60517,4.584967,0.02020271,9.190138,4.584967,4.60517,1,0,0,1.1145,4,0.3986,MORE
23,180,150,30,330,180,150,5.192957,5.010635,0.1823216,10.20359,5.192957,5.010635,0,0,1,0.9982,4,0.3721,MORE
23,150,132,18,282,150,132,5.010635,4.882802,0.1278334,9.893437,5.010635,4.882802,0,0,1,1.0189,4,0.4495,MORE
23,135,150,15,285,150,135,4.905275,5.010635,0.1053605,9.91591,5.010635,4.905275,1,1,1,1.204,3,0.365,MORE
23,150,180,30,330,180,150,5.010635,5.192957,0.1823216,10.20359,5.192957,5.010635,1,1,1,1.0169,4,0.3693,MORE
23,50,51,1,101,50,51,3.912023,3.931826,0.01980263,7.843849,3.912023,3.931826,0,1,0,1.1464,4,0.4409,MORE
23,138,150,12,288,150,138,4.927254,5.010635,0.08338161,9.937889,5.010635,4.927254,1,1,1,1.2626,1,0.3706,MORE
23,50,42,8,92,42,50,3.912023,3.73767,0.1743534,7.649693,3.73767,3.912023,1,0,0,1.2192,3,0.4826,MORE
23,41,50,9,91,50,41,3.713572,3.912023,0.1984509,7.625595,3.912023,3.713572,1,1,1,1.0675,3,0.4313,MORE
23,150,132,18,282,150,132,5.010635,4.882802,0.1278334,9.893437,5.010635,4.882802,0,0,1,1.055,4,0.3392,MORE
23,150,156,6,306,156,150,5.010635,5.049856,0.03922071,10.06049,5.049856,5.010635,1,1,1,1.1517,3,0.3883,MORE
23,150,177,27,327,177,150,5.010635,5.17615,0.1655144,10.18679,5.17615,5.010635,1,1,1,0.9767,4,0.3505,MORE
23,50,58,8,108,58,50,3.912023,4.060443,0.14842,7.972466,4.060443,3.912023,1,1,1,1.1339,3,0.3716,MORE
23,150,180,30,330,180,150,5.010635,5.192957,0.1823216,10.20359,5.192957,5.010635,1,1,1,1.2435,1,0.3042,MORE
23,48,50,2,98,50,48,3.871201,3.912023,0.04082199,7.783224,3.912023,3.871201,1,1,1,1.0504,3,0.3924,MORE
23,150,141,9,291,150,141,5.010635,4.94876,0.0618754,9.959395,5.010635,4.94876,0,0,1,0.9234,2,1.8651,MORE
23,135,150,15,285,150,135,4.905275,5.010635,0.1053605,9.91591,5.010635,4.905275,1,1,1,1.6026,3,0.8587,MORE
23,144,150,6,294,144,150,4.969813,5.010635,0.04082199,9.980449,4.969813,5.010635,0,1,0,1.0862,4,0.8187,MORE
23,54,50,4,104,50,54,3.988984,3.912023,0.07696104,7.901007,3.912023,3.988984,1,0,0,1.1336,4,0.3672,MORE
23,100,88,12,188,88,100,4.60517,4.477337,0.1278334,9.082507,4.477337,4.60517,1,0,0,1.3474,3,0.4494,MORE
23,156,150,6,306,150,156,5.049856,5.010635,0.03922071,10.06049,5.010635,5.049856,1,0,0,0.9939,3,0.4078,MORE
23,150,153,3,303,153,150,5.010635,5.030438,0.01980263,10.04107,5.030438,5.010635,1,1,1,1.1353,3,0.4156,MORE
23,100,94,6,194,100,94,4.60517,4.543295,0.0618754,9.148465,4.60517,4.543295,0,0,1,1.7977,2,0.8188,MORE
23,90,100,10,190,100,90,4.49981,4.60517,0.1053605,9.10498,4.60517,4.49981,1,1,1,1.1492,3,0.4098,MORE
23,100,96,4,196,96,100,4.60517,4.564348,0.04082199,9.169518,4.564348,4.60517,1,0,0,2.3967,4,1.4001,MORE
23,180,150,30,330,150,180,5.192957,5.010635,0.1823216,10.20359,5.010635,5.192957,1,0,0,1.3185,3,1.5836,MORE
23,168,150,18,318,168,150,5.123964,5.010635,0.1133287,10.1346,5.123964,5.010635,0,0,1,1.5199,4,0.5982,MORE
23,150,120,30,270,150,120,5.010635,4.787492,0.2231436,9.798127,5.010635,4.787492,0,0,1,1.0534,4,0.5514,MORE
23,100,82,18,182,82,100,4.60517,4.406719,0.1984509,9.011889,4.406719,4.60517,1,0,0,1.2835,3,0.5081,MORE
23,100,120,20,220,120,100,4.60517,4.787492,0.1823216,9.392662,4.787492,4.60517,1,1,1,1.0321,3,0.4497,MORE
23,50,49,1,99,50,49,3.912023,3.89182,0.02020271,7.803843,3.912023,3.89182,0,0,1,1.0257,2,0.7431,MORE
23,50,54,4,104,54,50,3.912023,3.988984,0.07696104,7.901007,3.988984,3.912023,1,1,1,1.7048,3,0.5398,MORE
23,98,100,2,198,98,100,4.584967,4.60517,0.02020271,9.190138,4.584967,4.60517,0,1,0,1.1066,3,0.4816,MORE
23,98,100,2,198,100,98,4.584967,4.60517,0.02020271,9.190138,4.60517,4.584967,1,1,1,1.1348,4,0.4478,MORE
23,147,150,3,297,150,147,4.990433,5.010635,0.02020271,10.00107,5.010635,4.990433,1,1,1,1.0275,3,0.3416,MORE
23,100,116,16,216,116,100,4.60517,4.75359,0.14842,9.35876,4.75359,4.60517,1,1,1,1.1276,3,0.3843,MORE
23,100,104,4,204,100,104,4.60517,4.644391,0.03922071,9.249561,4.60517,4.644391,0,1,0,1.155,2,0.5666,MORE
23,123,150,27,273,150,123,4.812184,5.010635,0.1984509,9.82282,5.010635,4.812184,1,1,1,1.441,1,0.39,MORE
23,58,50,8,108,58,50,4.060443,3.912023,0.14842,7.972466,4.060443,3.912023,0,0,1,1.2383,2,0.842,MORE
23,100,80,20,180,100,80,4.60517,4.382027,0.2231436,8.987197,4.60517,4.382027,0,0,1,1.1144,1,0.4152,MORE
23,159,150,9,309,159,150,5.068904,5.010635,0.05826891,10.07954,5.068904,5.010635,0,0,1,1.0583,3,0.6489,MORE
23,55,50,5,105,50,55,4.007333,3.912023,0.09531018,7.919356,3.912023,4.007333,1,0,0,1.2742,4,0.6154,MORE
23,108,100,8,208,108,100,4.682131,4.60517,0.07696104,9.287301,4.682131,4.60517,0,0,1,1.1028,3,0.3826,MORE
23,100,106,6,206,106,100,4.60517,4.663439,0.05826891,9.268609,4.663439,4.60517,1,1,1,0.9984,3,0.4197,MORE
23,44,50,6,94,50,44,3.78419,3.912023,0.1278334,7.696213,3.912023,3.78419,1,1,1,1.0793,4,0.4339,MORE
23,45,50,5,95,50,45,3.806662,3.912023,0.1053605,7.718685,3.912023,3.806662,1,1,1,1.0564,4,0.4089,MORE
23,177,150,27,327,177,150,5.17615,5.010635,0.1655144,10.18679,5.17615,5.010635,0,0,1,1.1228,2,0.5177,MORE
23,56,50,6,106,50,56,4.025352,3.912023,0.1133287,7.937375,3.912023,4.025352,1,0,0,0.9332,3,0.4498,MORE
23,116,100,16,216,116,100,4.75359,4.60517,0.14842,9.35876,4.75359,4.60517,0,0,1,1.0914,3,0.7662,MORE
23,54,50,4,104,50,54,3.988984,3.912023,0.07696104,7.901007,3.912023,3.988984,1,0,0,1.3996,3,0.4825,MORE
23,100,116,16,216,116,100,4.60517,4.75359,0.14842,9.35876,4.75359,4.60517,1,1,1,1.0119,3,0.4754,MORE
23,94,100,6,194,100,94,4.543295,4.60517,0.0618754,9.148465,4.60517,4.543295,1,1,1,1.4237,3,0.6056,MORE
23,82,100,18,182,100,82,4.406719,4.60517,0.1984509,9.011889,4.60517,4.406719,1,1,1,0.9138,4,0.4073,MORE
23,100,104,4,204,104,100,4.60517,4.644391,0.03922071,9.249561,4.644391,4.60517,1,1,1,1.1445,2,0.7589,MORE
23,100,114,14,214,114,100,4.60517,4.736198,0.1310283,9.341369,4.736198,4.60517,1,1,1,1.0934,1,1.2099,MORE
23,47,50,3,97,47,50,3.850148,3.912023,0.0618754,7.762171,3.850148,3.912023,0,1,0,1.133,4,0.842,MORE
23,100,92,8,192,92,100,4.60517,4.521789,0.08338161,9.126959,4.521789,4.60517,1,0,0,1.1097,3,0.4473,MORE
23,50,46,4,96,50,46,3.912023,3.828641,0.08338161,7.740664,3.912023,3.828641,0,0,1,1.3744,2,0.6681,MORE
23,116,100,16,216,116,100,4.75359,4.60517,0.14842,9.35876,4.75359,4.60517,0,0,1,1.145,3,0.6832,MORE
23,100,102,2,202,102,100,4.60517,4.624973,0.01980263,9.230143,4.624973,4.60517,1,1,1,1.0323,3,0.6042,MORE
23,100,90,10,190,90,100,4.60517,4.49981,0.1053605,9.10498,4.49981,4.60517,1,0,0,0.9651,4,0.4343,MORE
23,150,159,9,309,159,150,5.010635,5.068904,0.05826891,10.07954,5.068904,5.010635,1,1,1,1.6173,2,0.8695,MORE
23,104,100,4,204,100,104,4.644391,4.60517,0.03922071,9.249561,4.60517,4.644391,1,0,0,1.0201,2,0.6043,MORE
23,80,100,20,180,100,80,4.382027,4.60517,0.2231436,8.987197,4.60517,4.382027,1,1,1,0.9645,4,0.5581,MORE
23,100,112,12,212,100,112,4.60517,4.718499,0.1133287,9.323669,4.60517,4.718499,0,1,0,1.7609,3,0.5738,MORE
23,50,53,3,103,53,50,3.912023,3.970292,0.05826891,7.882315,3.970292,3.912023,1,1,1,0.9838,4,0.4509,MORE
23,50,55,5,105,55,50,3.912023,4.007333,0.09531018,7.919356,4.007333,3.912023,1,1,1,1.1836,3,0.3735,MORE
23,150,153,3,303,150,153,5.010635,5.030438,0.01980263,10.04107,5.010635,5.030438,0,1,0,0.9722,2,0.438,MORE
23,50,48,2,98,48,50,3.912023,3.871201,0.04082199,7.783224,3.871201,3.912023,1,0,0,0.9857,1,1.1224,MORE
23,162,150,12,312,162,150,5.087596,5.010635,0.07696104,10.09823,5.087596,5.010635,0,0,1,1.0708,2,0.4883,MORE
23,50,60,10,110,60,50,3.912023,4.094345,0.1823216,8.006368,4.094345,3.912023,1,1,1,1.0313,3,0.6057,MORE
23,57,50,7,107,57,50,4.043051,3.912023,0.1310283,7.955074,4.043051,3.912023,0,0,1,1.2489,2,0.533,MORE
23,150,162,12,312,150,162,5.010635,5.087596,0.07696104,10.09823,5.010635,5.087596,0,1,0,0.975,2,0.3998,MORE
23,100,86,14,186,100,86,4.60517,4.454347,0.1508229,9.059517,4.60517,4.454347,0,0,1,0.9479,2,0.7344,MORE
23,60,50,10,110,60,50,4.094345,3.912023,0.1823216,8.006368,4.094345,3.912023,0,0,1,1.276,2,0.3683,MORE
23,100,88,12,188,100,88,4.60517,4.477337,0.1278334,9.082507,4.60517,4.477337,0,0,1,1.3485,2,0.3867,MORE
23,150,129,21,279,150,129,5.010635,4.859812,0.1508229,9.870448,5.010635,4.859812,0,0,1,0.7791,4,0.5207,MORE
23,132,150,18,282,150,132,4.882802,5.010635,0.1278334,9.893437,5.010635,4.882802,1,1,1,1.3338,4,0.3493,MORE
23,92,100,8,192,100,92,4.521789,4.60517,0.08338161,9.126959,4.60517,4.521789,1,1,1,2.5587,3,0.4755,MORE
23,50,45,5,95,45,50,3.912023,3.806662,0.1053605,7.718685,3.806662,3.912023,1,0,0,1.0401,3,0.4314,MORE
23,100,84,16,184,100,84,4.60517,4.430817,0.1743534,9.035987,4.60517,4.430817,0,0,1,1.0502,2,0.433,MORE
23,150,147,3,297,150,147,5.010635,4.990433,0.02020271,10.00107,5.010635,4.990433,0,0,1,1.0257,2,0.3153,MORE
23,50,48,2,98,48,50,3.912023,3.871201,0.04082199,7.783224,3.871201,3.912023,1,0,0,1.2924,4,0.3513,MORE
23,100,102,2,202,102,100,4.60517,4.624973,0.01980263,9.230143,4.624973,4.60517,1,1,1,1.1448,3,0.3489,MORE
23,52,50,2,102,50,52,3.951244,3.912023,0.03922071,7.863267,3.912023,3.951244,1,0,0,1.0274,3,0.3671,MORE
23,47,50,3,97,50,47,3.850148,3.912023,0.0618754,7.762171,3.912023,3.850148,1,1,1,1.4404,3,0.4991,MORE
23,147,150,3,297,147,150,4.990433,5.010635,0.02020271,10.00107,4.990433,5.010635,0,1,0,1.0212,2,0.5901,MORE
23,126,150,24,276,150,126,4.836282,5.010635,0.1743534,9.846917,5.010635,4.836282,1,1,1,1.1708,1,0.5173,MORE
23,100,114,14,214,100,114,4.60517,4.736198,0.1310283,9.341369,4.60517,4.736198,0,1,0,1.2198,2,0.4101,MORE
23,49,50,1,99,50,49,3.89182,3.912023,0.02020271,7.803843,3.912023,3.89182,1,1,1,1.2195,3,0.5534,MORE
23,50,49,1,99,49,50,3.912023,3.89182,0.02020271,7.803843,3.89182,3.912023,1,0,0,1.1699,3,0.333,MORE
23,150,138,12,288,150,138,5.010635,4.927254,0.08338161,9.937889,5.010635,4.927254,0,0,1,1.0454,1,0.7843,MORE
23,106,100,6,206,106,100,4.663439,4.60517,0.05826891,9.268609,4.663439,4.60517,0,0,1,1.0925,2,0.434,MORE
23,141,150,9,291,141,150,4.94876,5.010635,0.0618754,9.959395,4.94876,5.010635,0,1,0,1.1124,2,0.3303,MORE
23,100,82,18,182,100,82,4.60517,4.406719,0.1984509,9.011889,4.60517,4.406719,0,0,1,1.0865,4,0.8874,MORE
23,120,100,20,220,120,100,4.787492,4.60517,0.1823216,9.392662,4.787492,4.60517,0,0,1,1.0129,4,0.3768,MORE
23,114,100,14,214,114,100,4.736198,4.60517,0.1310283,9.341369,4.736198,4.60517,0,0,1,2.3795,4,1.0167,MORE
23,150,147,3,297,150,147,5.010635,4.990433,0.02020271,10.00107,5.010635,4.990433,0,0,1,1.338,3,0.6922,MORE
23,150,141,9,291,150,141,5.010635,4.94876,0.0618754,9.959395,5.010635,4.94876,0,0,1,1.5511,2,1.0831,MORE
23,46,50,4,96,50,46,3.828641,3.912023,0.08338161,7.740664,3.912023,3.828641,1,1,1,1.1099,4,0.5035,MORE
23,150,165,15,315,165,150,5.010635,5.105945,0.09531018,10.11658,5.105945,5.010635,1,1,1,1.4863,4,0.382,MORE
23,50,55,5,105,50,55,3.912023,4.007333,0.09531018,7.919356,3.912023,4.007333,0,1,0,2.3103,2,0.5679,MORE
23,112,100,12,212,112,100,4.718499,4.60517,0.1133287,9.323669,4.718499,4.60517,0,0,1,1.3383,2,0.5092,MORE
23,52,50,2,102,50,52,3.951244,3.912023,0.03922071,7.863267,3.912023,3.951244,1,0,0,1.1228,3,0.6846,MORE
23,110,100,10,210,100,110,4.70048,4.60517,0.09531018,9.305651,4.60517,4.70048,1,0,0,1.1965,3,0.8004,MORE
23,150,120,30,270,150,120,5.010635,4.787492,0.2231436,9.798127,5.010635,4.787492,0,0,1,1.0036,4,0.3547,MORE
23,100,106,6,206,106,100,4.60517,4.663439,0.05826891,9.268609,4.663439,4.60517,1,1,1,2.0936,1,1.0984,MORE
23,40,50,10,90,40,50,3.688879,3.912023,0.2231436,7.600902,3.688879,3.912023,0,1,0,1.1621,2,0.4387,MORE
23,150,156,6,306,156,150,5.010635,5.049856,0.03922071,10.06049,5.049856,5.010635,1,1,1,1.5505,3,0.4163,MORE
23,100,110,10,210,100,110,4.60517,4.70048,0.09531018,9.305651,4.60517,4.70048,0,1,0,1.392,2,0.4999,MORE
23,50,60,10,110,60,50,3.912023,4.094345,0.1823216,8.006368,4.094345,3.912023,1,1,1,1.0121,4,0.3684,MORE
23,50,59,9,109,59,50,3.912023,4.077537,0.1655144,7.98956,4.077537,3.912023,1,1,1,1.7912,3,0.3828,MORE
23,50,57,7,107,57,50,3.912023,4.043051,0.1310283,7.955074,4.043051,3.912023,1,1,1,1.4334,3,0.4996,MORE
23,150,168,18,318,168,150,5.010635,5.123964,0.1133287,10.1346,5.123964,5.010635,1,1,1,1.1651,3,1.0667,MORE
23,50,59,9,109,59,50,3.912023,4.077537,0.1655144,7.98956,4.077537,3.912023,1,1,1,1.1822,4,0.4209,MORE
23,42,50,8,92,50,42,3.73767,3.912023,0.1743534,7.649693,3.912023,3.73767,1,1,1,1.875,3,0.4063,MORE
23,90,100,10,190,100,90,4.49981,4.60517,0.1053605,9.10498,4.60517,4.49981,1,1,1,1.4385,2,0.7713,MORE
23,141,150,9,291,141,150,4.94876,5.010635,0.0618754,9.959395,4.94876,5.010635,0,1,0,1.7177,1,0.9876,MORE
23,150,144,6,294,144,150,5.010635,4.969813,0.04082199,9.980449,4.969813,5.010635,1,0,0,1.3979,2,0.5494,MORE
23,59,50,9,109,59,50,4.077537,3.912023,0.1655144,7.98956,4.077537,3.912023,0,0,1,1.6794,4,0.5169,MORE
23,174,150,24,324,174,150,5.159055,5.010635,0.14842,10.16969,5.159055,5.010635,0,0,1,1.4788,3,1.0035,MORE
23,120,100,20,220,120,100,4.787492,4.60517,0.1823216,9.392662,4.787492,4.60517,0,0,1,1.1089,3,0.4664,MORE
23,46,50,4,96,50,46,3.828641,3.912023,0.08338161,7.740664,3.912023,3.828641,1,1,1,1.048,4,0.3802,MORE
23,50,47,3,97,47,50,3.912023,3.850148,0.0618754,7.762171,3.850148,3.912023,1,0,0,1.6321,3,0.4597,MORE
23,106,100,6,206,106,100,4.663439,4.60517,0.05826891,9.268609,4.663439,4.60517,0,0,1,1.3417,2,0.7507,MORE
23,92,100,8,192,100,92,4.521789,4.60517,0.08338161,9.126959,4.60517,4.521789,1,1,1,1.1179,3,0.4991,MORE
23,50,52,2,102,52,50,3.912023,3.951244,0.03922071,7.863267,3.951244,3.912023,1,1,1,1.3199,3,0.3848,MORE
23,100,118,18,218,118,100,4.60517,4.770685,0.1655144,9.375855,4.770685,4.60517,1,1,1,1.0846,4,1.2151,MORE
23,150,165,15,315,165,150,5.010635,5.105945,0.09531018,10.11658,5.105945,5.010635,1,1,1,1.1498,4,0.3491,MORE
23,100,118,18,218,118,100,4.60517,4.770685,0.1655144,9.375855,4.770685,4.60517,1,1,1,1.3786,3,0.3371,MORE
23,150,177,27,327,150,177,5.010635,5.17615,0.1655144,10.18679,5.010635,5.17615,0,1,0,1.4674,2,0.4373,MORE
23,41,50,9,91,50,41,3.713572,3.912023,0.1984509,7.625595,3.912023,3.713572,1,1,1,1.1014,4,0.3984,MORE
23,42,50,8,92,50,42,3.73767,3.912023,0.1743534,7.649693,3.912023,3.73767,1,1,1,1.5257,3,0.7028,MORE
23,100,120,20,220,120,100,4.60517,4.787492,0.1823216,9.392662,4.787492,4.60517,1,1,1,1.0084,3,0.4609,MORE
23,165,150,15,315,165,150,5.105945,5.010635,0.09531018,10.11658,5.105945,5.010635,0,0,1,0.932,4,0.4853,MORE
23,150,168,18,318,168,150,5.010635,5.123964,0.1133287,10.1346,5.123964,5.010635,1,1,1,1.2339,3,1.0669,MORE
23,100,108,8,208,108,100,4.60517,4.682131,0.07696104,9.287301,4.682131,4.60517,1,1,1,1.0444,3,0.383,MORE
23,138,150,12,288,150,138,4.927254,5.010635,0.08338161,9.937889,5.010635,4.927254,1,1,1,1.0345,4,0.6355,MORE
23,150,126,24,276,150,126,5.010635,4.836282,0.1743534,9.846917,5.010635,4.836282,0,0,1,1.2849,3,0.5829,MORE
23,150,135,15,285,150,135,5.010635,4.905275,0.1053605,9.91591,5.010635,4.905275,0,0,1,1.3565,2,0.4675,MORE
23,110,100,10,210,100,110,4.70048,4.60517,0.09531018,9.305651,4.60517,4.70048,1,0,0,1.0091,3,0.5341,MORE
23,96,100,4,196,96,100,4.564348,4.60517,0.04082199,9.169518,4.564348,4.60517,0,1,0,1.0022,4,0.468,MORE
23,150,174,24,324,174,150,5.010635,5.159055,0.14842,10.16969,5.159055,5.010635,1,1,1,1.0019,4,0.8719,MORE
23,150,129,21,279,150,129,5.010635,4.859812,0.1508229,9.870448,5.010635,4.859812,0,0,1,0.9582,3,1.1392,MORE
23,120,150,30,270,150,120,4.787492,5.010635,0.2231436,9.798127,5.010635,4.787492,1,1,1,0.9766,3,0.7012,MORE
23,50,42,8,92,50,42,3.912023,3.73767,0.1743534,7.649693,3.912023,3.73767,0,0,1,1.1686,4,0.5771,MORE
23,50,53,3,103,53,50,3.912023,3.970292,0.05826891,7.882315,3.970292,3.912023,1,1,1,1.1402,4,0.4067,MORE
23,50,58,8,108,58,50,3.912023,4.060443,0.14842,7.972466,4.060443,3.912023,1,1,1,1.3321,3,0.5198,MORE
23,60,50,10,110,60,50,4.094345,3.912023,0.1823216,8.006368,4.094345,3.912023,0,0,1,1.5015,4,0.3727,MORE
23,100,108,8,208,108,100,4.60517,4.682131,0.07696104,9.287301,4.682131,4.60517,1,1,1,1.3294,1,1.1006,MORE
23,150,162,12,312,162,150,5.010635,5.087596,0.07696104,10.09823,5.087596,5.010635,1,1,1,1.2264,4,0.5555,MORE
23,50,54,4,104,54,50,3.912023,3.988984,0.07696104,7.901007,3.988984,3.912023,1,1,1,1.061,4,0.6655,MORE
23,88,100,12,188,100,88,4.477337,4.60517,0.1278334,9.082507,4.60517,4.477337,1,1,1,1.1829,4,0.3517,MORE
23,86,100,14,186,100,86,4.454347,4.60517,0.1508229,9.059517,4.60517,4.454347,1,1,1,1.6802,3,0.634,MORE
23,153,150,3,303,153,150,5.030438,5.010635,0.01980263,10.04107,5.030438,5.010635,0,0,1,1.1548,2,0.4904,MORE
23,96,100,4,196,100,96,4.564348,4.60517,0.04082199,9.169518,4.60517,4.564348,1,1,1,1.0634,4,0.3816,MORE
23,44,50,6,94,50,44,3.78419,3.912023,0.1278334,7.696213,3.912023,3.78419,1,1,1,1.1173,3,0.6043,MORE
23,40,50,10,90,50,40,3.688879,3.912023,0.2231436,7.600902,3.912023,3.688879,1,1,1,1.1259,4,0.5811,MORE
23,82,100,18,182,100,82,4.406719,4.60517,0.1984509,9.011889,4.60517,4.406719,1,1,1,1.0653,3,0.4254,MORE
23,118,100,18,218,118,100,4.770685,4.60517,0.1655144,9.375855,4.770685,4.60517,0,0,1,1.1611,4,0.5169,MORE
23,102,100,2,202,102,100,4.624973,4.60517,0.01980263,9.230143,4.624973,4.60517,0,0,1,1.1982,2,0.8396,MORE
23,50,40,10,90,50,40,3.912023,3.688879,0.2231436,7.600902,3.912023,3.688879,0,0,1,1.1187,2,0.5332,MORE
23,84,100,16,184,100,84,4.430817,4.60517,0.1743534,9.035987,4.60517,4.430817,1,1,1,0.9516,3,1.5221,MORE
23,50,44,6,94,50,44,3.912023,3.78419,0.1278334,7.696213,3.912023,3.78419,0,0,1,1.0349,3,0.4083,MORE
23,50,56,6,106,56,50,3.912023,4.025352,0.1133287,7.937375,4.025352,3.912023,1,1,1,1.1747,3,0.7315,MORE
23,59,50,9,109,59,50,4.077537,3.912023,0.1655144,7.98956,4.077537,3.912023,0,0,1,0.9547,3,0.3657,MORE
23,94,100,6,194,100,94,4.543295,4.60517,0.0618754,9.148465,4.60517,4.543295,1,1,1,1.0166,3,0.369,MORE
23,86,100,14,186,100,86,4.454347,4.60517,0.1508229,9.059517,4.60517,4.454347,1,1,1,0.9626,3,0.4696,MORE
23,159,150,9,309,159,150,5.068904,5.010635,0.05826891,10.07954,5.068904,5.010635,0,0,1,1.1185,2,0.6539,MORE
23,162,150,12,312,150,162,5.087596,5.010635,0.07696104,10.09823,5.010635,5.087596,1,0,0,1.008,3,0.5384,MORE
23,156,150,6,306,150,156,5.049856,5.010635,0.03922071,10.06049,5.010635,5.049856,1,0,0,1.4392,3,0.6316,MORE
23,100,86,14,186,100,86,4.60517,4.454347,0.1508229,9.059517,4.60517,4.454347,0,0,1,0.9216,2,0.727,MORE
23,108,100,8,208,108,100,4.682131,4.60517,0.07696104,9.287301,4.682131,4.60517,0,0,1,1.042,2,0.3502,MORE
23,50,41,9,91,50,41,3.912023,3.713572,0.1984509,7.625595,3.912023,3.713572,0,0,1,1.5025,4,0.3982,MORE
23,51,50,1,101,50,51,3.931826,3.912023,0.01980263,7.843849,3.912023,3.931826,1,0,0,1.0146,4,0.3759,MORE
23,168,150,18,318,168,150,5.123964,5.010635,0.1133287,10.1346,5.123964,5.010635,0,0,1,1.0586,2,0.554,MORE
23,120,150,30,270,150,120,4.787492,5.010635,0.2231436,9.798127,5.010635,4.787492,1,1,1,1.1004,2,0.4539,MORE
23,150,171,21,321,171,150,5.010635,5.141664,0.1310283,10.1523,5.141664,5.010635,1,1,1,0.9685,2,0.473,MORE
23,114,100,14,214,100,114,4.736198,4.60517,0.1310283,9.341369,4.60517,4.736198,1,0,0,0.9963,2,0.4046,MORE
23,50,43,7,93,50,43,3.912023,3.7612,0.1508229,7.673223,3.912023,3.7612,0,0,1,1.6016,2,0.5223,MORE
23,50,43,7,93,50,43,3.912023,3.7612,0.1508229,7.673223,3.912023,3.7612,0,0,1,1.1745,2,0.4205,MORE
23,100,96,4,196,100,96,4.60517,4.564348,0.04082199,9.169518,4.60517,4.564348,0,0,1,1.3315,3,0.5883,MORE
23,43,50,7,93,50,43,3.7612,3.912023,0.1508229,7.673223,3.912023,3.7612,1,1,1,0.9671,4,0.507,MORE
23,118,100,18,218,100,118,4.770685,4.60517,0.1655144,9.375855,4.60517,4.770685,1,0,0,1.2275,3,0.373,MORE
23,84,100,16,184,100,84,4.430817,4.60517,0.1743534,9.035987,4.60517,4.430817,1,1,1,1.1207,3,0.3745,MORE
24,150,135,15,285,150,135,5.010635,4.905275,0.1053605,9.91591,5.010635,4.905275,0,0,1,0.808,3,1.3722,MORE
24,147,150,3,297,147,150,4.990433,5.010635,0.02020271,10.00107,4.990433,5.010635,0,1,0,0.9831,3,1.1196,MORE
24,100,94,6,194,100,94,4.60517,4.543295,0.0618754,9.148465,4.60517,4.543295,0,0,1,1.2343,2,1.872,MORE
24,82,100,18,182,100,82,4.406719,4.60517,0.1984509,9.011889,4.60517,4.406719,1,1,1,0.7343,3,1.0986,MORE
24,120,150,30,270,120,150,4.787492,5.010635,0.2231436,9.798127,4.787492,5.010635,0,1,0,0.8758,2,1.2058,MORE
24,150,123,27,273,150,123,5.010635,4.812184,0.1984509,9.82282,5.010635,4.812184,0,0,1,0.9592,2,1.3743,MORE
24,92,100,8,192,92,100,4.521789,4.60517,0.08338161,9.126959,4.521789,4.60517,0,1,0,1.0256,2,0.9566,MORE
24,135,150,15,285,150,135,4.905275,5.010635,0.1053605,9.91591,5.010635,4.905275,1,1,1,1.4819,2,1.0976,MORE
24,100,104,4,204,104,100,4.60517,4.644391,0.03922071,9.249561,4.644391,4.60517,1,1,1,1.6201,2,1.3305,MORE
24,50,54,4,104,54,50,3.912023,3.988984,0.07696104,7.901007,3.988984,3.912023,1,1,1,1.2248,2,1.6516,MORE
24,100,114,14,214,100,114,4.60517,4.736198,0.1310283,9.341369,4.60517,4.736198,0,1,0,1.246,2,1.1161,MORE
24,90,100,10,190,90,100,4.49981,4.60517,0.1053605,9.10498,4.49981,4.60517,0,1,0,2.4053,2,0.7876,MORE
24,100,86,14,186,100,86,4.60517,4.454347,0.1508229,9.059517,4.60517,4.454347,0,0,1,2.5617,2,0.8809,MORE
24,162,150,12,312,162,150,5.087596,5.010635,0.07696104,10.09823,5.087596,5.010635,0,0,1,1.125,3,1.3968,MORE
24,100,98,2,198,100,98,4.60517,4.584967,0.02020271,9.190138,4.60517,4.584967,0,0,1,1.7241,2,1.4682,MORE
24,150,138,12,288,150,138,5.010635,4.927254,0.08338161,9.937889,5.010635,4.927254,0,0,1,1.0443,2,1.2354,MORE
24,153,150,3,303,153,150,5.030438,5.010635,0.01980263,10.04107,5.030438,5.010635,0,0,1,1.8406,2,1.4691,MORE
24,100,120,20,220,120,100,4.60517,4.787492,0.1823216,9.392662,4.787492,4.60517,1,1,1,1.2387,3,1.3214,MORE
24,50,47,3,97,47,50,3.912023,3.850148,0.0618754,7.762171,3.850148,3.912023,1,0,0,1.2814,3,0.9341,MORE
24,51,50,1,101,50,51,3.931826,3.912023,0.01980263,7.843849,3.912023,3.931826,1,0,0,1.0744,3,1.0679,MORE
24,150,135,15,285,150,135,5.010635,4.905275,0.1053605,9.91591,5.010635,4.905275,0,0,1,1.1561,3,0.8919,MORE
24,110,100,10,210,110,100,4.70048,4.60517,0.09531018,9.305651,4.70048,4.60517,0,0,1,1.3664,3,1.2646,MORE
24,42,50,8,92,50,42,3.73767,3.912023,0.1743534,7.649693,3.912023,3.73767,1,1,1,0.9496,3,0.8978,MORE
24,50,49,1,99,49,50,3.912023,3.89182,0.02020271,7.803843,3.89182,3.912023,1,0,0,1.7831,3,0.6323,MORE
24,50,49,1,99,49,50,3.912023,3.89182,0.02020271,7.803843,3.89182,3.912023,1,0,0,2.2077,3,2.3722,MORE
24,54,50,4,104,54,50,3.988984,3.912023,0.07696104,7.901007,3.988984,3.912023,0,0,1,2.7892,2,0.8315,MORE
24,177,150,27,327,177,150,5.17615,5.010635,0.1655144,10.18679,5.17615,5.010635,0,0,1,0.9523,2,0.7037,MORE
24,86,100,14,186,100,86,4.454347,4.60517,0.1508229,9.059517,4.60517,4.454347,1,1,1,1.0299,3,0.6185,MORE
24,100,110,10,210,100,110,4.60517,4.70048,0.09531018,9.305651,4.60517,4.70048,0,1,0,2.8143,3,1.1213,MORE
24,100,90,10,190,100,90,4.60517,4.49981,0.1053605,9.10498,4.60517,4.49981,0,0,1,1.3328,3,0.7396,MORE
24,150,123,27,273,150,123,5.010635,4.812184,0.1984509,9.82282,5.010635,4.812184,0,0,1,1.0106,3,0.5863,MORE
24,116,100,16,216,116,100,4.75359,4.60517,0.14842,9.35876,4.75359,4.60517,0,0,1,1.6514,4,0.5141,MORE
24,150,168,18,318,150,168,5.010635,5.123964,0.1133287,10.1346,5.010635,5.123964,0,1,0,0.9825,4,0.7177,MORE
24,50,60,10,110,60,50,3.912023,4.094345,0.1823216,8.006368,4.094345,3.912023,1,1,1,1.0113,4,0.6666,MORE
24,50,58,8,108,58,50,3.912023,4.060443,0.14842,7.972466,4.060443,3.912023,1,1,1,2.4994,3,0.5363,MORE
24,150,147,3,297,150,147,5.010635,4.990433,0.02020271,10.00107,5.010635,4.990433,0,0,1,1.0117,4,0.7878,MORE
24,50,43,7,93,50,43,3.912023,3.7612,0.1508229,7.673223,3.912023,3.7612,0,0,1,1.7444,3,0.7161,MORE
24,104,100,4,204,104,100,4.644391,4.60517,0.03922071,9.249561,4.644391,4.60517,0,0,1,2.047,3,0.7685,MORE
24,150,141,9,291,150,141,5.010635,4.94876,0.0618754,9.959395,5.010635,4.94876,0,0,1,0.973,4,0.7924,MORE
24,50,42,8,92,50,42,3.912023,3.73767,0.1743534,7.649693,3.912023,3.73767,0,0,1,1.9955,3,0.9019,MORE
24,150,162,12,312,150,162,5.010635,5.087596,0.07696104,10.09823,5.010635,5.087596,0,1,0,1.5736,3,1.8744,MORE
24,165,150,15,315,165,150,5.105945,5.010635,0.09531018,10.11658,5.105945,5.010635,0,0,1,1.0151,3,0.5414,MORE
24,50,44,6,94,50,44,3.912023,3.78419,0.1278334,7.696213,3.912023,3.78419,0,0,1,2.9971,2,0.4641,MORE
24,96,100,4,196,96,100,4.564348,4.60517,0.04082199,9.169518,4.564348,4.60517,0,1,0,0.972,3,0.5361,MORE
24,102,100,2,202,102,100,4.624973,4.60517,0.01980263,9.230143,4.624973,4.60517,0,0,1,1.3455,3,0.4338,MORE
24,150,144,6,294,150,144,5.010635,4.969813,0.04082199,9.980449,5.010635,4.969813,0,0,1,1.0639,3,0.7166,MORE
24,49,50,1,99,50,49,3.89182,3.912023,0.02020271,7.803843,3.912023,3.89182,1,1,1,1.3621,3,0.7422,MORE
24,50,55,5,105,55,50,3.912023,4.007333,0.09531018,7.919356,4.007333,3.912023,1,1,1,1.3447,2,1.2175,MORE
24,48,50,2,98,50,48,3.871201,3.912023,0.04082199,7.783224,3.912023,3.871201,1,1,1,1.2737,2,1.8381,MORE
24,50,58,8,108,58,50,3.912023,4.060443,0.14842,7.972466,4.060443,3.912023,1,1,1,1.6198,3,0.9343,MORE
24,94,100,6,194,94,100,4.543295,4.60517,0.0618754,9.148465,4.543295,4.60517,0,1,0,1.4167,2,0.5666,MORE
24,52,50,2,102,50,52,3.951244,3.912023,0.03922071,7.863267,3.912023,3.951244,1,0,0,3.8629,2,0.7243,MORE
24,150,153,3,303,150,153,5.010635,5.030438,0.01980263,10.04107,5.010635,5.030438,0,1,0,0.8528,4,0.749,MORE
24,108,100,8,208,108,100,4.682131,4.60517,0.07696104,9.287301,4.682131,4.60517,0,0,1,1.079,3,1.1994,MORE
24,51,50,1,101,50,51,3.931826,3.912023,0.01980263,7.843849,3.912023,3.931826,1,0,0,2.8477,2,0.6367,MORE
24,58,50,8,108,58,50,4.060443,3.912023,0.14842,7.972466,4.060443,3.912023,0,0,1,1.0925,2,0.7668,MORE
24,43,50,7,93,50,43,3.7612,3.912023,0.1508229,7.673223,3.912023,3.7612,1,1,1,1.9122,2,0.4362,MORE
24,45,50,5,95,45,50,3.806662,3.912023,0.1053605,7.718685,3.806662,3.912023,0,1,0,3.6845,2,0.633,MORE
24,57,50,7,107,57,50,4.043051,3.912023,0.1310283,7.955074,4.043051,3.912023,0,0,1,1.4559,3,0.6009,MORE
24,150,159,9,309,150,159,5.010635,5.068904,0.05826891,10.07954,5.010635,5.068904,0,1,0,1.3641,3,0.5861,MORE
24,150,162,12,312,162,150,5.010635,5.087596,0.07696104,10.09823,5.087596,5.010635,1,1,1,1.6658,2,0.785,MORE
24,53,50,3,103,50,53,3.970292,3.912023,0.05826891,7.882315,3.912023,3.970292,1,0,0,3.3025,2,2.2086,MORE
24,42,50,8,92,42,50,3.73767,3.912023,0.1743534,7.649693,3.73767,3.912023,0,1,0,1.6095,2,0.5998,MORE
24,50,52,2,102,50,52,3.912023,3.951244,0.03922071,7.863267,3.912023,3.951244,0,1,0,1.5606,2,0.8174,MORE
24,100,120,20,220,100,120,4.60517,4.787492,0.1823216,9.392662,4.60517,4.787492,0,1,0,1.3834,3,0.7321,MORE
24,150,132,18,282,150,132,5.010635,4.882802,0.1278334,9.893437,5.010635,4.882802,0,0,1,0.9123,4,0.6515,MORE
24,156,150,6,306,156,150,5.049856,5.010635,0.03922071,10.06049,5.049856,5.010635,0,0,1,0.9651,4,0.5311,MORE
24,168,150,18,318,168,150,5.123964,5.010635,0.1133287,10.1346,5.123964,5.010635,0,0,1,0.9413,4,1.1523,MORE
24,150,171,21,321,150,171,5.010635,5.141664,0.1310283,10.1523,5.010635,5.141664,0,1,0,3.1369,3,0.5327,MORE
24,100,92,8,192,92,100,4.60517,4.521789,0.08338161,9.126959,4.521789,4.60517,1,0,0,2.534,2,0.4529,MORE
24,60,50,10,110,60,50,4.094345,3.912023,0.1823216,8.006368,4.094345,3.912023,0,0,1,1.5824,2,0.6543,MORE
24,168,150,18,318,168,150,5.123964,5.010635,0.1133287,10.1346,5.123964,5.010635,0,0,1,1.2932,3,2.7908,MORE
24,150,174,24,324,150,174,5.010635,5.159055,0.14842,10.16969,5.010635,5.159055,0,1,0,1.0523,3,0.4348,MORE
24,50,55,5,105,55,50,3.912023,4.007333,0.09531018,7.919356,4.007333,3.912023,1,1,1,1.3664,3,1.171,MORE
24,150,129,21,279,150,129,5.010635,4.859812,0.1508229,9.870448,5.010635,4.859812,0,0,1,0.9991,3,0.6635,MORE
24,150,165,15,315,150,165,5.010635,5.105945,0.09531018,10.11658,5.010635,5.105945,0,1,0,1.6544,3,0.5344,MORE
24,100,108,8,208,100,108,4.60517,4.682131,0.07696104,9.287301,4.60517,4.682131,0,1,0,1.2929,3,0.4617,MORE
24,150,156,6,306,150,156,5.010635,5.049856,0.03922071,10.06049,5.010635,5.049856,0,1,0,1.5354,4,0.5853,MORE
24,144,150,6,294,144,150,4.969813,5.010635,0.04082199,9.980449,4.969813,5.010635,0,1,0,1.1968,4,0.3978,MORE
24,150,174,24,324,150,174,5.010635,5.159055,0.14842,10.16969,5.010635,5.159055,0,1,0,1.268,4,0.8866,MORE
24,159,150,9,309,159,150,5.068904,5.010635,0.05826891,10.07954,5.068904,5.010635,0,0,1,1.5998,3,0.855,MORE
24,50,45,5,95,50,45,3.912023,3.806662,0.1053605,7.718685,3.912023,3.806662,0,0,1,3.1685,1,0.5369,MORE
24,50,53,3,103,50,53,3.912023,3.970292,0.05826891,7.882315,3.912023,3.970292,0,1,0,1.6991,2,0.4936,MORE
24,56,50,6,106,56,50,4.025352,3.912023,0.1133287,7.937375,4.025352,3.912023,0,0,1,1.5675,2,0.7157,MORE
24,116,100,16,216,116,100,4.75359,4.60517,0.14842,9.35876,4.75359,4.60517,0,0,1,1.0434,3,0.4486,MORE
24,50,53,3,103,50,53,3.912023,3.970292,0.05826891,7.882315,3.912023,3.970292,0,1,0,2.4939,2,0.5165,MORE
24,132,150,18,282,132,150,4.882802,5.010635,0.1278334,9.893437,4.882802,5.010635,0,1,0,1.1087,3,0.419,MORE
24,100,82,18,182,100,82,4.60517,4.406719,0.1984509,9.011889,4.60517,4.406719,0,0,1,1.1378,3,0.449,MORE
24,50,40,10,90,50,40,3.912023,3.688879,0.2231436,7.600902,3.912023,3.688879,0,0,1,3.6614,1,1.0798,MORE
24,92,100,8,192,100,92,4.521789,4.60517,0.08338161,9.126959,4.60517,4.521789,1,1,1,2.3261,2,0.3699,MORE
24,100,116,16,216,100,116,4.60517,4.75359,0.14842,9.35876,4.60517,4.75359,0,1,0,1.2859,2,0.6339,MORE
24,100,118,18,218,100,118,4.60517,4.770685,0.1655144,9.375855,4.60517,4.770685,0,1,0,1.8427,2,0.4471,MORE
24,100,110,10,210,100,110,4.60517,4.70048,0.09531018,9.305651,4.60517,4.70048,0,1,0,1.2757,2,0.4695,MORE
24,50,51,1,101,51,50,3.912023,3.931826,0.01980263,7.843849,3.931826,3.912023,1,1,1,1.7323,2,0.4158,MORE
24,50,47,3,97,50,47,3.912023,3.850148,0.0618754,7.762171,3.912023,3.850148,0,0,1,1.994,2,0.393,MORE
24,150,168,18,318,150,168,5.010635,5.123964,0.1133287,10.1346,5.010635,5.123964,0,1,0,1.1739,3,0.3948,MORE
24,41,50,9,91,50,41,3.713572,3.912023,0.1984509,7.625595,3.912023,3.713572,1,1,1,1.4272,3,1.305,MORE
24,180,150,30,330,180,150,5.192957,5.010635,0.1823216,10.20359,5.192957,5.010635,0,0,1,1.1017,3,0.8694,MORE
24,100,88,12,188,100,88,4.60517,4.477337,0.1278334,9.082507,4.60517,4.477337,0,0,1,1.3761,3,0.4334,MORE
24,100,106,6,206,100,106,4.60517,4.663439,0.05826891,9.268609,4.60517,4.663439,0,1,0,1.4169,3,0.404,MORE
24,96,100,4,196,96,100,4.564348,4.60517,0.04082199,9.169518,4.564348,4.60517,0,1,0,1.5195,2,1.5921,MORE
24,135,150,15,285,135,150,4.905275,5.010635,0.1053605,9.91591,4.905275,5.010635,0,1,0,0.9768,3,0.3435,MORE
24,49,50,1,99,49,50,3.89182,3.912023,0.02020271,7.803843,3.89182,3.912023,0,1,0,2.5804,1,0.36,MORE
24,100,88,12,188,100,88,4.60517,4.477337,0.1278334,9.082507,4.60517,4.477337,0,0,1,0.972,3,0.4152,MORE
24,52,50,2,102,52,50,3.951244,3.912023,0.03922071,7.863267,3.951244,3.912023,0,0,1,3.1433,2,0.3824,MORE
24,44,50,6,94,44,50,3.78419,3.912023,0.1278334,7.696213,3.78419,3.912023,0,1,0,2.087,1,0.3822,MORE
24,174,150,24,324,174,150,5.159055,5.010635,0.14842,10.16969,5.159055,5.010635,0,0,1,0.9641,4,0.467,MORE
24,50,57,7,107,57,50,3.912023,4.043051,0.1310283,7.955074,4.043051,3.912023,1,1,1,3.369,2,0.6675,MORE
24,171,150,21,321,171,150,5.141664,5.010635,0.1310283,10.1523,5.141664,5.010635,0,0,1,0.9663,3,0.5338,MORE
24,104,100,4,204,104,100,4.644391,4.60517,0.03922071,9.249561,4.644391,4.60517,0,0,1,1.0396,4,0.4855,MORE
24,180,150,30,330,180,150,5.192957,5.010635,0.1823216,10.20359,5.192957,5.010635,0,0,1,0.8943,4,0.3437,MORE
24,100,80,20,180,100,80,4.60517,4.382027,0.2231436,8.987197,4.60517,4.382027,0,0,1,3.6459,1,0.4106,MORE
24,88,100,12,188,88,100,4.477337,4.60517,0.1278334,9.082507,4.477337,4.60517,0,1,0,1.3852,2,0.5667,MORE
24,126,150,24,276,126,150,4.836282,5.010635,0.1743534,9.846917,4.836282,5.010635,0,1,0,0.9803,2,0.5,MORE
24,100,80,20,180,100,80,4.60517,4.382027,0.2231436,8.987197,4.60517,4.382027,0,0,1,1.4107,2,0.385,MORE
24,48,50,2,98,50,48,3.871201,3.912023,0.04082199,7.783224,3.912023,3.871201,1,1,1,1.2303,3,1.3485,MORE
24,80,100,20,180,80,100,4.382027,4.60517,0.2231436,8.987197,4.382027,4.60517,0,1,0,1.2356,3,1.0072,MORE
24,50,60,10,110,50,60,3.912023,4.094345,0.1823216,8.006368,3.912023,4.094345,0,1,0,2.5659,2,0.7673,MORE
24,123,150,27,273,123,150,4.812184,5.010635,0.1984509,9.82282,4.812184,5.010635,0,1,0,1.1543,3,0.5037,MORE
24,60,50,10,110,60,50,4.094345,3.912023,0.1823216,8.006368,4.094345,3.912023,0,0,1,1.0264,3,0.4758,MORE
24,100,112,12,212,100,112,4.60517,4.718499,0.1133287,9.323669,4.60517,4.718499,0,1,0,1.2724,3,0.4896,MORE
24,159,150,9,309,159,150,5.068904,5.010635,0.05826891,10.07954,5.068904,5.010635,0,0,1,0.8042,4,0.6326,MORE
24,94,100,6,194,94,100,4.543295,4.60517,0.0618754,9.148465,4.543295,4.60517,0,1,0,1.4445,4,0.4683,MORE
24,138,150,12,288,138,150,4.927254,5.010635,0.08338161,9.937889,4.927254,5.010635,0,1,0,0.8387,4,0.2998,MORE
24,165,150,15,315,165,150,5.105945,5.010635,0.09531018,10.11658,5.105945,5.010635,0,0,1,0.9087,3,0.6374,MORE
24,123,150,27,273,123,150,4.812184,5.010635,0.1984509,9.82282,4.812184,5.010635,0,1,0,1.0562,3,0.5175,MORE
24,147,150,3,297,147,150,4.990433,5.010635,0.02020271,10.00107,4.990433,5.010635,0,1,0,1.0157,3,0.4633,MORE
24,112,100,12,212,112,100,4.718499,4.60517,0.1133287,9.323669,4.718499,4.60517,0,0,1,1.1535,3,0.3408,MORE
24,106,100,6,206,106,100,4.663439,4.60517,0.05826891,9.268609,4.663439,4.60517,0,0,1,3.284,3,0.3832,MORE
24,100,112,12,212,100,112,4.60517,4.718499,0.1133287,9.323669,4.60517,4.718499,0,1,0,2.3363,2,0.7481,MORE
24,59,50,9,109,59,50,4.077537,3.912023,0.1655144,7.98956,4.077537,3.912023,0,0,1,1.7233,2,0.3661,MORE
24,150,171,21,321,150,171,5.010635,5.141664,0.1310283,10.1523,5.010635,5.141664,0,1,0,1.1059,3,0.3464,MORE
24,41,50,9,91,50,41,3.713572,3.912023,0.1984509,7.625595,3.912023,3.713572,1,1,1,1.1979,3,1.3551,MORE
24,46,50,4,96,50,46,3.828641,3.912023,0.08338161,7.740664,3.912023,3.828641,1,1,1,2.3929,2,0.5055,MORE
24,150,141,9,291,150,141,5.010635,4.94876,0.0618754,9.959395,5.010635,4.94876,0,0,1,1.0034,3,0.5539,MORE
24,100,114,14,214,100,114,4.60517,4.736198,0.1310283,9.341369,4.60517,4.736198,0,1,0,2.0509,3,1.053,MORE
24,177,150,27,327,177,150,5.17615,5.010635,0.1655144,10.18679,5.17615,5.010635,0,0,1,0.8976,3,0.33,MORE
24,108,100,8,208,108,100,4.682131,4.60517,0.07696104,9.287301,4.682131,4.60517,0,0,1,1.525,3,0.2907,MORE
24,50,40,10,90,50,40,3.912023,3.688879,0.2231436,7.600902,3.912023,3.688879,0,0,1,3.4701,1,0.8345,MORE
24,88,100,12,188,88,100,4.477337,4.60517,0.1278334,9.082507,4.477337,4.60517,0,1,0,1.6519,2,0.5316,MORE
24,150,126,24,276,150,126,5.010635,4.836282,0.1743534,9.846917,5.010635,4.836282,0,0,1,0.9491,4,0.334,MORE
24,58,50,8,108,58,50,4.060443,3.912023,0.14842,7.972466,4.060443,3.912023,0,0,1,1.767,2,1.2161,MORE
24,141,150,9,291,141,150,4.94876,5.010635,0.0618754,9.959395,4.94876,5.010635,0,1,0,0.8789,4,0.6811,MORE
24,150,153,3,303,150,153,5.010635,5.030438,0.01980263,10.04107,5.010635,5.030438,0,1,0,0.8866,3,0.6347,MORE
24,100,116,16,216,116,100,4.60517,4.75359,0.14842,9.35876,4.75359,4.60517,1,1,1,4.2876,2,1.4481,MORE
24,53,50,3,103,53,50,3.970292,3.912023,0.05826891,7.882315,3.970292,3.912023,0,0,1,2.7146,2,0.3258,MORE
24,59,50,9,109,59,50,4.077537,3.912023,0.1655144,7.98956,4.077537,3.912023,0,0,1,1.1262,3,0.3508,MORE
24,90,100,10,190,90,100,4.49981,4.60517,0.1053605,9.10498,4.49981,4.60517,0,1,0,1.5087,2,1.0417,MORE
24,100,108,8,208,100,108,4.60517,4.682131,0.07696104,9.287301,4.60517,4.682131,0,1,0,4.0217,2,0.9904,MORE
24,44,50,6,94,50,44,3.78419,3.912023,0.1278334,7.696213,3.912023,3.78419,1,1,1,2.1323,2,0.6821,MORE
24,150,129,21,279,150,129,5.010635,4.859812,0.1508229,9.870448,5.010635,4.859812,0,0,1,0.8028,4,0.6476,MORE
24,156,150,6,306,156,150,5.049856,5.010635,0.03922071,10.06049,5.049856,5.010635,0,0,1,0.9084,4,0.4807,MORE
24,50,48,2,98,48,50,3.912023,3.871201,0.04082199,7.783224,3.871201,3.912023,1,0,0,2.2885,2,0.4585,MORE
24,100,92,8,192,92,100,4.60517,4.521789,0.08338161,9.126959,4.521789,4.60517,1,0,0,1.5777,3,0.6206,MORE
24,50,56,6,106,56,50,3.912023,4.025352,0.1133287,7.937375,4.025352,3.912023,1,1,1,2.2694,2,0.3979,MORE
24,100,84,16,184,100,84,4.60517,4.430817,0.1743534,9.035987,4.60517,4.430817,0,0,1,0.9886,3,0.3819,MORE
24,100,86,14,186,100,86,4.60517,4.454347,0.1508229,9.059517,4.60517,4.454347,0,0,1,1.063,3,1.0068,MORE
24,112,100,12,212,112,100,4.718499,4.60517,0.1133287,9.323669,4.718499,4.60517,0,0,1,1.4181,3,0.9028,MORE
24,150,144,6,294,150,144,5.010635,4.969813,0.04082199,9.980449,5.010635,4.969813,0,0,1,0.9044,3,0.4488,MORE
24,120,150,30,270,120,150,4.787492,5.010635,0.2231436,9.798127,4.787492,5.010635,0,1,0,2.141,3,0.3541,MORE
24,50,43,7,93,43,50,3.912023,3.7612,0.1508229,7.673223,3.7612,3.912023,1,0,0,1.1384,3,1.369,MORE
24,50,46,4,96,50,46,3.912023,3.828641,0.08338161,7.740664,3.912023,3.828641,0,0,1,2.637,2,0.3503,MORE
24,150,147,3,297,150,147,5.010635,4.990433,0.02020271,10.00107,5.010635,4.990433,0,0,1,1.1383,3,0.3847,MORE
24,50,44,6,94,44,50,3.912023,3.78419,0.1278334,7.696213,3.78419,3.912023,1,0,0,2.1119,2,0.2393,MORE
24,50,57,7,107,57,50,3.912023,4.043051,0.1310283,7.955074,4.043051,3.912023,1,1,1,1.8518,2,0.7193,MORE
24,129,150,21,279,129,150,4.859812,5.010635,0.1508229,9.870448,4.859812,5.010635,0,1,0,1.6866,2,0.9407,MORE
24,100,102,2,202,100,102,4.60517,4.624973,0.01980263,9.230143,4.60517,4.624973,0,1,0,1.7622,2,0.3248,MORE
24,56,50,6,106,50,56,4.025352,3.912023,0.1133287,7.937375,3.912023,4.025352,1,0,0,3.4331,2,0.288,MORE
24,100,90,10,190,100,90,4.60517,4.49981,0.1053605,9.10498,4.60517,4.49981,0,0,1,1.4465,2,0.515,MORE
24,45,50,5,95,50,45,3.806662,3.912023,0.1053605,7.718685,3.912023,3.806662,1,1,1,5.1999,1,0.2673,MORE
24,50,56,6,106,50,56,3.912023,4.025352,0.1133287,7.937375,3.912023,4.025352,0,1,0,1.8043,2,0.4053,MORE
24,100,106,6,206,100,106,4.60517,4.663439,0.05826891,9.268609,4.60517,4.663439,0,1,0,2.4889,2,1.2374,MORE
24,50,52,2,102,52,50,3.912023,3.951244,0.03922071,7.863267,3.951244,3.912023,1,1,1,1.2693,2,0.6797,MORE
24,150,180,30,330,180,150,5.010635,5.192957,0.1823216,10.20359,5.192957,5.010635,1,1,1,1.9991,2,0.3189,MORE
24,50,48,2,98,50,48,3.912023,3.871201,0.04082199,7.783224,3.912023,3.871201,0,0,1,1.843,3,0.3488,MORE
24,98,100,2,198,98,100,4.584967,4.60517,0.02020271,9.190138,4.584967,4.60517,0,1,0,1.6902,2,0.2695,MORE
24,171,150,21,321,171,150,5.141664,5.010635,0.1310283,10.1523,5.141664,5.010635,0,0,1,0.9556,3,0.3992,MORE
24,118,100,18,218,118,100,4.770685,4.60517,0.1655144,9.375855,4.770685,4.60517,0,0,1,1.2111,3,0.3075,MORE
24,100,102,2,202,100,102,4.60517,4.624973,0.01980263,9.230143,4.60517,4.624973,0,1,0,5.2961,2,1.032,MORE
24,141,150,9,291,141,150,4.94876,5.010635,0.0618754,9.959395,4.94876,5.010635,0,1,0,1.4051,2,0.7032,MORE
24,100,84,16,184,100,84,4.60517,4.430817,0.1743534,9.035987,4.60517,4.430817,0,0,1,0.9814,3,0.6158,MORE
24,50,59,9,109,59,50,3.912023,4.077537,0.1655144,7.98956,4.077537,3.912023,1,1,1,2.0119,2,0.4854,MORE
24,55,50,5,105,55,50,4.007333,3.912023,0.09531018,7.919356,4.007333,3.912023,0,0,1,3.5795,2,0.2482,MORE
24,162,150,12,312,162,150,5.087596,5.010635,0.07696104,10.09823,5.087596,5.010635,0,0,1,1.1331,3,0.3508,MORE
24,50,41,9,91,41,50,3.912023,3.713572,0.1984509,7.625595,3.713572,3.912023,1,0,0,1.5996,2,0.7709,MORE
24,174,150,24,324,174,150,5.159055,5.010635,0.14842,10.16969,5.159055,5.010635,0,0,1,1.0163,3,0.3584,MORE
24,129,150,21,279,150,129,4.859812,5.010635,0.1508229,9.870448,5.010635,4.859812,1,1,1,3.184,2,0.271,MORE
24,50,59,9,109,59,50,3.912023,4.077537,0.1655144,7.98956,4.077537,3.912023,1,1,1,1.6226,2,0.3719,MORE
24,43,50,7,93,50,43,3.7612,3.912023,0.1508229,7.673223,3.912023,3.7612,1,1,1,1.0238,2,0.317,MORE
24,84,100,16,184,100,84,4.430817,4.60517,0.1743534,9.035987,4.60517,4.430817,1,1,1,2.3994,2,0.3473,MORE
24,150,126,24,276,150,126,5.010635,4.836282,0.1743534,9.846917,5.010635,4.836282,0,0,1,0.9507,3,0.2972,MORE
24,150,120,30,270,150,120,5.010635,4.787492,0.2231436,9.798127,5.010635,4.787492,0,0,1,1.0443,4,0.2759,MORE
24,138,150,12,288,138,150,4.927254,5.010635,0.08338161,9.937889,4.927254,5.010635,0,1,0,1.0346,3,0.3131,MORE
24,98,100,2,198,100,98,4.584967,4.60517,0.02020271,9.190138,4.60517,4.584967,1,1,1,3.6406,2,0.3505,MORE
24,150,177,27,327,150,177,5.010635,5.17615,0.1655144,10.18679,5.010635,5.17615,0,1,0,1.0482,3,0.2795,MORE
24,114,100,14,214,114,100,4.736198,4.60517,0.1310283,9.341369,4.736198,4.60517,0,0,1,1.2389,2,0.6874,MORE
24,102,100,2,202,102,100,4.624973,4.60517,0.01980263,9.230143,4.624973,4.60517,0,0,1,1.1315,3,0.2851,MORE
24,144,150,6,294,144,150,4.969813,5.010635,0.04082199,9.980449,4.969813,5.010635,0,1,0,1.143,3,0.2745,MORE
24,126,150,24,276,126,150,4.836282,5.010635,0.1743534,9.846917,4.836282,5.010635,0,1,0,2.6519,2,0.9197,MORE
24,150,177,27,327,150,177,5.010635,5.17615,0.1655144,10.18679,5.010635,5.17615,0,1,0,1.1972,3,0.3297,MORE
24,54,50,4,104,50,54,3.988984,3.912023,0.07696104,7.901007,3.912023,3.988984,1,0,0,2.3165,2,0.7304,MORE
24,110,100,10,210,110,100,4.70048,4.60517,0.09531018,9.305651,4.70048,4.60517,0,0,1,0.8745,2,0.5742,MORE
24,47,50,3,97,47,50,3.850148,3.912023,0.0618754,7.762171,3.850148,3.912023,0,1,0,1.4533,2,0.6169,MORE
24,40,50,10,90,50,40,3.688879,3.912023,0.2231436,7.600902,3.912023,3.688879,1,1,1,1.4066,2,0.5579,MORE
24,132,150,18,282,132,150,4.882802,5.010635,0.1278334,9.893437,4.882802,5.010635,0,1,0,2.627,2,0.4039,MORE
24,150,165,15,315,150,165,5.010635,5.105945,0.09531018,10.11658,5.010635,5.105945,0,1,0,1.4437,2,0.7523,MORE
24,50,42,8,92,50,42,3.912023,3.73767,0.1743534,7.649693,3.912023,3.73767,0,0,1,1.4085,2,0.7875,MORE
24,40,50,10,90,50,40,3.688879,3.912023,0.2231436,7.600902,3.912023,3.688879,1,1,1,1.7635,2,0.5012,MORE
24,120,100,20,220,120,100,4.787492,4.60517,0.1823216,9.392662,4.787492,4.60517,0,0,1,0.8121,3,0.4382,MORE
24,150,180,30,330,150,180,5.010635,5.192957,0.1823216,10.20359,5.010635,5.192957,0,1,0,0.9637,3,0.5507,MORE
24,82,100,18,182,100,82,4.406719,4.60517,0.1984509,9.011889,4.60517,4.406719,1,1,1,2.9493,3,1.0542,MORE
24,57,50,7,107,50,57,4.043051,3.912023,0.1310283,7.955074,3.912023,4.043051,1,0,0,2.3992,2,0.9269,MORE
24,100,98,2,198,98,100,4.60517,4.584967,0.02020271,9.190138,4.584967,4.60517,1,0,0,2.7168,2,0.4273,MORE
24,150,120,30,270,150,120,5.010635,4.787492,0.2231436,9.798127,5.010635,4.787492,0,0,1,1.0347,4,0.4399,MORE
24,100,94,6,194,94,100,4.60517,4.543295,0.0618754,9.148465,4.543295,4.60517,1,0,0,1.6735,2,1.0226,MORE
24,106,100,6,206,106,100,4.663439,4.60517,0.05826891,9.268609,4.663439,4.60517,0,0,1,3.0379,2,0.5353,MORE
24,47,50,3,97,50,47,3.850148,3.912023,0.0618754,7.762171,3.912023,3.850148,1,1,1,1.1773,2,0.4992,MORE
24,150,156,6,306,150,156,5.010635,5.049856,0.03922071,10.06049,5.010635,5.049856,0,1,0,1.0831,3,0.6647,MORE
24,84,100,16,184,100,84,4.430817,4.60517,0.1743534,9.035987,4.60517,4.430817,1,1,1,1.5323,2,0.4144,MORE
24,50,54,4,104,54,50,3.912023,3.988984,0.07696104,7.901007,3.988984,3.912023,1,1,1,1.2864,3,0.8013,MORE
24,100,96,4,196,100,96,4.60517,4.564348,0.04082199,9.169518,4.60517,4.564348,0,0,1,1.2086,2,0.7359,MORE
24,100,82,18,182,100,82,4.60517,4.406719,0.1984509,9.011889,4.60517,4.406719,0,0,1,2.8461,3,0.688,MORE
24,46,50,4,96,50,46,3.828641,3.912023,0.08338161,7.740664,3.912023,3.828641,1,1,1,1.3514,3,0.4005,MORE
24,150,159,9,309,150,159,5.010635,5.068904,0.05826891,10.07954,5.010635,5.068904,0,1,0,1.2515,3,0.489,MORE
24,50,51,1,101,50,51,3.912023,3.931826,0.01980263,7.843849,3.912023,3.931826,0,1,0,2.1684,2,0.4337,MORE
24,120,100,20,220,120,100,4.787492,4.60517,0.1823216,9.392662,4.787492,4.60517,0,0,1,1.003,2,0.669,MORE
24,50,45,5,95,45,50,3.912023,3.806662,0.1053605,7.718685,3.806662,3.912023,1,0,0,1.8925,2,0.8854,MORE
24,100,104,4,204,100,104,4.60517,4.644391,0.03922071,9.249561,4.60517,4.644391,0,1,0,1.5994,2,0.4326,MORE
24,80,100,20,180,100,80,4.382027,4.60517,0.2231436,8.987197,4.60517,4.382027,1,1,1,2.0947,2,0.2853,MORE
24,118,100,18,218,118,100,4.770685,4.60517,0.1655144,9.375855,4.770685,4.60517,0,0,1,1.6321,2,0.2638,MORE
24,50,41,9,91,41,50,3.912023,3.713572,0.1984509,7.625595,3.713572,3.912023,1,0,0,0.9905,3,0.6864,MORE
24,114,100,14,214,114,100,4.736198,4.60517,0.1310283,9.341369,4.736198,4.60517,0,0,1,1.3402,2,0.5384,MORE
24,150,132,18,282,150,132,5.010635,4.882802,0.1278334,9.893437,5.010635,4.882802,0,0,1,0.9744,3,0.8399,MORE
24,86,100,14,186,100,86,4.454347,4.60517,0.1508229,9.059517,4.60517,4.454347,1,1,1,1.5139,2,0.5322,MORE
24,55,50,5,105,50,55,4.007333,3.912023,0.09531018,7.919356,3.912023,4.007333,1,0,0,1.917,2,0.4335,MORE
24,100,118,18,218,118,100,4.60517,4.770685,0.1655144,9.375855,4.770685,4.60517,1,1,1,1.4404,2,0.5351,MORE
24,100,96,4,196,96,100,4.60517,4.564348,0.04082199,9.169518,4.564348,4.60517,1,0,0,2.3872,2,0.8379,MORE
24,153,150,3,303,153,150,5.030438,5.010635,0.01980263,10.04107,5.030438,5.010635,0,0,1,0.9777,3,0.449,MORE
24,50,46,4,96,50,46,3.912023,3.828641,0.08338161,7.740664,3.912023,3.828641,0,0,1,1.3587,2,0.4482,MORE
24,150,138,12,288,150,138,5.010635,4.927254,0.08338161,9.937889,5.010635,4.927254,0,0,1,0.9321,3,0.459,MORE
25,100,88,12,188,100,88,4.60517,4.477337,0.1278334,9.082507,4.60517,4.477337,0,0,1,2.28,2,0.957,MORE
25,100,110,10,210,100,110,4.60517,4.70048,0.09531018,9.305651,4.60517,4.70048,0,1,0,2.88,2,0.696,MORE
25,50,46,4,96,50,46,3.912023,3.828641,0.08338161,7.740664,3.912023,3.828641,0,0,1,1.585,2,0.499,MORE
25,108,100,8,208,108,100,4.682131,4.60517,0.07696104,9.287301,4.682131,4.60517,0,0,1,1.563,1,1.217,MORE
25,171,150,21,321,171,150,5.141664,5.010635,0.1310283,10.1523,5.141664,5.010635,0,0,1,1.712,3,0.753,MORE
25,51,50,1,101,50,51,3.931826,3.912023,0.01980263,7.843849,3.912023,3.931826,1,0,0,1.548,4,0.92,MORE
25,100,118,18,218,100,118,4.60517,4.770685,0.1655144,9.375855,4.60517,4.770685,0,1,0,1.401,2,0.586,MORE
25,100,86,14,186,100,86,4.60517,4.454347,0.1508229,9.059517,4.60517,4.454347,0,0,1,1.264,3,0.667,MORE
25,129,150,21,279,129,150,4.859812,5.010635,0.1508229,9.870448,4.859812,5.010635,0,1,0,1.484,3,0.67,MORE
25,47,50,3,97,50,47,3.850148,3.912023,0.0618754,7.762171,3.912023,3.850148,1,1,1,1.772,4,0.603,MORE
25,100,90,10,190,100,90,4.60517,4.49981,0.1053605,9.10498,4.60517,4.49981,0,0,1,1.568,2,0.608,MORE
25,49,50,1,99,50,49,3.89182,3.912023,0.02020271,7.803843,3.912023,3.89182,1,1,1,1.473,3,0.583,MORE
25,141,150,9,291,141,150,4.94876,5.010635,0.0618754,9.959395,4.94876,5.010635,0,1,0,1.525,2,0.501,MORE
25,150,168,18,318,168,150,5.010635,5.123964,0.1133287,10.1346,5.123964,5.010635,1,1,1,1.335,3,0.415,MORE
25,150,171,21,321,171,150,5.010635,5.141664,0.1310283,10.1523,5.141664,5.010635,1,1,1,1.68,4,0.473,MORE
25,132,150,18,282,150,132,4.882802,5.010635,0.1278334,9.893437,5.010635,4.882802,1,1,1,1.34,3,0.483,MORE
25,116,100,16,216,100,116,4.75359,4.60517,0.14842,9.35876,4.60517,4.75359,1,0,0,1.147,4,0.584,MORE
25,114,100,14,214,114,100,4.736198,4.60517,0.1310283,9.341369,4.736198,4.60517,0,0,1,1.219,3,0.871,MORE
25,59,50,9,109,50,59,4.077537,3.912023,0.1655144,7.98956,3.912023,4.077537,1,0,0,1.453,3,0.625,MORE
25,50,52,2,102,52,50,3.912023,3.951244,0.03922071,7.863267,3.951244,3.912023,1,1,1,1.459,3,0.456,MORE
25,120,150,30,270,150,120,4.787492,5.010635,0.2231436,9.798127,5.010635,4.787492,1,1,1,1.693,3,0.359,MORE
25,150,129,21,279,150,129,5.010635,4.859812,0.1508229,9.870448,5.010635,4.859812,0,0,1,1.139,3,0.438,MORE
25,129,150,21,279,129,150,4.859812,5.010635,0.1508229,9.870448,4.859812,5.010635,0,1,0,1.29,3,0.538,MORE
25,100,94,6,194,94,100,4.60517,4.543295,0.0618754,9.148465,4.543295,4.60517,1,0,0,1.321,3,0.465,MORE
25,165,150,15,315,165,150,5.105945,5.010635,0.09531018,10.11658,5.105945,5.010635,0,0,1,1.527,2,0.353,MORE
25,57,50,7,107,50,57,4.043051,3.912023,0.1310283,7.955074,3.912023,4.043051,1,0,0,1.452,3,0.451,MORE
25,50,53,3,103,50,53,3.912023,3.970292,0.05826891,7.882315,3.912023,3.970292,0,1,0,1.427,2,0.565,MORE
25,88,100,12,188,100,88,4.477337,4.60517,0.1278334,9.082507,4.60517,4.477337,1,1,1,1.258,3,0.433,MORE
25,100,98,2,198,100,98,4.60517,4.584967,0.02020271,9.190138,4.60517,4.584967,0,0,1,1.302,1,0.584,MORE
25,156,150,6,306,156,150,5.049856,5.010635,0.03922071,10.06049,5.049856,5.010635,0,0,1,1.749,2,0.359,MORE
25,153,150,3,303,150,153,5.030438,5.010635,0.01980263,10.04107,5.010635,5.030438,1,0,0,1.335,3,0.344,MORE
25,48,50,2,98,50,48,3.871201,3.912023,0.04082199,7.783224,3.912023,3.871201,1,1,1,1.263,4,0.451,MORE
25,94,100,6,194,100,94,4.543295,4.60517,0.0618754,9.148465,4.60517,4.543295,1,1,1,1.37,4,0.418,MORE
25,108,100,8,208,108,100,4.682131,4.60517,0.07696104,9.287301,4.682131,4.60517,0,0,1,1.284,3,0.417,MORE
25,102,100,2,202,100,102,4.624973,4.60517,0.01980263,9.230143,4.60517,4.624973,1,0,0,1.468,4,0.352,MORE
25,150,165,15,315,150,165,5.010635,5.105945,0.09531018,10.11658,5.010635,5.105945,0,1,0,1.225,3,0.395,MORE
25,150,156,6,306,156,150,5.010635,5.049856,0.03922071,10.06049,5.049856,5.010635,1,1,1,1.122,3,0.357,MORE
25,90,100,10,190,100,90,4.49981,4.60517,0.1053605,9.10498,4.60517,4.49981,1,1,1,1.523,3,0.276,MORE
25,47,50,3,97,50,47,3.850148,3.912023,0.0618754,7.762171,3.912023,3.850148,1,1,1,1.166,3,0.319,MORE
25,150,177,27,327,177,150,5.010635,5.17615,0.1655144,10.18679,5.17615,5.010635,1,1,1,1.565,4,0.294,MORE
25,50,41,9,91,41,50,3.912023,3.713572,0.1984509,7.625595,3.713572,3.912023,1,0,0,1.26,4,0.383,MORE
25,50,53,3,103,53,50,3.912023,3.970292,0.05826891,7.882315,3.970292,3.912023,1,1,1,0.893,4,0.385,MORE
25,150,168,18,318,168,150,5.010635,5.123964,0.1133287,10.1346,5.123964,5.010635,1,1,1,1.159,3,0.324,MORE
25,53,50,3,103,50,53,3.970292,3.912023,0.05826891,7.882315,3.912023,3.970292,1,0,0,1.278,4,0.426,MORE
25,50,57,7,107,50,57,3.912023,4.043051,0.1310283,7.955074,3.912023,4.043051,0,1,0,1.294,3,0.654,MORE
25,50,47,3,97,50,47,3.912023,3.850148,0.0618754,7.762171,3.912023,3.850148,0,0,1,1.356,2,0.383,MORE
25,118,100,18,218,118,100,4.770685,4.60517,0.1655144,9.375855,4.770685,4.60517,0,0,1,1.526,2,0.345,MORE
25,100,106,6,206,100,106,4.60517,4.663439,0.05826891,9.268609,4.60517,4.663439,0,1,0,1.596,2,0.288,MORE
25,50,56,6,106,56,50,3.912023,4.025352,0.1133287,7.937375,4.025352,3.912023,1,1,1,0.992,3,0.265,MORE
25,90,100,10,190,100,90,4.49981,4.60517,0.1053605,9.10498,4.60517,4.49981,1,1,1,1.146,3,0.298,MORE
25,50,58,8,108,58,50,3.912023,4.060443,0.14842,7.972466,4.060443,3.912023,1,1,1,1.116,3,0.339,MORE
25,58,50,8,108,58,50,4.060443,3.912023,0.14842,7.972466,4.060443,3.912023,0,0,1,1.118,3,0.408,MORE
25,54,50,4,104,50,54,3.988984,3.912023,0.07696104,7.901007,3.912023,3.988984,1,0,0,1.321,3,0.37,MORE
25,50,45,5,95,50,45,3.912023,3.806662,0.1053605,7.718685,3.912023,3.806662,0,0,1,1.159,2,0.305,MORE
25,153,150,3,303,150,153,5.030438,5.010635,0.01980263,10.04107,5.010635,5.030438,1,0,0,1.214,1,0.468,MORE
25,98,100,2,198,98,100,4.584967,4.60517,0.02020271,9.190138,4.584967,4.60517,0,1,0,1.189,2,0.257,MORE
25,50,46,4,96,50,46,3.912023,3.828641,0.08338161,7.740664,3.912023,3.828641,0,0,1,2.634,3,0.484,MORE
25,100,92,8,192,100,92,4.60517,4.521789,0.08338161,9.126959,4.60517,4.521789,0,0,1,1.369,4,0.432,MORE
25,42,50,8,92,50,42,3.73767,3.912023,0.1743534,7.649693,3.912023,3.73767,1,1,1,1.542,3,0.301,MORE
25,50,56,6,106,56,50,3.912023,4.025352,0.1133287,7.937375,4.025352,3.912023,1,1,1,1.224,3,0.312,MORE
25,168,150,18,318,168,150,5.123964,5.010635,0.1133287,10.1346,5.123964,5.010635,0,0,1,1.3,3,0.497,MORE
25,150,144,6,294,150,144,5.010635,4.969813,0.04082199,9.980449,5.010635,4.969813,0,0,1,1.376,3,0.45,MORE
25,150,147,3,297,147,150,5.010635,4.990433,0.02020271,10.00107,4.990433,5.010635,1,0,0,1.206,4,0.341,MORE
25,59,50,9,109,50,59,4.077537,3.912023,0.1655144,7.98956,3.912023,4.077537,1,0,0,1.221,3,0.384,MORE
25,150,141,9,291,150,141,5.010635,4.94876,0.0618754,9.959395,5.010635,4.94876,0,0,1,1.17,2,0.332,MORE
25,52,50,2,102,50,52,3.951244,3.912023,0.03922071,7.863267,3.912023,3.951244,1,0,0,1.137,3,0.439,MORE
25,104,100,4,204,104,100,4.644391,4.60517,0.03922071,9.249561,4.644391,4.60517,0,0,1,1.256,1,0.54,MORE
25,150,174,24,324,174,150,5.010635,5.159055,0.14842,10.16969,5.159055,5.010635,1,1,1,1.228,2,0.439,MORE
25,100,82,18,182,100,82,4.60517,4.406719,0.1984509,9.011889,4.60517,4.406719,0,0,1,1.257,2,0.394,MORE
25,150,120,30,270,150,120,5.010635,4.787492,0.2231436,9.798127,5.010635,4.787492,0,0,1,1.296,2,0.402,MORE
25,40,50,10,90,50,40,3.688879,3.912023,0.2231436,7.600902,3.912023,3.688879,1,1,1,1.117,3,0.304,MORE
25,94,100,6,194,100,94,4.543295,4.60517,0.0618754,9.148465,4.60517,4.543295,1,1,1,1.147,3,0.318,MORE
25,40,50,10,90,50,40,3.688879,3.912023,0.2231436,7.600902,3.912023,3.688879,1,1,1,1.283,3,0.301,MORE
25,50,44,6,94,50,44,3.912023,3.78419,0.1278334,7.696213,3.912023,3.78419,0,0,1,1.295,2,0.384,MORE
25,56,50,6,106,56,50,4.025352,3.912023,0.1133287,7.937375,4.025352,3.912023,0,0,1,1.357,2,0.377,MORE
25,100,102,2,202,102,100,4.60517,4.624973,0.01980263,9.230143,4.624973,4.60517,1,1,1,1.169,3,0.342,MORE
25,50,54,4,104,54,50,3.912023,3.988984,0.07696104,7.901007,3.988984,3.912023,1,1,1,1.092,3,0.335,MORE
25,60,50,10,110,50,60,4.094345,3.912023,0.1823216,8.006368,3.912023,4.094345,1,0,0,1.192,2,0.449,MORE
25,150,123,27,273,150,123,5.010635,4.812184,0.1984509,9.82282,5.010635,4.812184,0,0,1,1.165,2,0.378,MORE
25,50,55,5,105,55,50,3.912023,4.007333,0.09531018,7.919356,4.007333,3.912023,1,1,1,1.095,3,0.275,MORE
25,150,153,3,303,153,150,5.010635,5.030438,0.01980263,10.04107,5.030438,5.010635,1,1,1,1.087,3,0.372,MORE
25,112,100,12,212,100,112,4.718499,4.60517,0.1133287,9.323669,4.60517,4.718499,1,0,0,0.771,3,0.551,MORE
25,44,50,6,94,44,50,3.78419,3.912023,0.1278334,7.696213,3.78419,3.912023,0,1,0,1.212,3,0.276,MORE
25,106,100,6,206,100,106,4.663439,4.60517,0.05826891,9.268609,4.60517,4.663439,1,0,0,1.06,2,0.272,MORE
25,86,100,14,186,100,86,4.454347,4.60517,0.1508229,9.059517,4.60517,4.454347,1,1,1,1.089,3,0.384,MORE
25,135,150,15,285,135,150,4.905275,5.010635,0.1053605,9.91591,4.905275,5.010635,0,1,0,0.633,2,0.617,MORE
25,150,171,21,321,171,150,5.010635,5.141664,0.1310283,10.1523,5.141664,5.010635,1,1,1,1.17,2,0.287,MORE
25,100,110,10,210,110,100,4.60517,4.70048,0.09531018,9.305651,4.70048,4.60517,1,1,1,1.136,2,0.349,MORE
25,50,40,10,90,40,50,3.912023,3.688879,0.2231436,7.600902,3.688879,3.912023,1,0,0,1.471,1,0.367,MORE
25,50,43,7,93,50,43,3.912023,3.7612,0.1508229,7.673223,3.912023,3.7612,0,0,1,1.277,2,0.354,MORE
25,84,100,16,184,100,84,4.430817,4.60517,0.1743534,9.035987,4.60517,4.430817,1,1,1,1.112,2,0.307,MORE
25,100,112,12,212,112,100,4.60517,4.718499,0.1133287,9.323669,4.718499,4.60517,1,1,1,1.09,3,0.395,MORE
25,50,59,9,109,59,50,3.912023,4.077537,0.1655144,7.98956,4.077537,3.912023,1,1,1,1.129,4,1.217,MORE
25,150,180,30,330,180,150,5.010635,5.192957,0.1823216,10.20359,5.192957,5.010635,1,1,1,1.064,4,0.306,MORE
25,56,50,6,106,56,50,4.025352,3.912023,0.1133287,7.937375,4.025352,3.912023,0,0,1,1.25,2,0.346,MORE
25,51,50,1,101,50,51,3.931826,3.912023,0.01980263,7.843849,3.912023,3.931826,1,0,0,1.118,3,0.318,MORE
25,60,50,10,110,60,50,4.094345,3.912023,0.1823216,8.006368,4.094345,3.912023,0,0,1,1.244,2,0.277,MORE
25,50,57,7,107,57,50,3.912023,4.043051,0.1310283,7.955074,4.043051,3.912023,1,1,1,0.932,3,0.258,MORE
25,165,150,15,315,165,150,5.105945,5.010635,0.09531018,10.11658,5.105945,5.010635,0,0,1,1.215,2,0.25,MORE
25,159,150,9,309,159,150,5.068904,5.010635,0.05826891,10.07954,5.068904,5.010635,0,0,1,1.013,1,0.375,MORE
25,80,100,20,180,100,80,4.382027,4.60517,0.2231436,8.987197,4.60517,4.382027,1,1,1,0.764,4,0.811,MORE
25,43,50,7,93,50,43,3.7612,3.912023,0.1508229,7.673223,3.912023,3.7612,1,1,1,0.959,4,0.395,MORE
25,100,82,18,182,100,82,4.60517,4.406719,0.1984509,9.011889,4.60517,4.406719,0,0,1,1.327,3,0.37,MORE
25,123,150,27,273,150,123,4.812184,5.010635,0.1984509,9.82282,5.010635,4.812184,1,1,1,1.108,4,0.384,MORE
25,150,180,30,330,180,150,5.010635,5.192957,0.1823216,10.20359,5.192957,5.010635,1,1,1,1.477,3,0.243,MORE
25,50,42,8,92,50,42,3.912023,3.73767,0.1743534,7.649693,3.912023,3.73767,0,0,1,1.123,2,0.303,MORE
25,50,43,7,93,43,50,3.912023,3.7612,0.1508229,7.673223,3.7612,3.912023,1,0,0,1.161,3,0.226,MORE
25,50,59,9,109,59,50,3.912023,4.077537,0.1655144,7.98956,4.077537,3.912023,1,1,1,1.074,3,0.284,MORE
25,126,150,24,276,150,126,4.836282,5.010635,0.1743534,9.846917,5.010635,4.836282,1,1,1,1.183,4,0.325,MORE
25,50,60,10,110,60,50,3.912023,4.094345,0.1823216,8.006368,4.094345,3.912023,1,1,1,0.982,3,0.268,MORE
25,50,52,2,102,52,50,3.912023,3.951244,0.03922071,7.863267,3.951244,3.912023,1,1,1,1.17,3,0.241,MORE
25,174,150,24,324,174,150,5.159055,5.010635,0.14842,10.16969,5.159055,5.010635,0,0,1,1.323,2,0.369,MORE
25,44,50,6,94,50,44,3.78419,3.912023,0.1278334,7.696213,3.912023,3.78419,1,1,1,0.924,3,0.343,MORE
25,92,100,8,192,92,100,4.521789,4.60517,0.08338161,9.126959,4.521789,4.60517,0,1,0,1.256,1,0.451,MORE
25,55,50,5,105,55,50,4.007333,3.912023,0.09531018,7.919356,4.007333,3.912023,0,0,1,1.622,2,0.257,MORE
25,100,116,16,216,100,116,4.60517,4.75359,0.14842,9.35876,4.60517,4.75359,0,1,0,1.211,2,0.407,MORE
25,138,150,12,288,150,138,4.927254,5.010635,0.08338161,9.937889,5.010635,4.927254,1,1,1,1.142,3,0.293,MORE
25,100,118,18,218,118,100,4.60517,4.770685,0.1655144,9.375855,4.770685,4.60517,1,1,1,0.905,3,0.254,MORE
25,96,100,4,196,96,100,4.564348,4.60517,0.04082199,9.169518,4.564348,4.60517,0,1,0,1.123,2,0.584,MORE
25,177,150,27,327,177,150,5.17615,5.010635,0.1655144,10.18679,5.17615,5.010635,0,0,1,1.03,2,0.235,MORE
25,100,120,20,220,120,100,4.60517,4.787492,0.1823216,9.392662,4.787492,4.60517,1,1,1,1.181,3,0.2,MORE
25,92,100,8,192,92,100,4.521789,4.60517,0.08338161,9.126959,4.521789,4.60517,0,1,0,1.093,2,0.294,MORE
25,147,150,3,297,150,147,4.990433,5.010635,0.02020271,10.00107,5.010635,4.990433,1,1,1,0.989,3,0.166,MORE
25,50,40,10,90,50,40,3.912023,3.688879,0.2231436,7.600902,3.912023,3.688879,0,0,1,1.296,2,0.249,MORE
25,150,153,3,303,153,150,5.010635,5.030438,0.01980263,10.04107,5.030438,5.010635,1,1,1,1.105,3,0.187,MORE
25,100,84,16,184,100,84,4.60517,4.430817,0.1743534,9.035987,4.60517,4.430817,0,0,1,1.125,2,0.373,MORE
25,46,50,4,96,46,50,3.828641,3.912023,0.08338161,7.740664,3.828641,3.912023,0,1,0,1.734,1,0.257,MORE
25,50,45,5,95,50,45,3.912023,3.806662,0.1053605,7.718685,3.912023,3.806662,0,0,1,1.212,2,0.276,MORE
25,132,150,18,282,150,132,4.882802,5.010635,0.1278334,9.893437,5.010635,4.882802,1,1,1,1.015,4,0.44,MORE
25,150,132,18,282,132,150,5.010635,4.882802,0.1278334,9.893437,4.882802,5.010635,1,0,0,1.108,3,0.242,MORE
25,100,88,12,188,100,88,4.60517,4.477337,0.1278334,9.082507,4.60517,4.477337,0,0,1,0.725,3,0.458,MORE
25,150,141,9,291,150,141,5.010635,4.94876,0.0618754,9.959395,5.010635,4.94876,0,0,1,0.961,2,0.322,MORE
25,53,50,3,103,53,50,3.970292,3.912023,0.05826891,7.882315,3.970292,3.912023,0,0,1,1.128,2,0.353,MORE
25,58,50,8,108,58,50,4.060443,3.912023,0.14842,7.972466,4.060443,3.912023,0,0,1,0.873,2,0.328,MORE
25,57,50,7,107,50,57,4.043051,3.912023,0.1310283,7.955074,3.912023,4.043051,1,0,0,1.332,2,0.269,MORE
25,50,48,2,98,48,50,3.912023,3.871201,0.04082199,7.783224,3.871201,3.912023,1,0,0,0.982,3,0.283,MORE
25,50,58,8,108,50,58,3.912023,4.060443,0.14842,7.972466,3.912023,4.060443,0,1,0,1.266,2,0.461,MORE
25,100,80,20,180,100,80,4.60517,4.382027,0.2231436,8.987197,4.60517,4.382027,0,0,1,0.912,2,0.491,MORE
25,100,116,16,216,116,100,4.60517,4.75359,0.14842,9.35876,4.75359,4.60517,1,1,1,1.123,2,0.29,MORE
25,171,150,21,321,171,150,5.141664,5.010635,0.1310283,10.1523,5.141664,5.010635,0,0,1,1.276,1,0.418,MORE
25,52,50,2,102,50,52,3.951244,3.912023,0.03922071,7.863267,3.912023,3.951244,1,0,0,1.233,2,0.327,MORE
25,147,150,3,297,150,147,4.990433,5.010635,0.02020271,10.00107,5.010635,4.990433,1,1,1,1.109,2,0.273,MORE
25,114,100,14,214,114,100,4.736198,4.60517,0.1310283,9.341369,4.736198,4.60517,0,0,1,1.376,2,0.299,MORE
25,100,108,8,208,108,100,4.60517,4.682131,0.07696104,9.287301,4.682131,4.60517,1,1,1,1.271,3,0.35,MORE
25,156,150,6,306,150,156,5.049856,5.010635,0.03922071,10.06049,5.010635,5.049856,1,0,0,1.426,3,0.357,MORE
25,88,100,12,188,100,88,4.477337,4.60517,0.1278334,9.082507,4.60517,4.477337,1,1,1,1.056,2,0.357,MORE
25,150,162,12,312,162,150,5.010635,5.087596,0.07696104,10.09823,5.087596,5.010635,1,1,1,1.288,3,0.332,MORE
25,150,147,3,297,150,147,5.010635,4.990433,0.02020271,10.00107,5.010635,4.990433,0,0,1,1.424,3,0.2,MORE
25,42,50,8,92,50,42,3.73767,3.912023,0.1743534,7.649693,3.912023,3.73767,1,1,1,1.42,4,0.28,MORE
25,50,51,1,101,51,50,3.912023,3.931826,0.01980263,7.843849,3.931826,3.912023,1,1,1,1.299,3,0.253,MORE
25,150,138,12,288,150,138,5.010635,4.927254,0.08338161,9.937889,5.010635,4.927254,0,0,1,1.466,2,0.307,MORE
25,180,150,30,330,180,150,5.192957,5.010635,0.1823216,10.20359,5.192957,5.010635,0,0,1,1.306,3,0.459,MORE
25,159,150,9,309,159,150,5.068904,5.010635,0.05826891,10.07954,5.068904,5.010635,0,0,1,1.222,4,0.291,MORE
25,49,50,1,99,50,49,3.89182,3.912023,0.02020271,7.803843,3.912023,3.89182,1,1,1,1.444,3,0.193,MORE
25,45,50,5,95,50,45,3.806662,3.912023,0.1053605,7.718685,3.912023,3.806662,1,1,1,1.149,3,0.256,MORE
25,118,100,18,218,118,100,4.770685,4.60517,0.1655144,9.375855,4.770685,4.60517,0,0,1,1.125,3,0.189,MORE
25,82,100,18,182,100,82,4.406719,4.60517,0.1984509,9.011889,4.60517,4.406719,1,1,1,1.396,3,0.176,MORE
25,50,55,5,105,55,50,3.912023,4.007333,0.09531018,7.919356,4.007333,3.912023,1,1,1,1.079,3,0.199,MORE
25,100,94,6,194,94,100,4.60517,4.543295,0.0618754,9.148465,4.543295,4.60517,1,0,0,1.179,2,0.317,MORE
25,84,100,16,184,100,84,4.430817,4.60517,0.1743534,9.035987,4.60517,4.430817,1,1,1,0.918,2,0.324,MORE
25,150,177,27,327,177,150,5.010635,5.17615,0.1655144,10.18679,5.17615,5.010635,1,1,1,1.115,3,0.52,MORE
25,150,159,9,309,159,150,5.010635,5.068904,0.05826891,10.07954,5.068904,5.010635,1,1,1,1.012,3,0.239,MORE
25,100,104,4,204,104,100,4.60517,4.644391,0.03922071,9.249561,4.644391,4.60517,1,1,1,1.056,2,0.284,MORE
25,100,104,4,204,100,104,4.60517,4.644391,0.03922071,9.249561,4.60517,4.644391,0,1,0,1.113,2,0.311,MORE
25,50,42,8,92,50,42,3.912023,3.73767,0.1743534,7.649693,3.912023,3.73767,0,0,1,1.055,2,0.274,MORE
25,54,50,4,104,50,54,3.988984,3.912023,0.07696104,7.901007,3.912023,3.988984,1,0,0,1.152,1,0.389,MORE
25,100,108,8,208,100,108,4.60517,4.682131,0.07696104,9.287301,4.60517,4.682131,0,1,0,1.143,2,0.357,MORE
25,100,92,8,192,100,92,4.60517,4.521789,0.08338161,9.126959,4.60517,4.521789,0,0,1,0.82,2,0.351,MORE
25,50,51,1,101,51,50,3.912023,3.931826,0.01980263,7.843849,3.931826,3.912023,1,1,1,1.036,2,0.385,MORE
25,112,100,12,212,112,100,4.718499,4.60517,0.1133287,9.323669,4.718499,4.60517,0,0,1,0.947,3,0.309,MORE
25,123,150,27,273,150,123,4.812184,5.010635,0.1984509,9.82282,5.010635,4.812184,1,1,1,1.03,2,0.288,MORE
25,177,150,27,327,177,150,5.17615,5.010635,0.1655144,10.18679,5.17615,5.010635,0,0,1,1.143,2,0.285,MORE
25,100,114,14,214,114,100,4.60517,4.736198,0.1310283,9.341369,4.736198,4.60517,1,1,1,0.963,2,0.323,MORE
25,144,150,6,294,144,150,4.969813,5.010635,0.04082199,9.980449,4.969813,5.010635,0,1,0,0.979,2,0.375,MORE
25,45,50,5,95,50,45,3.806662,3.912023,0.1053605,7.718685,3.912023,3.806662,1,1,1,1.258,4,0.344,MORE
25,150,138,12,288,150,138,5.010635,4.927254,0.08338161,9.937889,5.010635,4.927254,0,0,1,1.259,3,0.255,MORE
25,150,135,15,285,150,135,5.010635,4.905275,0.1053605,9.91591,5.010635,4.905275,0,0,1,1.151,3,0.187,MORE
25,100,114,14,214,114,100,4.60517,4.736198,0.1310283,9.341369,4.736198,4.60517,1,1,1,1.161,2,0.289,MORE
25,48,50,2,98,50,48,3.871201,3.912023,0.04082199,7.783224,3.912023,3.871201,1,1,1,1.179,1,0.361,MORE
25,50,44,6,94,50,44,3.912023,3.78419,0.1278334,7.696213,3.912023,3.78419,0,0,1,1.425,2,0.303,MORE
25,150,159,9,309,159,150,5.010635,5.068904,0.05826891,10.07954,5.068904,5.010635,1,1,1,1.595,3,0.362,MORE
25,102,100,2,202,102,100,4.624973,4.60517,0.01980263,9.230143,4.624973,4.60517,0,0,1,1.658,2,0.259,MORE
25,50,41,9,91,50,41,3.912023,3.713572,0.1984509,7.625595,3.912023,3.713572,0,0,1,1.229,2,0.311,MORE
25,150,165,15,315,165,150,5.010635,5.105945,0.09531018,10.11658,5.105945,5.010635,1,1,1,1.075,2,0.242,MORE
25,100,80,20,180,80,100,4.60517,4.382027,0.2231436,8.987197,4.382027,4.60517,1,0,0,0.945,2,0.171,MORE
25,46,50,4,96,50,46,3.828641,3.912023,0.08338161,7.740664,3.912023,3.828641,1,1,1,0.765,2,0.377,MORE
25,110,100,10,210,110,100,4.70048,4.60517,0.09531018,9.305651,4.70048,4.60517,0,0,1,0.635,2,0.345,MORE
25,174,150,24,324,174,150,5.159055,5.010635,0.14842,10.16969,5.159055,5.010635,0,0,1,1.144,4,0.474,MORE
25,138,150,12,288,138,150,4.927254,5.010635,0.08338161,9.937889,4.927254,5.010635,0,1,0,1.119,1,0.317,MORE
25,100,96,4,196,100,96,4.60517,4.564348,0.04082199,9.169518,4.60517,4.564348,0,0,1,1.125,2,0.433,MORE
25,110,100,10,210,110,100,4.70048,4.60517,0.09531018,9.305651,4.70048,4.60517,0,0,1,1.103,2,0.294,MORE
25,50,54,4,104,50,54,3.912023,3.988984,0.07696104,7.901007,3.912023,3.988984,0,1,0,1.176,1,0.346,MORE
25,41,50,9,91,50,41,3.713572,3.912023,0.1984509,7.625595,3.912023,3.713572,1,1,1,1.139,2,0.393,MORE
25,150,123,27,273,150,123,5.010635,4.812184,0.1984509,9.82282,5.010635,4.812184,0,0,1,1.022,3,0.285,MORE
25,150,120,30,270,150,120,5.010635,4.787492,0.2231436,9.798127,5.010635,4.787492,0,0,1,0.978,3,0.235,MORE
25,116,100,16,216,100,116,4.75359,4.60517,0.14842,9.35876,4.60517,4.75359,1,0,0,1.062,3,0.254,MORE
25,104,100,4,204,104,100,4.644391,4.60517,0.03922071,9.249561,4.644391,4.60517,0,0,1,1.481,3,0.625,MORE
25,100,86,14,186,100,86,4.60517,4.454347,0.1508229,9.059517,4.60517,4.454347,0,0,1,1.18,2,0.34,MORE
25,50,49,1,99,50,49,3.912023,3.89182,0.02020271,7.803843,3.912023,3.89182,0,0,1,1.098,1,0.36,MORE
25,150,129,21,279,150,129,5.010635,4.859812,0.1508229,9.870448,5.010635,4.859812,0,0,1,1.095,3,0.24,MORE
25,80,100,20,180,100,80,4.382027,4.60517,0.2231436,8.987197,4.60517,4.382027,1,1,1,0.962,2,0.473,MORE
25,100,106,6,206,106,100,4.60517,4.663439,0.05826891,9.268609,4.663439,4.60517,1,1,1,1.176,2,0.316,MORE
25,100,120,20,220,120,100,4.60517,4.787492,0.1823216,9.392662,4.787492,4.60517,1,1,1,0.761,2,0.323,MORE
25,100,98,2,198,98,100,4.60517,4.584967,0.02020271,9.190138,4.584967,4.60517,1,0,0,0.883,2,0.333,MORE
25,150,162,12,312,162,150,5.010635,5.087596,0.07696104,10.09823,5.087596,5.010635,1,1,1,1.076,3,0.868,MORE
25,126,150,24,276,150,126,4.836282,5.010635,0.1743534,9.846917,5.010635,4.836282,1,1,1,0.949,3,0.284,MORE
25,86,100,14,186,100,86,4.454347,4.60517,0.1508229,9.059517,4.60517,4.454347,1,1,1,1.109,3,0.242,MORE
25,180,150,30,330,180,150,5.192957,5.010635,0.1823216,10.20359,5.192957,5.010635,0,0,1,1.12,2,0.368,MORE
25,50,47,3,97,47,50,3.912023,3.850148,0.0618754,7.762171,3.850148,3.912023,1,0,0,1.351,1,0.415,MORE
25,100,112,12,212,112,100,4.60517,4.718499,0.1133287,9.323669,4.718499,4.60517,1,1,1,1.795,3,0.235,MORE
25,135,150,15,285,135,150,4.905275,5.010635,0.1053605,9.91591,4.905275,5.010635,0,1,0,1.261,2,0.308,MORE
25,162,150,12,312,162,150,5.087596,5.010635,0.07696104,10.09823,5.087596,5.010635,0,0,1,1.678,3,0.76,MORE
25,150,135,15,285,150,135,5.010635,4.905275,0.1053605,9.91591,5.010635,4.905275,0,0,1,1.298,4,0.599,MORE
25,98,100,2,198,100,98,4.584967,4.60517,0.02020271,9.190138,4.60517,4.584967,1,1,1,1.31,3,0.559,MORE
25,150,156,6,306,156,150,5.010635,5.049856,0.03922071,10.06049,5.049856,5.010635,1,1,1,1.329,3,0.524,MORE
25,150,132,18,282,150,132,5.010635,4.882802,0.1278334,9.893437,5.010635,4.882802,0,0,1,1.498,4,0.421,MORE
25,150,126,24,276,126,150,5.010635,4.836282,0.1743534,9.846917,4.836282,5.010635,1,0,0,1.229,4,0.383,MORE
25,100,96,4,196,96,100,4.60517,4.564348,0.04082199,9.169518,4.564348,4.60517,1,0,0,1.413,2,0.744,MORE
25,55,50,5,105,50,55,4.007333,3.912023,0.09531018,7.919356,3.912023,4.007333,1,0,0,1.522,3,0.368,MORE
25,50,60,10,110,60,50,3.912023,4.094345,0.1823216,8.006368,4.094345,3.912023,1,1,1,1.167,3,0.199,MORE
25,50,48,2,98,48,50,3.912023,3.871201,0.04082199,7.783224,3.871201,3.912023,1,0,0,1.586,1,0.335,MORE
25,96,100,4,196,96,100,4.564348,4.60517,0.04082199,9.169518,4.564348,4.60517,0,1,0,1.26,3,0.434,MORE
25,100,84,16,184,100,84,4.60517,4.430817,0.1743534,9.035987,4.60517,4.430817,0,0,1,1.187,2,0.242,MORE
25,120,100,20,220,120,100,4.787492,4.60517,0.1823216,9.392662,4.787492,4.60517,0,0,1,1.064,2,0.233,MORE
25,120,100,20,220,120,100,4.787492,4.60517,0.1823216,9.392662,4.787492,4.60517,0,0,1,1.548,2,0.369,MORE
25,50,49,1,99,49,50,3.912023,3.89182,0.02020271,7.803843,3.89182,3.912023,1,0,0,1.327,3,0.279,MORE
25,41,50,9,91,50,41,3.713572,3.912023,0.1984509,7.625595,3.912023,3.713572,1,1,1,1.286,3,0.218,MORE
25,150,126,24,276,150,126,5.010635,4.836282,0.1743534,9.846917,5.010635,4.836282,0,0,1,1.439,3,0.359,MORE
25,120,150,30,270,150,120,4.787492,5.010635,0.2231436,9.798127,5.010635,4.787492,1,1,1,1.085,3,0.18,MORE
25,43,50,7,93,50,43,3.7612,3.912023,0.1508229,7.673223,3.912023,3.7612,1,1,1,1.126,3,0.16,MORE
25,141,150,9,291,150,141,4.94876,5.010635,0.0618754,9.959395,5.010635,4.94876,1,1,1,1.562,3,0.185,MORE
25,168,150,18,318,168,150,5.123964,5.010635,0.1133287,10.1346,5.123964,5.010635,0,0,1,1.222,2,0.742,MORE
25,100,102,2,202,100,102,4.60517,4.624973,0.01980263,9.230143,4.60517,4.624973,0,1,0,1.386,2,0.308,MORE
25,162,150,12,312,150,162,5.087596,5.010635,0.07696104,10.09823,5.010635,5.087596,1,0,0,1.024,2,0.231,MORE
25,144,150,6,294,150,144,4.969813,5.010635,0.04082199,9.980449,5.010635,4.969813,1,1,1,0.944,2,0.341,MORE
25,150,144,6,294,150,144,5.010635,4.969813,0.04082199,9.980449,5.010635,4.969813,0,0,1,1.126,2,0.333,MORE
25,100,90,10,190,90,100,4.60517,4.49981,0.1053605,9.10498,4.49981,4.60517,1,0,0,1.112,2,0.252,MORE
25,106,100,6,206,100,106,4.663439,4.60517,0.05826891,9.268609,4.60517,4.663439,1,0,0,0.91,1,0.529,MORE
25,150,174,24,324,174,150,5.010635,5.159055,0.14842,10.16969,5.159055,5.010635,1,1,1,0.906,2,0.252,MORE
25,82,100,18,182,100,82,4.406719,4.60517,0.1984509,9.011889,4.60517,4.406719,1,1,1,1.017,2,0.367,MORE
26,50,55,5,105,50,55,3.912023,4.007333,0.09531018,7.919356,3.912023,4.007333,0,1,0,2.016,2,2.376,MORE
26,150,171,21,321,171,150,5.010635,5.141664,0.1310283,10.1523,5.141664,5.010635,1,1,1,1.144,3,2.219,MORE
26,150,159,9,309,159,150,5.010635,5.068904,0.05826891,10.07954,5.068904,5.010635,1,1,1,1.698,3,2.117,MORE
26,82,100,18,182,100,82,4.406719,4.60517,0.1984509,9.011889,4.60517,4.406719,1,1,1,2.058,4,1.285,MORE
26,120,150,30,270,150,120,4.787492,5.010635,0.2231436,9.798127,5.010635,4.787492,1,1,1,1.69,4,2.286,MORE
26,150,159,9,309,159,150,5.010635,5.068904,0.05826891,10.07954,5.068904,5.010635,1,1,1,2.456,3,1.859,MORE
26,96,100,4,196,96,100,4.564348,4.60517,0.04082199,9.169518,4.564348,4.60517,0,1,0,2.545,2,1.603,MORE
26,57,50,7,107,57,50,4.043051,3.912023,0.1310283,7.955074,4.043051,3.912023,0,0,1,2.571,4,1.783,MORE
26,90,100,10,190,90,100,4.49981,4.60517,0.1053605,9.10498,4.49981,4.60517,0,1,0,2.051,4,2.471,MORE
26,53,50,3,103,53,50,3.970292,3.912023,0.05826891,7.882315,3.970292,3.912023,0,0,1,2.595,3,3.336,MORE
26,100,106,6,206,106,100,4.60517,4.663439,0.05826891,9.268609,4.663439,4.60517,1,1,1,2.505,2,2.192,MORE
26,150,135,15,285,150,135,5.010635,4.905275,0.1053605,9.91591,5.010635,4.905275,0,0,1,2.94,2,2.307,MORE
26,100,98,2,198,98,100,4.60517,4.584967,0.02020271,9.190138,4.584967,4.60517,1,0,0,2.272,1,2.342,MORE
26,147,150,3,297,147,150,4.990433,5.010635,0.02020271,10.00107,4.990433,5.010635,0,1,0,3.82,1,1,MORE
26,100,114,14,214,114,100,4.60517,4.736198,0.1310283,9.341369,4.736198,4.60517,1,1,1,2.627,2,1.498,MORE
26,100,102,2,202,102,100,4.60517,4.624973,0.01980263,9.230143,4.624973,4.60517,1,1,1,1.759,3,1.711,MORE
26,150,144,6,294,150,144,5.010635,4.969813,0.04082199,9.980449,5.010635,4.969813,0,0,1,1.935,2,1.855,MORE
26,49,50,1,99,50,49,3.89182,3.912023,0.02020271,7.803843,3.912023,3.89182,1,1,1,3.122,3,1.343,MORE
26,92,100,8,192,100,92,4.521789,4.60517,0.08338161,9.126959,4.60517,4.521789,1,1,1,2.731,2,2.258,MORE
26,90,100,10,190,90,100,4.49981,4.60517,0.1053605,9.10498,4.49981,4.60517,0,1,0,4.201,1,0.756,MORE
26,138,150,12,288,150,138,4.927254,5.010635,0.08338161,9.937889,5.010635,4.927254,1,1,1,1.569,3,1.901,MORE
26,94,100,6,194,100,94,4.543295,4.60517,0.0618754,9.148465,4.60517,4.543295,1,1,1,3.239,1,2.036,MORE
26,54,50,4,104,50,54,3.988984,3.912023,0.07696104,7.901007,3.912023,3.988984,1,0,0,2.985,2,1.092,MORE
26,159,150,9,309,159,150,5.068904,5.010635,0.05826891,10.07954,5.068904,5.010635,0,0,1,2.611,3,2.487,MORE
26,43,50,7,93,50,43,3.7612,3.912023,0.1508229,7.673223,3.912023,3.7612,1,1,1,3.681,4,1.17,MORE
26,86,100,14,186,100,86,4.454347,4.60517,0.1508229,9.059517,4.60517,4.454347,1,1,1,2.506,4,1.303,MORE
26,60,50,10,110,50,60,4.094345,3.912023,0.1823216,8.006368,3.912023,4.094345,1,0,0,2.387,3,1.419,MORE
26,100,86,14,186,100,86,4.60517,4.454347,0.1508229,9.059517,4.60517,4.454347,0,0,1,1.98,2,1.907,MORE
26,150,156,6,306,156,150,5.010635,5.049856,0.03922071,10.06049,5.049856,5.010635,1,1,1,2.448,4,1.294,MORE
26,150,123,27,273,150,123,5.010635,4.812184,0.1984509,9.82282,5.010635,4.812184,0,0,1,1.783,4,1.885,MORE
26,100,108,8,208,100,108,4.60517,4.682131,0.07696104,9.287301,4.60517,4.682131,0,1,0,2.894,1,1.049,MORE
26,150,162,12,312,162,150,5.010635,5.087596,0.07696104,10.09823,5.087596,5.010635,1,1,1,2.543,2,1.068,MORE
26,50,40,10,90,50,40,3.912023,3.688879,0.2231436,7.600902,3.912023,3.688879,0,0,1,1.684,3,2.204,MORE
26,177,150,27,327,177,150,5.17615,5.010635,0.1655144,10.18679,5.17615,5.010635,0,0,1,1.224,4,1.684,MORE
26,100,110,10,210,110,100,4.60517,4.70048,0.09531018,9.305651,4.70048,4.60517,1,1,1,1.57,3,1.168,MORE
26,50,42,8,92,50,42,3.912023,3.73767,0.1743534,7.649693,3.912023,3.73767,0,0,1,1.289,4,1.544,MORE
26,150,132,18,282,132,150,5.010635,4.882802,0.1278334,9.893437,4.882802,5.010635,1,0,0,2.339,1,0.803,MORE
26,100,104,4,204,104,100,4.60517,4.644391,0.03922071,9.249561,4.644391,4.60517,1,1,1,2.259,2,0.935,MORE
26,98,100,2,198,100,98,4.584967,4.60517,0.02020271,9.190138,4.60517,4.584967,1,1,1,2.167,2,1.443,MORE
26,150,147,3,297,150,147,5.010635,4.990433,0.02020271,10.00107,5.010635,4.990433,0,0,1,2.014,1,2.973,MORE
26,84,100,16,184,100,84,4.430817,4.60517,0.1743534,9.035987,4.60517,4.430817,1,1,1,3.801,3,2.034,MORE
26,50,46,4,96,50,46,3.912023,3.828641,0.08338161,7.740664,3.912023,3.828641,0,0,1,2.17,4,2.026,MORE
26,129,150,21,279,150,129,4.859812,5.010635,0.1508229,9.870448,5.010635,4.859812,1,1,1,2.262,4,1.859,MORE
26,92,100,8,192,100,92,4.521789,4.60517,0.08338161,9.126959,4.60517,4.521789,1,1,1,1.941,3,1.051,MORE
26,110,100,10,210,110,100,4.70048,4.60517,0.09531018,9.305651,4.70048,4.60517,0,0,1,4.834,2,0.454,MORE
26,150,141,9,291,150,141,5.010635,4.94876,0.0618754,9.959395,5.010635,4.94876,0,0,1,1.46,4,1.541,MORE
26,100,96,4,196,96,100,4.60517,4.564348,0.04082199,9.169518,4.564348,4.60517,1,0,0,1.582,3,1.483,MORE
26,100,108,8,208,100,108,4.60517,4.682131,0.07696104,9.287301,4.60517,4.682131,0,1,0,1.532,4,1.455,MORE
26,52,50,2,102,52,50,3.951244,3.912023,0.03922071,7.863267,3.951244,3.912023,0,0,1,3.119,1,0.955,MORE
26,129,150,21,279,150,129,4.859812,5.010635,0.1508229,9.870448,5.010635,4.859812,1,1,1,1.804,4,1.153,MORE
26,100,104,4,204,100,104,4.60517,4.644391,0.03922071,9.249561,4.60517,4.644391,0,1,0,1.887,3,1.116,MORE
26,56,50,6,106,50,56,4.025352,3.912023,0.1133287,7.937375,3.912023,4.025352,1,0,0,2.413,1,0.816,MORE
26,120,100,20,220,120,100,4.787492,4.60517,0.1823216,9.392662,4.787492,4.60517,0,0,1,1.176,3,2.103,MORE
26,40,50,10,90,50,40,3.688879,3.912023,0.2231436,7.600902,3.912023,3.688879,1,1,1,1.127,4,1.192,MORE
26,50,59,9,109,59,50,3.912023,4.077537,0.1655144,7.98956,4.077537,3.912023,1,1,1,1.166,4,0.974,MORE
26,174,150,24,324,174,150,5.159055,5.010635,0.14842,10.16969,5.159055,5.010635,0,0,1,1.17,4,1.018,MORE
26,150,168,18,318,150,168,5.010635,5.123964,0.1133287,10.1346,5.010635,5.123964,0,1,0,1.142,2,0.902,MORE
26,150,177,27,327,177,150,5.010635,5.17615,0.1655144,10.18679,5.17615,5.010635,1,1,1,1.049,3,0.992,MORE
26,50,41,9,91,41,50,3.912023,3.713572,0.1984509,7.625595,3.713572,3.912023,1,0,0,2.095,2,1.159,MORE
26,100,88,12,188,100,88,4.60517,4.477337,0.1278334,9.082507,4.60517,4.477337,0,0,1,1.424,4,1.419,MORE
26,150,123,27,273,150,123,5.010635,4.812184,0.1984509,9.82282,5.010635,4.812184,0,0,1,1.379,4,0.937,MORE
26,58,50,8,108,58,50,4.060443,3.912023,0.14842,7.972466,4.060443,3.912023,0,0,1,3.934,2,0.838,MORE
26,150,129,21,279,150,129,5.010635,4.859812,0.1508229,9.870448,5.010635,4.859812,0,0,1,1.536,2,1.339,MORE
26,40,50,10,90,50,40,3.688879,3.912023,0.2231436,7.600902,3.912023,3.688879,1,1,1,1.169,4,1.018,MORE
26,100,90,10,190,100,90,4.60517,4.49981,0.1053605,9.10498,4.60517,4.49981,0,0,1,1.383,3,1.151,MORE
26,57,50,7,107,57,50,4.043051,3.912023,0.1310283,7.955074,4.043051,3.912023,0,0,1,3.284,1,1.018,MORE
26,50,56,6,106,56,50,3.912023,4.025352,0.1133287,7.937375,4.025352,3.912023,1,1,1,1.212,3,1.022,MORE
26,168,150,18,318,168,150,5.123964,5.010635,0.1133287,10.1346,5.123964,5.010635,0,0,1,2.043,2,1.053,MORE
26,42,50,8,92,50,42,3.73767,3.912023,0.1743534,7.649693,3.912023,3.73767,1,1,1,1.135,4,1.07,MORE
26,108,100,8,208,108,100,4.682131,4.60517,0.07696104,9.287301,4.682131,4.60517,0,0,1,1.238,4,1.151,MORE
26,138,150,12,288,150,138,4.927254,5.010635,0.08338161,9.937889,5.010635,4.927254,1,1,1,3.549,2,0.516,MORE
26,106,100,6,206,100,106,4.663439,4.60517,0.05826891,9.268609,4.60517,4.663439,1,0,0,1.884,1,0.739,MORE
26,126,150,24,276,150,126,4.836282,5.010635,0.1743534,9.846917,5.010635,4.836282,1,1,1,1.19,1,0.75,MORE
26,150,132,18,282,150,132,5.010635,4.882802,0.1278334,9.893437,5.010635,4.882802,0,0,1,1.484,2,0.621,MORE
26,56,50,6,106,50,56,4.025352,3.912023,0.1133287,7.937375,3.912023,4.025352,1,0,0,1.389,2,1.043,MORE
26,100,92,8,192,92,100,4.60517,4.521789,0.08338161,9.126959,4.521789,4.60517,1,0,0,1.871,1,0.872,MORE
26,50,49,1,99,50,49,3.912023,3.89182,0.02020271,7.803843,3.912023,3.89182,0,0,1,2.675,2,0.805,MORE
26,48,50,2,98,50,48,3.871201,3.912023,0.04082199,7.783224,3.912023,3.871201,1,1,1,1.24,4,1.502,MORE
26,123,150,27,273,150,123,4.812184,5.010635,0.1984509,9.82282,5.010635,4.812184,1,1,1,1.174,3,0.776,MORE
26,100,94,6,194,100,94,4.60517,4.543295,0.0618754,9.148465,4.60517,4.543295,0,0,1,2.167,2,0.908,MORE
26,100,110,10,210,110,100,4.60517,4.70048,0.09531018,9.305651,4.70048,4.60517,1,1,1,1.091,3,0.935,MORE
26,88,100,12,188,88,100,4.477337,4.60517,0.1278334,9.082507,4.477337,4.60517,0,1,0,1.395,2,1.871,MORE
26,102,100,2,202,100,102,4.624973,4.60517,0.01980263,9.230143,4.60517,4.624973,1,0,0,1.525,2,0.768,MORE
26,100,80,20,180,100,80,4.60517,4.382027,0.2231436,8.987197,4.60517,4.382027,0,0,1,1.23,3,0.871,MORE
26,132,150,18,282,150,132,4.882802,5.010635,0.1278334,9.893437,5.010635,4.882802,1,1,1,1.358,1,1.152,MORE
26,150,168,18,318,168,150,5.010635,5.123964,0.1133287,10.1346,5.123964,5.010635,1,1,1,2.17,1,0.768,MORE
26,150,141,9,291,150,141,5.010635,4.94876,0.0618754,9.959395,5.010635,4.94876,0,0,1,1.437,2,0.85,MORE
26,171,150,21,321,171,150,5.141664,5.010635,0.1310283,10.1523,5.141664,5.010635,0,0,1,1.317,2,0.86,MORE
26,150,180,30,330,180,150,5.010635,5.192957,0.1823216,10.20359,5.192957,5.010635,1,1,1,1.537,2,1.485,MORE
26,50,43,7,93,43,50,3.912023,3.7612,0.1508229,7.673223,3.7612,3.912023,1,0,0,1.333,4,0.867,MORE
26,100,98,2,198,98,100,4.60517,4.584967,0.02020271,9.190138,4.584967,4.60517,1,0,0,2.283,3,0.701,MORE
26,108,100,8,208,100,108,4.682131,4.60517,0.07696104,9.287301,4.60517,4.682131,1,0,0,3.428,2,0.772,MORE
26,165,150,15,315,150,165,5.105945,5.010635,0.09531018,10.11658,5.010635,5.105945,1,0,0,1.725,1,0.655,MORE
26,150,138,12,288,138,150,5.010635,4.927254,0.08338161,9.937889,4.927254,5.010635,1,0,0,1.587,1,0.885,MORE
26,162,150,12,312,162,150,5.087596,5.010635,0.07696104,10.09823,5.087596,5.010635,0,0,1,1.751,2,0.86,MORE
26,50,51,1,101,51,50,3.912023,3.931826,0.01980263,7.843849,3.931826,3.912023,1,1,1,1.195,4,1.189,MORE
26,54,50,4,104,54,50,3.988984,3.912023,0.07696104,7.901007,3.988984,3.912023,0,0,1,2.142,3,0.751,MORE
26,100,102,2,202,102,100,4.60517,4.624973,0.01980263,9.230143,4.624973,4.60517,1,1,1,1.273,3,0.825,MORE
26,55,50,5,105,50,55,4.007333,3.912023,0.09531018,7.919356,3.912023,4.007333,1,0,0,1.221,3,0.607,MORE
26,156,150,6,306,156,150,5.049856,5.010635,0.03922071,10.06049,5.049856,5.010635,0,0,1,1.351,2,0.586,MORE
26,110,100,10,210,110,100,4.70048,4.60517,0.09531018,9.305651,4.70048,4.60517,0,0,1,1.233,1,0.469,MORE
26,147,150,3,297,150,147,4.990433,5.010635,0.02020271,10.00107,5.010635,4.990433,1,1,1,3.28,2,0.734,MORE
26,100,118,18,218,118,100,4.60517,4.770685,0.1655144,9.375855,4.770685,4.60517,1,1,1,1.217,3,0.537,MORE
26,150,120,30,270,150,120,5.010635,4.787492,0.2231436,9.798127,5.010635,4.787492,0,0,1,1.263,3,1.102,MORE
26,150,153,3,303,150,153,5.010635,5.030438,0.01980263,10.04107,5.010635,5.030438,0,1,0,1.409,2,0.805,MORE
26,100,112,12,212,112,100,4.60517,4.718499,0.1133287,9.323669,4.718499,4.60517,1,1,1,1.663,3,0.452,MORE
26,50,57,7,107,57,50,3.912023,4.043051,0.1310283,7.955074,4.043051,3.912023,1,1,1,1.811,4,0.736,MORE
26,153,150,3,303,153,150,5.030438,5.010635,0.01980263,10.04107,5.030438,5.010635,0,0,1,1.905,1,0.822,MORE
26,150,162,12,312,162,150,5.010635,5.087596,0.07696104,10.09823,5.087596,5.010635,1,1,1,1.143,2,1.251,MORE
26,50,58,8,108,58,50,3.912023,4.060443,0.14842,7.972466,4.060443,3.912023,1,1,1,1.247,4,0.918,MORE
26,106,100,6,206,106,100,4.663439,4.60517,0.05826891,9.268609,4.663439,4.60517,0,0,1,1.925,2,1.335,MORE
26,180,150,30,330,180,150,5.192957,5.010635,0.1823216,10.20359,5.192957,5.010635,0,0,1,1.137,3,0.991,MORE
26,50,47,3,97,47,50,3.912023,3.850148,0.0618754,7.762171,3.850148,3.912023,1,0,0,1.21,3,0.924,MORE
26,50,52,2,102,52,50,3.912023,3.951244,0.03922071,7.863267,3.951244,3.912023,1,1,1,1.806,1,0.576,MORE
26,50,60,10,110,60,50,3.912023,4.094345,0.1823216,8.006368,4.094345,3.912023,1,1,1,1.174,2,1.041,MORE
26,100,84,16,184,100,84,4.60517,4.430817,0.1743534,9.035987,4.60517,4.430817,0,0,1,1.595,1,0.653,MORE
26,50,43,7,93,43,50,3.912023,3.7612,0.1508229,7.673223,3.7612,3.912023,1,0,0,1.585,2,1.012,MORE
26,50,49,1,99,49,50,3.912023,3.89182,0.02020271,7.803843,3.89182,3.912023,1,0,0,1.211,3,0.868,MORE
26,100,120,20,220,120,100,4.60517,4.787492,0.1823216,9.392662,4.787492,4.60517,1,1,1,1.746,4,0.917,MORE
26,171,150,21,321,171,150,5.141664,5.010635,0.1310283,10.1523,5.141664,5.010635,0,0,1,1.316,2,0.866,MORE
26,150,156,6,306,156,150,5.010635,5.049856,0.03922071,10.06049,5.049856,5.010635,1,1,1,1.741,2,1.223,MORE
26,150,144,6,294,144,150,5.010635,4.969813,0.04082199,9.980449,4.969813,5.010635,1,0,0,1.575,2,0.837,MORE
26,114,100,14,214,100,114,4.736198,4.60517,0.1310283,9.341369,4.60517,4.736198,1,0,0,1.897,1,0.701,MORE
26,100,82,18,182,82,100,4.60517,4.406719,0.1984509,9.011889,4.406719,4.60517,1,0,0,1.848,2,1.384,MORE
26,48,50,2,98,50,48,3.871201,3.912023,0.04082199,7.783224,3.912023,3.871201,1,1,1,1.61,4,1.552,MORE
26,96,100,4,196,100,96,4.564348,4.60517,0.04082199,9.169518,4.60517,4.564348,1,1,1,6.159,2,1.357,MORE
26,112,100,12,212,112,100,4.718499,4.60517,0.1133287,9.323669,4.718499,4.60517,0,0,1,1.158,3,0.801,MORE
26,150,153,3,303,153,150,5.010635,5.030438,0.01980263,10.04107,5.030438,5.010635,1,1,1,1.562,2,1.091,MORE
26,150,180,30,330,180,150,5.010635,5.192957,0.1823216,10.20359,5.192957,5.010635,1,1,1,1.524,3,1.172,MORE
26,50,54,4,104,54,50,3.912023,3.988984,0.07696104,7.901007,3.988984,3.912023,1,1,1,1.19,3,0.645,MORE
26,44,50,6,94,50,44,3.78419,3.912023,0.1278334,7.696213,3.912023,3.78419,1,1,1,1.169,3,0.523,MORE
26,80,100,20,180,100,80,4.382027,4.60517,0.2231436,8.987197,4.60517,4.382027,1,1,1,1.232,2,1.083,MORE
26,100,114,14,214,114,100,4.60517,4.736198,0.1310283,9.341369,4.736198,4.60517,1,1,1,1.766,3,1.035,MORE
26,114,100,14,214,114,100,4.736198,4.60517,0.1310283,9.341369,4.736198,4.60517,0,0,1,1.447,2,0.872,MORE
26,59,50,9,109,59,50,4.077537,3.912023,0.1655144,7.98956,4.077537,3.912023,0,0,1,1.517,1,0.935,MORE
26,150,147,3,297,150,147,5.010635,4.990433,0.02020271,10.00107,5.010635,4.990433,0,0,1,1.804,2,0.634,MORE
26,100,88,12,188,100,88,4.60517,4.477337,0.1278334,9.082507,4.60517,4.477337,0,0,1,2.037,1,0.861,MORE
26,50,58,8,108,58,50,3.912023,4.060443,0.14842,7.972466,4.060443,3.912023,1,1,1,1.096,4,0.99,MORE
26,55,50,5,105,55,50,4.007333,3.912023,0.09531018,7.919356,4.007333,3.912023,0,0,1,3.774,3,0.55,MORE
26,144,150,6,294,144,150,4.969813,5.010635,0.04082199,9.980449,4.969813,5.010635,0,1,0,1.204,3,0.985,MORE
26,50,44,6,94,50,44,3.912023,3.78419,0.1278334,7.696213,3.912023,3.78419,0,0,1,6.193,2,0.45,MORE
26,165,150,15,315,165,150,5.105945,5.010635,0.09531018,10.11658,5.105945,5.010635,0,0,1,1.15,3,1.236,MORE
26,50,60,10,110,60,50,3.912023,4.094345,0.1823216,8.006368,4.094345,3.912023,1,1,1,1.245,4,1.19,MORE
26,60,50,10,110,50,60,4.094345,3.912023,0.1823216,8.006368,3.912023,4.094345,1,0,0,2.166,3,0.62,MORE
26,120,100,20,220,120,100,4.787492,4.60517,0.1823216,9.392662,4.787492,4.60517,0,0,1,1.133,3,0.925,MORE
26,162,150,12,312,162,150,5.087596,5.010635,0.07696104,10.09823,5.087596,5.010635,0,0,1,2.455,3,1.626,MORE
26,100,82,18,182,100,82,4.60517,4.406719,0.1984509,9.011889,4.60517,4.406719,0,0,1,1.196,4,0.775,MORE
26,50,44,6,94,44,50,3.912023,3.78419,0.1278334,7.696213,3.78419,3.912023,1,0,0,1.371,4,1.044,MORE
26,84,100,16,184,100,84,4.430817,4.60517,0.1743534,9.035987,4.60517,4.430817,1,1,1,1.145,4,0.8,MORE
26,45,50,5,95,50,45,3.806662,3.912023,0.1053605,7.718685,3.912023,3.806662,1,1,1,1.23,3,0.59,MORE
26,100,80,20,180,100,80,4.60517,4.382027,0.2231436,8.987197,4.60517,4.382027,0,0,1,3.527,2,0.817,MORE
26,50,42,8,92,42,50,3.912023,3.73767,0.1743534,7.649693,3.73767,3.912023,1,0,0,1.63,2,1.076,MORE
26,50,40,10,90,40,50,3.912023,3.688879,0.2231436,7.600902,3.688879,3.912023,1,0,0,1.572,1,0.867,MORE
26,180,150,30,330,180,150,5.192957,5.010635,0.1823216,10.20359,5.192957,5.010635,0,0,1,1.392,2,1.033,MORE
26,53,50,3,103,50,53,3.970292,3.912023,0.05826891,7.882315,3.912023,3.970292,1,0,0,1.19,3,0.653,MORE
26,153,150,3,303,150,153,5.030438,5.010635,0.01980263,10.04107,5.010635,5.030438,1,0,0,1.217,2,1.016,MORE
26,86,100,14,186,100,86,4.454347,4.60517,0.1508229,9.059517,4.60517,4.454347,1,1,1,1.05,3,0.554,MORE
26,59,50,9,109,50,59,4.077537,3.912023,0.1655144,7.98956,3.912023,4.077537,1,0,0,1.147,4,0.755,MORE
26,41,50,9,91,50,41,3.713572,3.912023,0.1984509,7.625595,3.912023,3.713572,1,1,1,1.135,4,0.818,MORE
26,150,171,21,321,150,171,5.010635,5.141664,0.1310283,10.1523,5.010635,5.141664,0,1,0,1.974,2,0.684,MORE
26,150,165,15,315,165,150,5.010635,5.105945,0.09531018,10.11658,5.105945,5.010635,1,1,1,1.629,3,0.918,MORE
26,100,118,18,218,118,100,4.60517,4.770685,0.1655144,9.375855,4.770685,4.60517,1,1,1,1.145,2,1.403,MORE
26,50,45,5,95,50,45,3.912023,3.806662,0.1053605,7.718685,3.912023,3.806662,0,0,1,1.627,1,1.168,MORE
26,80,100,20,180,100,80,4.382027,4.60517,0.2231436,8.987197,4.60517,4.382027,1,1,1,0.948,2,0.772,MORE
26,150,135,15,285,150,135,5.010635,4.905275,0.1053605,9.91591,5.010635,4.905275,0,0,1,2.087,2,0.968,MORE
26,150,126,24,276,150,126,5.010635,4.836282,0.1743534,9.846917,5.010635,4.836282,0,0,1,1.203,2,0.877,MORE
26,100,120,20,220,120,100,4.60517,4.787492,0.1823216,9.392662,4.787492,4.60517,1,1,1,1.378,4,0.775,MORE
26,50,48,2,98,48,50,3.912023,3.871201,0.04082199,7.783224,3.871201,3.912023,1,0,0,1.163,4,0.975,MORE
26,132,150,18,282,150,132,4.882802,5.010635,0.1278334,9.893437,5.010635,4.882802,1,1,1,1.136,4,0.843,MORE
26,123,150,27,273,150,123,4.812184,5.010635,0.1984509,9.82282,5.010635,4.812184,1,1,1,1.292,4,0.641,MORE
26,116,100,16,216,116,100,4.75359,4.60517,0.14842,9.35876,4.75359,4.60517,0,0,1,1.803,2,0.919,MORE
26,144,150,6,294,150,144,4.969813,5.010635,0.04082199,9.980449,5.010635,4.969813,1,1,1,1.827,2,0.734,MORE
26,50,59,9,109,59,50,3.912023,4.077537,0.1655144,7.98956,4.077537,3.912023,1,1,1,1.105,4,0.973,MORE
26,50,57,7,107,50,57,3.912023,4.043051,0.1310283,7.955074,3.912023,4.043051,0,1,0,1.859,1,0.936,MORE
26,156,150,6,306,150,156,5.049856,5.010635,0.03922071,10.06049,5.010635,5.049856,1,0,0,1.55,2,0.892,MORE
26,118,100,18,218,100,118,4.770685,4.60517,0.1655144,9.375855,4.60517,4.770685,1,0,0,1.222,2,0.626,MORE
26,141,150,9,291,141,150,4.94876,5.010635,0.0618754,9.959395,4.94876,5.010635,0,1,0,1.896,1,0.61,MORE
26,82,100,18,182,100,82,4.406719,4.60517,0.1984509,9.011889,4.60517,4.406719,1,1,1,1.124,4,1.101,MORE
26,100,112,12,212,112,100,4.60517,4.718499,0.1133287,9.323669,4.718499,4.60517,1,1,1,1.74,3,0.659,MORE
26,150,126,24,276,150,126,5.010635,4.836282,0.1743534,9.846917,5.010635,4.836282,0,0,1,1.473,3,1.806,MORE
26,50,53,3,103,50,53,3.912023,3.970292,0.05826891,7.882315,3.912023,3.970292,0,1,0,3.045,1,0.771,MORE
26,150,120,30,270,150,120,5.010635,4.787492,0.2231436,9.798127,5.010635,4.787492,0,0,1,2.602,2,0.949,MORE
26,88,100,12,188,100,88,4.477337,4.60517,0.1278334,9.082507,4.60517,4.477337,1,1,1,1.24,3,0.991,MORE
26,50,53,3,103,53,50,3.912023,3.970292,0.05826891,7.882315,3.970292,3.912023,1,1,1,1.243,4,1.317,MORE
26,112,100,12,212,112,100,4.718499,4.60517,0.1133287,9.323669,4.718499,4.60517,0,0,1,2.07,2,1.487,MORE
26,43,50,7,93,50,43,3.7612,3.912023,0.1508229,7.673223,3.912023,3.7612,1,1,1,1.21,4,0.634,MORE
26,150,165,15,315,150,165,5.010635,5.105945,0.09531018,10.11658,5.010635,5.105945,0,1,0,2.798,2,1.075,MORE
26,46,50,4,96,50,46,3.828641,3.912023,0.08338161,7.740664,3.912023,3.828641,1,1,1,1.143,4,1.425,MORE
26,44,50,6,94,50,44,3.78419,3.912023,0.1278334,7.696213,3.912023,3.78419,1,1,1,1.236,3,0.784,MORE
26,174,150,24,324,174,150,5.159055,5.010635,0.14842,10.16969,5.159055,5.010635,0,0,1,2.241,2,0.868,MORE
26,50,56,6,106,56,50,3.912023,4.025352,0.1133287,7.937375,4.025352,3.912023,1,1,1,1.138,4,1.507,MORE
26,51,50,1,101,50,51,3.931826,3.912023,0.01980263,7.843849,3.912023,3.931826,1,0,0,2.143,3,0.591,MORE
26,118,100,18,218,118,100,4.770685,4.60517,0.1655144,9.375855,4.770685,4.60517,0,0,1,1.505,2,0.874,MORE
26,116,100,16,216,116,100,4.75359,4.60517,0.14842,9.35876,4.75359,4.60517,0,0,1,1.34,2,0.593,MORE
26,50,45,5,95,45,50,3.912023,3.806662,0.1053605,7.718685,3.806662,3.912023,1,0,0,1.285,3,1.443,MORE
26,47,50,3,97,50,47,3.850148,3.912023,0.0618754,7.762171,3.912023,3.850148,1,1,1,1.118,3,0.574,MORE
26,50,48,2,98,48,50,3.912023,3.871201,0.04082199,7.783224,3.871201,3.912023,1,0,0,1.411,3,0.709,MORE
26,50,54,4,104,54,50,3.912023,3.988984,0.07696104,7.901007,3.988984,3.912023,1,1,1,1.1,3,0.59,MORE
26,98,100,2,198,100,98,4.584967,4.60517,0.02020271,9.190138,4.60517,4.584967,1,1,1,1.313,2,0.784,MORE
26,168,150,18,318,168,150,5.123964,5.010635,0.1133287,10.1346,5.123964,5.010635,0,0,1,1.637,1,1.018,MORE
26,100,94,6,194,100,94,4.60517,4.543295,0.0618754,9.148465,4.60517,4.543295,0,0,1,1.079,2,0.693,MORE
26,104,100,4,204,100,104,4.644391,4.60517,0.03922071,9.249561,4.60517,4.644391,1,0,0,1.303,2,0.91,MORE
26,120,150,30,270,150,120,4.787492,5.010635,0.2231436,9.798127,5.010635,4.787492,1,1,1,0.973,3,0.768,MORE
26,47,50,3,97,50,47,3.850148,3.912023,0.0618754,7.762171,3.912023,3.850148,1,1,1,1.42,4,0.469,MORE
26,50,46,4,96,46,50,3.912023,3.828641,0.08338161,7.740664,3.828641,3.912023,1,0,0,3.151,3,0.592,MORE
26,94,100,6,194,100,94,4.543295,4.60517,0.0618754,9.148465,4.60517,4.543295,1,1,1,2.434,3,0.708,MORE
26,150,177,27,327,177,150,5.010635,5.17615,0.1655144,10.18679,5.17615,5.010635,1,1,1,1.097,4,0.911,MORE
26,141,150,9,291,141,150,4.94876,5.010635,0.0618754,9.959395,4.94876,5.010635,0,1,0,1.322,2,0.683,MORE
26,150,174,24,324,174,150,5.010635,5.159055,0.14842,10.16969,5.159055,5.010635,1,1,1,1.334,3,0.592,MORE
26,100,116,16,216,100,116,4.60517,4.75359,0.14842,9.35876,4.60517,4.75359,0,1,0,2.954,1,0.603,MORE
26,49,50,1,99,50,49,3.89182,3.912023,0.02020271,7.803843,3.912023,3.89182,1,1,1,1.152,4,1.283,MORE
26,177,150,27,327,177,150,5.17615,5.010635,0.1655144,10.18679,5.17615,5.010635,0,0,1,1.042,3,1.158,MORE
26,42,50,8,92,50,42,3.73767,3.912023,0.1743534,7.649693,3.912023,3.73767,1,1,1,1.042,4,0.637,MORE
26,159,150,9,309,150,159,5.068904,5.010635,0.05826891,10.07954,5.010635,5.068904,1,0,0,1.317,2,0.97,MORE
26,126,150,24,276,150,126,4.836282,5.010635,0.1743534,9.846917,5.010635,4.836282,1,1,1,1.065,2,0.718,MORE
26,45,50,5,95,50,45,3.806662,3.912023,0.1053605,7.718685,3.912023,3.806662,1,1,1,1.043,3,1.101,MORE
26,100,96,4,196,96,100,4.60517,4.564348,0.04082199,9.169518,4.564348,4.60517,1,0,0,1.189,3,0.555,MORE
26,150,174,24,324,174,150,5.010635,5.159055,0.14842,10.16969,5.159055,5.010635,1,1,1,1.384,2,0.918,MORE
26,104,100,4,204,100,104,4.644391,4.60517,0.03922071,9.249561,4.60517,4.644391,1,0,0,1.187,3,0.534,MORE
26,50,52,2,102,50,52,3.912023,3.951244,0.03922071,7.863267,3.912023,3.951244,0,1,0,2.172,1,1.007,MORE
26,41,50,9,91,50,41,3.713572,3.912023,0.1984509,7.625595,3.912023,3.713572,1,1,1,1.055,3,0.555,MORE
26,58,50,8,108,50,58,4.060443,3.912023,0.14842,7.972466,3.912023,4.060443,1,0,0,1.819,1,0.827,MORE
26,51,50,1,101,50,51,3.931826,3.912023,0.01980263,7.843849,3.912023,3.931826,1,0,0,1.106,3,0.968,MORE
26,100,92,8,192,92,100,4.60517,4.521789,0.08338161,9.126959,4.521789,4.60517,1,0,0,1.232,2,0.952,MORE
26,150,129,21,279,150,129,5.010635,4.859812,0.1508229,9.870448,5.010635,4.859812,0,0,1,1.127,3,1.034,MORE
26,135,150,15,285,150,135,4.905275,5.010635,0.1053605,9.91591,5.010635,4.905275,1,1,1,1.04,2,0.774,MORE
26,50,55,5,105,55,50,3.912023,4.007333,0.09531018,7.919356,4.007333,3.912023,1,1,1,1.124,3,0.548,MORE
26,100,90,10,190,100,90,4.60517,4.49981,0.1053605,9.10498,4.60517,4.49981,0,0,1,1.268,2,1.234,MORE
26,100,86,14,186,100,86,4.60517,4.454347,0.1508229,9.059517,4.60517,4.454347,0,0,1,1.609,2,0.918,MORE
26,135,150,15,285,150,135,4.905275,5.010635,0.1053605,9.91591,5.010635,4.905275,1,1,1,1.488,2,0.893,MORE
26,46,50,4,96,50,46,3.828641,3.912023,0.08338161,7.740664,3.912023,3.828641,1,1,1,1.02,2,1.968,MORE
26,100,106,6,206,106,100,4.60517,4.663439,0.05826891,9.268609,4.663439,4.60517,1,1,1,1.058,3,0.853,MORE
26,52,50,2,102,50,52,3.951244,3.912023,0.03922071,7.863267,3.912023,3.951244,1,0,0,1.29,3,0.455,MORE
26,50,51,1,101,51,50,3.912023,3.931826,0.01980263,7.843849,3.931826,3.912023,1,1,1,1.051,3,0.466,MORE
26,100,84,16,184,84,100,4.60517,4.430817,0.1743534,9.035987,4.430817,4.60517,1,0,0,0.974,3,0.574,MORE
26,102,100,2,202,100,102,4.624973,4.60517,0.01980263,9.230143,4.60517,4.624973,1,0,0,0.958,3,0.739,MORE
26,50,47,3,97,47,50,3.912023,3.850148,0.0618754,7.762171,3.850148,3.912023,1,0,0,1.229,3,0.842,MORE
26,150,138,12,288,150,138,5.010635,4.927254,0.08338161,9.937889,5.010635,4.927254,0,0,1,2.951,2,0.466,MORE
26,50,41,9,91,41,50,3.912023,3.713572,0.1984509,7.625595,3.713572,3.912023,1,0,0,1.119,3,0.454,MORE
26,100,116,16,216,116,100,4.60517,4.75359,0.14842,9.35876,4.75359,4.60517,1,1,1,1.399,3,0.469,MORE
27,48,50,2,98,50,48,3.871201,3.912023,0.04082199,7.783224,3.912023,3.871201,1,1,1,1.2031,4,1.4189,MORE
27,58,50,8,108,50,58,4.060443,3.912023,0.14842,7.972466,3.912023,4.060443,1,0,0,1.4036,3,1.6446,MORE
27,168,150,18,318,168,150,5.123964,5.010635,0.1133287,10.1346,5.123964,5.010635,0,0,1,2.3093,1,1.0269,MORE
27,118,100,18,218,100,118,4.770685,4.60517,0.1655144,9.375855,4.60517,4.770685,1,0,0,1.878,2,1.0158,MORE
27,100,104,4,204,104,100,4.60517,4.644391,0.03922071,9.249561,4.644391,4.60517,1,1,1,1.5473,3,1.2334,MORE
27,47,50,3,97,50,47,3.850148,3.912023,0.0618754,7.762171,3.912023,3.850148,1,1,1,2.3953,3,0.753,MORE
27,120,100,20,220,120,100,4.787492,4.60517,0.1823216,9.392662,4.787492,4.60517,0,0,1,1.5769,4,1.4502,MORE
27,86,100,14,186,100,86,4.454347,4.60517,0.1508229,9.059517,4.60517,4.454347,1,1,1,1.5231,3,0.7981,MORE
27,150,153,3,303,153,150,5.010635,5.030438,0.01980263,10.04107,5.030438,5.010635,1,1,1,1.6062,3,1.0426,MORE
27,50,58,8,108,58,50,3.912023,4.060443,0.14842,7.972466,4.060443,3.912023,1,1,1,1.2915,4,1.0927,MORE
27,50,53,3,103,53,50,3.912023,3.970292,0.05826891,7.882315,3.970292,3.912023,1,1,1,1.4687,3,1.2067,MORE
27,150,171,21,321,171,150,5.010635,5.141664,0.1310283,10.1523,5.141664,5.010635,1,1,1,1.539,3,1.2975,MORE
27,94,100,6,194,94,100,4.543295,4.60517,0.0618754,9.148465,4.543295,4.60517,0,1,0,2.2813,1,0.7351,MORE
27,50,46,4,96,46,50,3.912023,3.828641,0.08338161,7.740664,3.828641,3.912023,1,0,0,1.4369,3,1.3592,MORE
27,100,106,6,206,106,100,4.60517,4.663439,0.05826891,9.268609,4.663439,4.60517,1,1,1,1.4756,4,1.0077,MORE
27,100,104,4,204,104,100,4.60517,4.644391,0.03922071,9.249561,4.644391,4.60517,1,1,1,1.3807,4,0.6989,MORE
27,150,123,27,273,150,123,5.010635,4.812184,0.1984509,9.82282,5.010635,4.812184,0,0,1,1.4615,3,1.2844,MORE
27,150,177,27,327,177,150,5.010635,5.17615,0.1655144,10.18679,5.17615,5.010635,1,1,1,1.422,3,0.8023,MORE
27,177,150,27,327,177,150,5.17615,5.010635,0.1655144,10.18679,5.17615,5.010635,0,0,1,1.3202,2,1.1696,MORE
27,40,50,10,90,50,40,3.688879,3.912023,0.2231436,7.600902,3.912023,3.688879,1,1,1,1.1367,4,0.7009,MORE
27,165,150,15,315,165,150,5.105945,5.010635,0.09531018,10.11658,5.105945,5.010635,0,0,1,1.1895,3,1.1943,MORE
27,100,116,16,216,116,100,4.60517,4.75359,0.14842,9.35876,4.75359,4.60517,1,1,1,1.2046,3,1.6544,MORE
27,46,50,4,96,50,46,3.828641,3.912023,0.08338161,7.740664,3.912023,3.828641,1,1,1,1.0519,4,1.3344,MORE
27,41,50,9,91,50,41,3.713572,3.912023,0.1984509,7.625595,3.912023,3.713572,1,1,1,1.2427,3,1.0996,MORE
27,100,118,18,218,118,100,4.60517,4.770685,0.1655144,9.375855,4.770685,4.60517,1,1,1,1.1565,3,1.5148,MORE
27,129,150,21,279,150,129,4.859812,5.010635,0.1508229,9.870448,5.010635,4.859812,1,1,1,1.3587,3,1.0392,MORE
27,150,120,30,270,150,120,5.010635,4.787492,0.2231436,9.798127,5.010635,4.787492,0,0,1,1.2204,3,2.068,MORE
27,82,100,18,182,100,82,4.406719,4.60517,0.1984509,9.011889,4.60517,4.406719,1,1,1,1.1165,4,2.218,MORE
27,150,174,24,324,150,174,5.010635,5.159055,0.14842,10.16969,5.010635,5.159055,0,1,0,2.3144,1,0.6979,MORE
27,150,168,18,318,168,150,5.010635,5.123964,0.1133287,10.1346,5.123964,5.010635,1,1,1,1.6467,2,0.7045,MORE
27,156,150,6,306,156,150,5.049856,5.010635,0.03922071,10.06049,5.049856,5.010635,0,0,1,1.3262,2,1.4674,MORE
27,150,156,6,306,156,150,5.010635,5.049856,0.03922071,10.06049,5.049856,5.010635,1,1,1,1.3645,3,0.7043,MORE
27,150,162,12,312,150,162,5.010635,5.087596,0.07696104,10.09823,5.010635,5.087596,0,1,0,2.137,2,0.4452,MORE
27,49,50,1,99,50,49,3.89182,3.912023,0.02020271,7.803843,3.912023,3.89182,1,1,1,1.404,3,0.8581,MORE
27,50,44,6,94,44,50,3.912023,3.78419,0.1278334,7.696213,3.78419,3.912023,1,0,0,1.7415,3,0.5016,MORE
27,100,92,8,192,100,92,4.60517,4.521789,0.08338161,9.126959,4.60517,4.521789,0,0,1,1.1297,3,0.7893,MORE
27,98,100,2,198,100,98,4.584967,4.60517,0.02020271,9.190138,4.60517,4.584967,1,1,1,1.7906,3,0.8532,MORE
27,100,88,12,188,100,88,4.60517,4.477337,0.1278334,9.082507,4.60517,4.477337,0,0,1,1.3745,2,0.5832,MORE
27,50,60,10,110,60,50,3.912023,4.094345,0.1823216,8.006368,4.094345,3.912023,1,1,1,1.2556,4,0.5574,MORE
27,100,82,18,182,100,82,4.60517,4.406719,0.1984509,9.011889,4.60517,4.406719,0,0,1,1.4272,3,0.5164,MORE
27,153,150,3,303,153,150,5.030438,5.010635,0.01980263,10.04107,5.030438,5.010635,0,0,1,1.2548,2,0.798,MORE
27,150,126,24,276,126,150,5.010635,4.836282,0.1743534,9.846917,4.836282,5.010635,1,0,0,1.295,4,0.6397,MORE
27,82,100,18,182,100,82,4.406719,4.60517,0.1984509,9.011889,4.60517,4.406719,1,1,1,1.3077,3,0.6592,MORE
27,150,165,15,315,150,165,5.010635,5.105945,0.09531018,10.11658,5.010635,5.105945,0,1,0,1.6872,1,0.5311,MORE
27,54,50,4,104,50,54,3.988984,3.912023,0.07696104,7.901007,3.912023,3.988984,1,0,0,1.1354,3,0.7684,MORE
27,50,47,3,97,47,50,3.912023,3.850148,0.0618754,7.762171,3.850148,3.912023,1,0,0,1.0392,2,1.1735,MORE
27,43,50,7,93,50,43,3.7612,3.912023,0.1508229,7.673223,3.912023,3.7612,1,1,1,1.0084,4,0.7022,MORE
27,102,100,2,202,102,100,4.624973,4.60517,0.01980263,9.230143,4.624973,4.60517,0,0,1,1.2655,3,0.6042,MORE
27,60,50,10,110,60,50,4.094345,3.912023,0.1823216,8.006368,4.094345,3.912023,0,0,1,1.8449,3,0.7511,MORE
27,162,150,12,312,162,150,5.087596,5.010635,0.07696104,10.09823,5.087596,5.010635,0,0,1,2.1359,4,0.8027,MORE
27,53,50,3,103,50,53,3.970292,3.912023,0.05826891,7.882315,3.912023,3.970292,1,0,0,1.4866,2,1.3679,MORE
27,123,150,27,273,150,123,4.812184,5.010635,0.1984509,9.82282,5.010635,4.812184,1,1,1,1.3677,3,0.6479,MORE
27,40,50,10,90,50,40,3.688879,3.912023,0.2231436,7.600902,3.912023,3.688879,1,1,1,1.2039,4,0.8292,MORE
27,52,50,2,102,50,52,3.951244,3.912023,0.03922071,7.863267,3.912023,3.951244,1,0,0,2.0168,2,1.0473,MORE
27,52,50,2,102,50,52,3.951244,3.912023,0.03922071,7.863267,3.912023,3.951244,1,0,0,1.2804,3,0.6993,MORE
27,50,40,10,90,50,40,3.912023,3.688879,0.2231436,7.600902,3.912023,3.688879,0,0,1,1.4834,3,0.6721,MORE
27,100,108,8,208,108,100,4.60517,4.682131,0.07696104,9.287301,4.682131,4.60517,1,1,1,1.2127,2,0.9595,MORE
27,45,50,5,95,50,45,3.806662,3.912023,0.1053605,7.718685,3.912023,3.806662,1,1,1,1.1145,4,0.6663,MORE
27,50,54,4,104,54,50,3.912023,3.988984,0.07696104,7.901007,3.988984,3.912023,1,1,1,1.0704,4,0.6342,MORE
27,108,100,8,208,108,100,4.682131,4.60517,0.07696104,9.287301,4.682131,4.60517,0,0,1,1.2943,3,0.6639,MORE
27,180,150,30,330,180,150,5.192957,5.010635,0.1823216,10.20359,5.192957,5.010635,0,0,1,1.2712,4,0.6042,MORE
27,41,50,9,91,50,41,3.713572,3.912023,0.1984509,7.625595,3.912023,3.713572,1,1,1,1.0707,3,0.6646,MORE
27,88,100,12,188,88,100,4.477337,4.60517,0.1278334,9.082507,4.477337,4.60517,0,1,0,2.7025,1,0.3891,MORE
27,100,88,12,188,88,100,4.60517,4.477337,0.1278334,9.082507,4.477337,4.60517,1,0,0,1.1816,2,0.6013,MORE
27,50,52,2,102,52,50,3.912023,3.951244,0.03922071,7.863267,3.951244,3.912023,1,1,1,1.103,3,0.5007,MORE
27,50,49,1,99,49,50,3.912023,3.89182,0.02020271,7.803843,3.89182,3.912023,1,0,0,1.241,3,1.4105,MORE
27,100,112,12,212,112,100,4.60517,4.718499,0.1133287,9.323669,4.718499,4.60517,1,1,1,1.6674,2,0.6321,MORE
27,150,144,6,294,150,144,5.010635,4.969813,0.04082199,9.980449,5.010635,4.969813,0,0,1,1.6849,3,0.5644,MORE
27,153,150,3,303,153,150,5.030438,5.010635,0.01980263,10.04107,5.030438,5.010635,0,0,1,1.7185,3,1.1533,MORE
27,100,98,2,198,98,100,4.60517,4.584967,0.02020271,9.190138,4.584967,4.60517,1,0,0,1.6739,2,0.89,MORE
27,50,46,4,96,46,50,3.912023,3.828641,0.08338161,7.740664,3.828641,3.912023,1,0,0,1.3236,3,0.5413,MORE
27,53,50,3,103,50,53,3.970292,3.912023,0.05826891,7.882315,3.912023,3.970292,1,0,0,1.9194,3,0.6659,MORE
27,106,100,6,206,106,100,4.663439,4.60517,0.05826891,9.268609,4.663439,4.60517,0,0,1,1.1895,4,0.5824,MORE
27,150,147,3,297,150,147,5.010635,4.990433,0.02020271,10.00107,5.010635,4.990433,0,0,1,1.3965,3,0.5405,MORE
27,150,141,9,291,150,141,5.010635,4.94876,0.0618754,9.959395,5.010635,4.94876,0,0,1,1.3331,4,0.6264,MORE
27,54,50,4,104,50,54,3.988984,3.912023,0.07696104,7.901007,3.912023,3.988984,1,0,0,1.1021,3,0.5397,MORE
27,120,100,20,220,120,100,4.787492,4.60517,0.1823216,9.392662,4.787492,4.60517,0,0,1,1.2225,3,0.5516,MORE
27,50,60,10,110,60,50,3.912023,4.094345,0.1823216,8.006368,4.094345,3.912023,1,1,1,1.186,4,0.6281,MORE
27,159,150,9,309,159,150,5.068904,5.010635,0.05826891,10.07954,5.068904,5.010635,0,0,1,1.071,3,0.5649,MORE
27,150,132,18,282,150,132,5.010635,4.882802,0.1278334,9.893437,5.010635,4.882802,0,0,1,1.9221,2,0.5332,MORE
27,100,86,14,186,100,86,4.60517,4.454347,0.1508229,9.059517,4.60517,4.454347,0,0,1,1.2694,2,0.6526,MORE
27,150,168,18,318,168,150,5.010635,5.123964,0.1133287,10.1346,5.123964,5.010635,1,1,1,1.828,3,0.3888,MORE
27,50,43,7,93,50,43,3.912023,3.7612,0.1508229,7.673223,3.912023,3.7612,0,0,1,1.3711,2,0.5407,MORE
27,51,50,1,101,50,51,3.931826,3.912023,0.01980263,7.843849,3.912023,3.931826,1,0,0,1.3191,4,0.4977,MORE
27,100,98,2,198,100,98,4.60517,4.584967,0.02020271,9.190138,4.60517,4.584967,0,0,1,1.235,4,0.6015,MORE
27,126,150,24,276,150,126,4.836282,5.010635,0.1743534,9.846917,5.010635,4.836282,1,1,1,1.115,4,1.0385,MORE
27,58,50,8,108,50,58,4.060443,3.912023,0.14842,7.972466,3.912023,4.060443,1,0,0,1.8961,3,0.4094,MORE
27,50,44,6,94,50,44,3.912023,3.78419,0.1278334,7.696213,3.912023,3.78419,0,0,1,2.6971,1,0.5025,MORE
27,49,50,1,99,50,49,3.89182,3.912023,0.02020271,7.803843,3.912023,3.89182,1,1,1,1.0582,4,0.7705,MORE
27,51,50,1,101,50,51,3.931826,3.912023,0.01980263,7.843849,3.912023,3.931826,1,0,0,2.0917,2,0.4889,MORE
27,100,84,16,184,100,84,4.60517,4.430817,0.1743534,9.035987,4.60517,4.430817,0,0,1,1.7033,3,0.5089,MORE
27,135,150,15,285,150,135,4.905275,5.010635,0.1053605,9.91591,5.010635,4.905275,1,1,1,1.1914,4,0.4363,MORE
27,56,50,6,106,50,56,4.025352,3.912023,0.1133287,7.937375,3.912023,4.025352,1,0,0,1.199,3,0.5352,MORE
27,50,40,10,90,50,40,3.912023,3.688879,0.2231436,7.600902,3.912023,3.688879,0,0,1,3.1363,2,0.3507,MORE
27,50,43,7,93,50,43,3.912023,3.7612,0.1508229,7.673223,3.912023,3.7612,0,0,1,2.3707,3,0.485,MORE
27,60,50,10,110,50,60,4.094345,3.912023,0.1823216,8.006368,3.912023,4.094345,1,0,0,2.1639,2,0.437,MORE
27,96,100,4,196,96,100,4.564348,4.60517,0.04082199,9.169518,4.564348,4.60517,0,1,0,1.4331,3,0.4516,MORE
27,50,59,9,109,59,50,3.912023,4.077537,0.1655144,7.98956,4.077537,3.912023,1,1,1,1.0541,4,0.4874,MORE
27,84,100,16,184,84,100,4.430817,4.60517,0.1743534,9.035987,4.430817,4.60517,0,1,0,1.768,3,0.4203,MORE
27,144,150,6,294,144,150,4.969813,5.010635,0.04082199,9.980449,4.969813,5.010635,0,1,0,2.148,2,0.5848,MORE
27,57,50,7,107,50,57,4.043051,3.912023,0.1310283,7.955074,3.912023,4.043051,1,0,0,1.1306,3,0.4976,MORE
27,100,106,6,206,106,100,4.60517,4.663439,0.05826891,9.268609,4.663439,4.60517,1,1,1,1.0968,4,0.6395,MORE
27,100,102,2,202,102,100,4.60517,4.624973,0.01980263,9.230143,4.624973,4.60517,1,1,1,1.1686,3,0.6512,MORE
27,120,150,30,270,150,120,4.787492,5.010635,0.2231436,9.798127,5.010635,4.787492,1,1,1,1.1418,3,1.2525,MORE
27,100,86,14,186,100,86,4.60517,4.454347,0.1508229,9.059517,4.60517,4.454347,0,0,1,1.3666,3,0.6516,MORE
27,114,100,14,214,114,100,4.736198,4.60517,0.1310283,9.341369,4.736198,4.60517,0,0,1,1.3919,3,0.6058,MORE
27,150,171,21,321,171,150,5.010635,5.141664,0.1310283,10.1523,5.141664,5.010635,1,1,1,1.0954,4,0.5347,MORE
27,50,41,9,91,41,50,3.912023,3.713572,0.1984509,7.625595,3.713572,3.912023,1,0,0,1.2123,2,0.6716,MORE
27,50,56,6,106,56,50,3.912023,4.025352,0.1133287,7.937375,4.025352,3.912023,1,1,1,1.1572,4,0.6633,MORE
27,100,110,10,210,110,100,4.60517,4.70048,0.09531018,9.305651,4.70048,4.60517,1,1,1,1.4579,3,0.4971,MORE
27,171,150,21,321,171,150,5.141664,5.010635,0.1310283,10.1523,5.141664,5.010635,0,0,1,1.3427,3,0.5315,MORE
27,102,100,2,202,100,102,4.624973,4.60517,0.01980263,9.230143,4.60517,4.624973,1,0,0,1.2696,1,2.0757,MORE
27,50,42,8,92,42,50,3.912023,3.73767,0.1743534,7.649693,3.73767,3.912023,1,0,0,1.1929,3,0.5481,MORE
27,150,177,27,327,177,150,5.010635,5.17615,0.1655144,10.18679,5.17615,5.010635,1,1,1,1.1643,3,0.6387,MORE
27,180,150,30,330,180,150,5.192957,5.010635,0.1823216,10.20359,5.192957,5.010635,0,0,1,1.3275,4,0.519,MORE
27,50,52,2,102,52,50,3.912023,3.951244,0.03922071,7.863267,3.951244,3.912023,1,1,1,1.046,4,0.582,MORE
27,50,55,5,105,55,50,3.912023,4.007333,0.09531018,7.919356,4.007333,3.912023,1,1,1,1.0561,4,0.483,MORE
27,47,50,3,97,50,47,3.850148,3.912023,0.0618754,7.762171,3.912023,3.850148,1,1,1,0.9134,4,0.6335,MORE
27,116,100,16,216,116,100,4.75359,4.60517,0.14842,9.35876,4.75359,4.60517,0,0,1,1.1218,4,0.5941,MORE
27,150,126,24,276,150,126,5.010635,4.836282,0.1743534,9.846917,5.010635,4.836282,0,0,1,1.7952,3,0.5598,MORE
27,100,94,6,194,94,100,4.60517,4.543295,0.0618754,9.148465,4.543295,4.60517,1,0,0,1.0677,4,1.0167,MORE
27,116,100,16,216,116,100,4.75359,4.60517,0.14842,9.35876,4.75359,4.60517,0,0,1,1.3051,4,0.4811,MORE
27,150,159,9,309,150,159,5.010635,5.068904,0.05826891,10.07954,5.010635,5.068904,0,1,0,2.1085,3,0.5654,MORE
27,108,100,8,208,108,100,4.682131,4.60517,0.07696104,9.287301,4.682131,4.60517,0,0,1,1.5307,3,0.5658,MORE
27,50,48,2,98,48,50,3.912023,3.871201,0.04082199,7.783224,3.871201,3.912023,1,0,0,1.1389,4,0.5839,MORE
27,100,82,18,182,82,100,4.60517,4.406719,0.1984509,9.011889,4.406719,4.60517,1,0,0,1.4172,1,2.2167,MORE
27,150,129,21,279,129,150,5.010635,4.859812,0.1508229,9.870448,4.859812,5.010635,1,0,0,1.4081,4,0.4085,MORE
27,150,147,3,297,150,147,5.010635,4.990433,0.02020271,10.00107,5.010635,4.990433,0,0,1,3.3721,2,0.4505,MORE
27,98,100,2,198,98,100,4.584967,4.60517,0.02020271,9.190138,4.584967,4.60517,0,1,0,2.2498,1,0.4239,MORE
27,96,100,4,196,100,96,4.564348,4.60517,0.04082199,9.169518,4.60517,4.564348,1,1,1,1.3079,3,0.4942,MORE
27,50,47,3,97,47,50,3.912023,3.850148,0.0618754,7.762171,3.850148,3.912023,1,0,0,1.0829,3,0.5693,MORE
27,100,84,16,184,100,84,4.60517,4.430817,0.1743534,9.035987,4.60517,4.430817,0,0,1,1.1953,4,0.5275,MORE
27,100,114,14,214,114,100,4.60517,4.736198,0.1310283,9.341369,4.736198,4.60517,1,1,1,2.2276,3,0.4853,MORE
27,50,53,3,103,53,50,3.912023,3.970292,0.05826891,7.882315,3.970292,3.912023,1,1,1,1.1757,4,0.4494,MORE
27,100,96,4,196,96,100,4.60517,4.564348,0.04082199,9.169518,4.564348,4.60517,1,0,0,3.1387,3,0.4389,MORE
27,150,174,24,324,174,150,5.010635,5.159055,0.14842,10.16969,5.159055,5.010635,1,1,1,1.7844,2,0.6184,MORE
27,50,42,8,92,42,50,3.912023,3.73767,0.1743534,7.649693,3.73767,3.912023,1,0,0,1.319,3,0.4279,MORE
27,150,120,30,270,150,120,5.010635,4.787492,0.2231436,9.798127,5.010635,4.787492,0,0,1,1.9436,4,0.469,MORE
27,120,150,30,270,150,120,4.787492,5.010635,0.2231436,9.798127,5.010635,4.787492,1,1,1,1.0789,4,0.4413,MORE
27,44,50,6,94,50,44,3.78419,3.912023,0.1278334,7.696213,3.912023,3.78419,1,1,1,1.0231,4,0.4177,MORE
27,165,150,15,315,165,150,5.105945,5.010635,0.09531018,10.11658,5.105945,5.010635,0,0,1,1.5518,4,0.4361,MORE
27,150,180,30,330,180,150,5.010635,5.192957,0.1823216,10.20359,5.192957,5.010635,1,1,1,1.9391,3,0.4236,MORE
27,100,120,20,220,120,100,4.60517,4.787492,0.1823216,9.392662,4.787492,4.60517,1,1,1,1.0647,3,0.6973,MORE
27,150,135,15,285,150,135,5.010635,4.905275,0.1053605,9.91591,5.010635,4.905275,0,0,1,1.5754,3,0.7846,MORE
27,150,144,6,294,150,144,5.010635,4.969813,0.04082199,9.980449,5.010635,4.969813,0,0,1,2.5772,2,0.604,MORE
27,150,159,9,309,159,150,5.010635,5.068904,0.05826891,10.07954,5.068904,5.010635,1,1,1,1.2149,4,0.609,MORE
27,177,150,27,327,150,177,5.17615,5.010635,0.1655144,10.18679,5.010635,5.17615,1,0,0,1.0115,4,0.6534,MORE
27,80,100,20,180,100,80,4.382027,4.60517,0.2231436,8.987197,4.60517,4.382027,1,1,1,1.6885,3,0.5329,MORE
27,100,108,8,208,108,100,4.60517,4.682131,0.07696104,9.287301,4.682131,4.60517,1,1,1,1.1888,3,0.5319,MORE
27,50,58,8,108,58,50,3.912023,4.060443,0.14842,7.972466,4.060443,3.912023,1,1,1,1.1666,4,0.3885,MORE
27,150,162,12,312,150,162,5.010635,5.087596,0.07696104,10.09823,5.010635,5.087596,0,1,0,1.9491,3,0.664,MORE
27,80,100,20,180,100,80,4.382027,4.60517,0.2231436,8.987197,4.60517,4.382027,1,1,1,1.0298,4,0.4826,MORE
27,147,150,3,297,150,147,4.990433,5.010635,0.02020271,10.00107,5.010635,4.990433,1,1,1,3.3374,1,0.4141,MORE
27,100,116,16,216,100,116,4.60517,4.75359,0.14842,9.35876,4.60517,4.75359,0,1,0,2.0097,2,0.5247,MORE
27,132,150,18,282,150,132,4.882802,5.010635,0.1278334,9.893437,5.010635,4.882802,1,1,1,1.9263,2,0.7145,MORE
27,92,100,8,192,100,92,4.521789,4.60517,0.08338161,9.126959,4.60517,4.521789,1,1,1,1.2248,3,0.5671,MORE
27,141,150,9,291,150,141,4.94876,5.010635,0.0618754,9.959395,5.010635,4.94876,1,1,1,1.2813,4,0.5506,MORE
27,106,100,6,206,100,106,4.663439,4.60517,0.05826891,9.268609,4.60517,4.663439,1,0,0,1.6664,3,0.4315,MORE
27,110,100,10,210,110,100,4.70048,4.60517,0.09531018,9.305651,4.70048,4.60517,0,0,1,2.243,2,0.5019,MORE
27,159,150,9,309,150,159,5.068904,5.010635,0.05826891,10.07954,5.010635,5.068904,1,0,0,1.1724,3,0.4388,MORE
27,123,150,27,273,123,150,4.812184,5.010635,0.1984509,9.82282,4.812184,5.010635,0,1,0,1.8086,2,0.4874,MORE
27,90,100,10,190,100,90,4.49981,4.60517,0.1053605,9.10498,4.60517,4.49981,1,1,1,1.0335,4,0.8645,MORE
27,90,100,10,190,100,90,4.49981,4.60517,0.1053605,9.10498,4.60517,4.49981,1,1,1,1.0569,4,0.4914,MORE
27,100,94,6,194,100,94,4.60517,4.543295,0.0618754,9.148465,4.60517,4.543295,0,0,1,1.5702,1,0.6491,MORE
27,150,138,12,288,138,150,5.010635,4.927254,0.08338161,9.937889,4.927254,5.010635,1,0,0,1.0906,4,0.4742,MORE
27,110,100,10,210,110,100,4.70048,4.60517,0.09531018,9.305651,4.70048,4.60517,0,0,1,1.593,2,0.5516,MORE
27,150,123,27,273,123,150,5.010635,4.812184,0.1984509,9.82282,4.812184,5.010635,1,0,0,1.0017,2,4.7578,MORE
27,44,50,6,94,50,44,3.78419,3.912023,0.1278334,7.696213,3.912023,3.78419,1,1,1,1.1171,4,0.3899,MORE
27,168,150,18,318,168,150,5.123964,5.010635,0.1133287,10.1346,5.123964,5.010635,0,0,1,1.5121,4,0.422,MORE
27,150,156,6,306,150,156,5.010635,5.049856,0.03922071,10.06049,5.010635,5.049856,0,1,0,1.1762,4,0.4876,MORE
27,174,150,24,324,174,150,5.159055,5.010635,0.14842,10.16969,5.159055,5.010635,0,0,1,1.1431,4,0.4852,MORE
27,50,51,1,101,51,50,3.912023,3.931826,0.01980263,7.843849,3.931826,3.912023,1,1,1,1.0126,4,0.5996,MORE
27,50,41,9,91,50,41,3.912023,3.713572,0.1984509,7.625595,3.912023,3.713572,0,0,1,1.8905,3,0.5924,MORE
27,112,100,12,212,112,100,4.718499,4.60517,0.1133287,9.323669,4.718499,4.60517,0,0,1,1.4306,3,0.5033,MORE
27,56,50,6,106,50,56,4.025352,3.912023,0.1133287,7.937375,3.912023,4.025352,1,0,0,1.0622,4,0.4655,MORE
27,50,51,1,101,51,50,3.912023,3.931826,0.01980263,7.843849,3.931826,3.912023,1,1,1,1.6589,3,0.5484,MORE
27,55,50,5,105,55,50,4.007333,3.912023,0.09531018,7.919356,4.007333,3.912023,0,0,1,1.6066,2,0.6661,MORE
27,118,100,18,218,100,118,4.770685,4.60517,0.1655144,9.375855,4.60517,4.770685,1,0,0,1.0806,4,0.4994,MORE
27,57,50,7,107,57,50,4.043051,3.912023,0.1310283,7.955074,4.043051,3.912023,0,0,1,1.7058,1,0.4323,MORE
27,150,141,9,291,141,150,5.010635,4.94876,0.0618754,9.959395,4.94876,5.010635,1,0,0,1.099,2,1.5671,MORE
27,171,150,21,321,171,150,5.141664,5.010635,0.1310283,10.1523,5.141664,5.010635,0,0,1,1.539,4,0.5135,MORE
27,100,90,10,190,100,90,4.60517,4.49981,0.1053605,9.10498,4.60517,4.49981,0,0,1,2.0286,3,0.4378,MORE
27,138,150,12,288,138,150,4.927254,5.010635,0.08338161,9.937889,4.927254,5.010635,0,1,0,1.4066,4,0.4586,MORE
27,50,55,5,105,55,50,3.912023,4.007333,0.09531018,7.919356,4.007333,3.912023,1,1,1,1.2863,3,0.7217,MORE
27,43,50,7,93,50,43,3.7612,3.912023,0.1508229,7.673223,3.912023,3.7612,1,1,1,1.0765,4,0.4401,MORE
27,104,100,4,204,100,104,4.644391,4.60517,0.03922071,9.249561,4.60517,4.644391,1,0,0,1.3398,4,0.432,MORE
27,162,150,12,312,162,150,5.087596,5.010635,0.07696104,10.09823,5.087596,5.010635,0,0,1,1.4317,3,0.5655,MORE
27,150,138,12,288,150,138,5.010635,4.927254,0.08338161,9.937889,5.010635,4.927254,0,0,1,2.1483,4,0.3022,MORE
27,46,50,4,96,50,46,3.828641,3.912023,0.08338161,7.740664,3.912023,3.828641,1,1,1,2.6559,1,0.5989,MORE
27,50,45,5,95,45,50,3.912023,3.806662,0.1053605,7.718685,3.806662,3.912023,1,0,0,1.6183,2,0.3824,MORE
27,132,150,18,282,150,132,4.882802,5.010635,0.1278334,9.893437,5.010635,4.882802,1,1,1,2.3691,2,0.9344,MORE
27,147,150,3,297,147,150,4.990433,5.010635,0.02020271,10.00107,4.990433,5.010635,0,1,0,2.0057,3,0.4849,MORE
27,104,100,4,204,100,104,4.644391,4.60517,0.03922071,9.249561,4.60517,4.644391,1,0,0,2.062,2,0.7664,MORE
27,50,59,9,109,59,50,3.912023,4.077537,0.1655144,7.98956,4.077537,3.912023,1,1,1,1.1367,3,0.4002,MORE
27,150,180,30,330,150,180,5.010635,5.192957,0.1823216,10.20359,5.010635,5.192957,0,1,0,1.496,4,0.4324,MORE
27,150,135,15,285,150,135,5.010635,4.905275,0.1053605,9.91591,5.010635,4.905275,0,0,1,1.5478,4,0.3689,MORE
27,126,150,24,276,150,126,4.836282,5.010635,0.1743534,9.846917,5.010635,4.836282,1,1,1,1.6408,3,0.4015,MORE
27,135,150,15,285,135,150,4.905275,5.010635,0.1053605,9.91591,4.905275,5.010635,0,1,0,1.6072,3,0.482,MORE
27,100,96,4,196,96,100,4.60517,4.564348,0.04082199,9.169518,4.564348,4.60517,1,0,0,1.1423,3,0.4171,MORE
27,50,56,6,106,56,50,3.912023,4.025352,0.1133287,7.937375,4.025352,3.912023,1,1,1,1.0207,3,0.5753,MORE
27,42,50,8,92,50,42,3.73767,3.912023,0.1743534,7.649693,3.912023,3.73767,1,1,1,1.0612,4,0.3849,MORE
27,84,100,16,184,100,84,4.430817,4.60517,0.1743534,9.035987,4.60517,4.430817,1,1,1,1.1501,3,0.4683,MORE
27,50,57,7,107,57,50,3.912023,4.043051,0.1310283,7.955074,4.043051,3.912023,1,1,1,0.9946,4,0.5352,MORE
27,112,100,12,212,112,100,4.718499,4.60517,0.1133287,9.323669,4.718499,4.60517,0,0,1,1.7805,1,0.4638,MORE
27,48,50,2,98,50,48,3.871201,3.912023,0.04082199,7.783224,3.912023,3.871201,1,1,1,1.0682,3,0.399,MORE
27,100,112,12,212,112,100,4.60517,4.718499,0.1133287,9.323669,4.718499,4.60517,1,1,1,1.0632,2,0.824,MORE
27,100,80,20,180,100,80,4.60517,4.382027,0.2231436,8.987197,4.60517,4.382027,0,0,1,1.5807,3,0.4161,MORE
27,150,153,3,303,150,153,5.010635,5.030438,0.01980263,10.04107,5.010635,5.030438,0,1,0,1.522,3,0.3669,MORE
27,94,100,6,194,100,94,4.543295,4.60517,0.0618754,9.148465,4.60517,4.543295,1,1,1,1.2311,3,0.3472,MORE
27,100,118,18,218,118,100,4.60517,4.770685,0.1655144,9.375855,4.770685,4.60517,1,1,1,1.0411,3,0.4019,MORE
27,174,150,24,324,174,150,5.159055,5.010635,0.14842,10.16969,5.159055,5.010635,0,0,1,1.3715,4,0.3664,MORE
27,141,150,9,291,150,141,4.94876,5.010635,0.0618754,9.959395,5.010635,4.94876,1,1,1,1.0588,4,0.4495,MORE
27,156,150,6,306,156,150,5.049856,5.010635,0.03922071,10.06049,5.049856,5.010635,0,0,1,1.4945,4,0.9333,MORE
27,50,57,7,107,57,50,3.912023,4.043051,0.1310283,7.955074,4.043051,3.912023,1,1,1,1.0116,3,0.5389,MORE
27,92,100,8,192,100,92,4.521789,4.60517,0.08338161,9.126959,4.60517,4.521789,1,1,1,1.3833,4,0.6901,MORE
27,42,50,8,92,50,42,3.73767,3.912023,0.1743534,7.649693,3.912023,3.73767,1,1,1,1.1153,3,0.4991,MORE
27,100,92,8,192,100,92,4.60517,4.521789,0.08338161,9.126959,4.60517,4.521789,0,0,1,1.2347,3,0.5688,MORE
27,88,100,12,188,100,88,4.477337,4.60517,0.1278334,9.082507,4.60517,4.477337,1,1,1,1.3231,3,0.7205,MORE
27,50,48,2,98,48,50,3.912023,3.871201,0.04082199,7.783224,3.871201,3.912023,1,0,0,2.3763,2,0.4492,MORE
27,100,110,10,210,110,100,4.60517,4.70048,0.09531018,9.305651,4.70048,4.60517,1,1,1,2.2151,1,0.5338,MORE
27,100,102,2,202,100,102,4.60517,4.624973,0.01980263,9.230143,4.60517,4.624973,0,1,0,1.9223,3,0.3891,MORE
27,59,50,9,109,50,59,4.077537,3.912023,0.1655144,7.98956,3.912023,4.077537,1,0,0,1.2598,3,0.3732,MORE
27,150,132,18,282,150,132,5.010635,4.882802,0.1278334,9.893437,5.010635,4.882802,0,0,1,1.6633,4,0.3165,MORE
27,150,129,21,279,150,129,5.010635,4.859812,0.1508229,9.870448,5.010635,4.859812,0,0,1,1.357,4,0.2888,MORE
27,100,120,20,220,120,100,4.60517,4.787492,0.1823216,9.392662,4.787492,4.60517,1,1,1,1.1067,4,0.6007,MORE
27,100,80,20,180,100,80,4.60517,4.382027,0.2231436,8.987197,4.60517,4.382027,0,0,1,1.5006,4,0.4946,MORE
27,50,54,4,104,54,50,3.912023,3.988984,0.07696104,7.901007,3.988984,3.912023,1,1,1,1.0943,4,0.399,MORE
27,100,114,14,214,114,100,4.60517,4.736198,0.1310283,9.341369,4.736198,4.60517,1,1,1,1.8291,3,0.4664,MORE
27,55,50,5,105,50,55,4.007333,3.912023,0.09531018,7.919356,3.912023,4.007333,1,0,0,1.0692,3,0.5893,MORE
27,86,100,14,186,100,86,4.454347,4.60517,0.1508229,9.059517,4.60517,4.454347,1,1,1,1.3066,3,0.7488,MORE
27,59,50,9,109,59,50,4.077537,3.912023,0.1655144,7.98956,4.077537,3.912023,0,0,1,1.5505,2,1.1537,MORE
27,144,150,6,294,144,150,4.969813,5.010635,0.04082199,9.980449,4.969813,5.010635,0,1,0,1.7544,3,0.5421,MORE
27,114,100,14,214,114,100,4.736198,4.60517,0.1310283,9.341369,4.736198,4.60517,0,0,1,1.5523,4,0.6027,MORE
27,150,165,15,315,165,150,5.010635,5.105945,0.09531018,10.11658,5.105945,5.010635,1,1,1,2.2086,3,0.3983,MORE
27,50,49,1,99,49,50,3.912023,3.89182,0.02020271,7.803843,3.89182,3.912023,1,0,0,1.0538,4,0.6076,MORE
27,138,150,12,288,138,150,4.927254,5.010635,0.08338161,9.937889,4.927254,5.010635,0,1,0,1.2456,4,0.4811,MORE
27,50,45,5,95,45,50,3.912023,3.806662,0.1053605,7.718685,3.806662,3.912023,1,0,0,1.0609,3,0.5233,MORE
27,100,90,10,190,100,90,4.60517,4.49981,0.1053605,9.10498,4.60517,4.49981,0,0,1,1.1596,3,0.8516,MORE
27,129,150,21,279,150,129,4.859812,5.010635,0.1508229,9.870448,5.010635,4.859812,1,1,1,1.1456,3,0.4668,MORE
27,45,50,5,95,50,45,3.806662,3.912023,0.1053605,7.718685,3.912023,3.806662,1,1,1,2.1649,3,0.6019,MORE
28,150,156,6,306,150,156,5.010635,5.049856,0.03922071,10.06049,5.010635,5.049856,0,1,0,1.1216,3,1.2683,MORE
28,50,45,5,95,50,45,3.912023,3.806662,0.1053605,7.718685,3.912023,3.806662,0,0,1,2.0053,2,1.5629,MORE
28,50,44,6,94,50,44,3.912023,3.78419,0.1278334,7.696213,3.912023,3.78419,0,0,1,1.1764,3,1.3572,MORE
28,150,165,15,315,165,150,5.010635,5.105945,0.09531018,10.11658,5.105945,5.010635,1,1,1,1.1281,4,0.7838,MORE
28,50,57,7,107,57,50,3.912023,4.043051,0.1310283,7.955074,4.043051,3.912023,1,1,1,0.9034,4,0.935,MORE
28,150,174,24,324,174,150,5.010635,5.159055,0.14842,10.16969,5.159055,5.010635,1,1,1,0.9623,3,0.9301,MORE
28,57,50,7,107,57,50,4.043051,3.912023,0.1310283,7.955074,4.043051,3.912023,0,0,1,0.9308,3,1.3536,MORE
28,150,141,9,291,141,150,5.010635,4.94876,0.0618754,9.959395,4.94876,5.010635,1,0,0,1.0814,2,0.9855,MORE
28,171,150,21,321,171,150,5.141664,5.010635,0.1310283,10.1523,5.141664,5.010635,0,0,1,1.0323,2,1.7906,MORE
28,50,42,8,92,50,42,3.912023,3.73767,0.1743534,7.649693,3.912023,3.73767,0,0,1,1.4096,3,0.7678,MORE
28,141,150,9,291,150,141,4.94876,5.010635,0.0618754,9.959395,5.010635,4.94876,1,1,1,1.0116,2,2.0134,MORE
28,100,112,12,212,112,100,4.60517,4.718499,0.1133287,9.323669,4.718499,4.60517,1,1,1,0.6557,3,1.5721,MORE
28,116,100,16,216,100,116,4.75359,4.60517,0.14842,9.35876,4.60517,4.75359,1,0,0,0.5948,3,1.2189,MORE
28,138,150,12,288,150,138,4.927254,5.010635,0.08338161,9.937889,5.010635,4.927254,1,1,1,0.7462,2,0.9598,MORE
28,108,100,8,208,108,100,4.682131,4.60517,0.07696104,9.287301,4.682131,4.60517,0,0,1,0.6639,1,0.8141,MORE
28,126,150,24,276,150,126,4.836282,5.010635,0.1743534,9.846917,5.010635,4.836282,1,1,1,0.582,3,1.6538,MORE
28,50,40,10,90,50,40,3.912023,3.688879,0.2231436,7.600902,3.912023,3.688879,0,0,1,0.8075,3,1.3649,MORE
28,50,41,9,91,41,50,3.912023,3.713572,0.1984509,7.625595,3.713572,3.912023,1,0,0,0.9865,2,1.0166,MORE
28,100,114,14,214,114,100,4.60517,4.736198,0.1310283,9.341369,4.736198,4.60517,1,1,1,0.7583,3,0.9982,MORE
28,100,96,4,196,96,100,4.60517,4.564348,0.04082199,9.169518,4.564348,4.60517,1,0,0,0.7791,3,1.3651,MORE
28,100,94,6,194,94,100,4.60517,4.543295,0.0618754,9.148465,4.543295,4.60517,1,0,0,0.5958,4,1.0015,MORE
28,150,174,24,324,174,150,5.010635,5.159055,0.14842,10.16969,5.159055,5.010635,1,1,1,0.7406,3,1.0184,MORE
28,100,94,6,194,100,94,4.60517,4.543295,0.0618754,9.148465,4.60517,4.543295,0,0,1,0.8901,2,0.9886,MORE
28,42,50,8,92,50,42,3.73767,3.912023,0.1743534,7.649693,3.912023,3.73767,1,1,1,1.012,2,1.8121,MORE
28,88,100,12,188,100,88,4.477337,4.60517,0.1278334,9.082507,4.60517,4.477337,1,1,1,0.6382,3,1.4229,MORE
28,168,150,18,318,168,150,5.123964,5.010635,0.1133287,10.1346,5.123964,5.010635,0,0,1,0.9466,1,0.735,MORE
28,150,129,21,279,129,150,5.010635,4.859812,0.1508229,9.870448,4.859812,5.010635,1,0,0,0.7345,2,1.1975,MORE
28,168,150,18,318,168,150,5.123964,5.010635,0.1133287,10.1346,5.123964,5.010635,0,0,1,0.749,2,0.8183,MORE
28,150,162,12,312,162,150,5.010635,5.087596,0.07696104,10.09823,5.087596,5.010635,1,1,1,0.6573,2,1.3526,MORE
28,126,150,24,276,150,126,4.836282,5.010635,0.1743534,9.846917,5.010635,4.836282,1,1,1,0.6006,2,0.8816,MORE
28,138,150,12,288,150,138,4.927254,5.010635,0.08338161,9.937889,5.010635,4.927254,1,1,1,0.9331,2,0.8541,MORE
28,141,150,9,291,141,150,4.94876,5.010635,0.0618754,9.959395,4.94876,5.010635,0,1,0,0.8427,2,0.9443,MORE
28,156,150,6,306,150,156,5.049856,5.010635,0.03922071,10.06049,5.010635,5.049856,1,0,0,0.9137,2,0.7641,MORE
28,60,50,10,110,60,50,4.094345,3.912023,0.1823216,8.006368,4.094345,3.912023,0,0,1,1.1121,3,0.7487,MORE
28,46,50,4,96,50,46,3.828641,3.912023,0.08338161,7.740664,3.912023,3.828641,1,1,1,0.8155,4,0.8079,MORE
28,150,144,6,294,150,144,5.010635,4.969813,0.04082199,9.980449,5.010635,4.969813,0,0,1,0.7868,2,1.1982,MORE
28,144,150,6,294,150,144,4.969813,5.010635,0.04082199,9.980449,5.010635,4.969813,1,1,1,0.786,3,0.7632,MORE
28,180,150,30,330,180,150,5.192957,5.010635,0.1823216,10.20359,5.192957,5.010635,0,0,1,0.7506,3,0.981,MORE
28,100,108,8,208,108,100,4.60517,4.682131,0.07696104,9.287301,4.682131,4.60517,1,1,1,1.0063,2,0.7416,MORE
28,100,104,4,204,100,104,4.60517,4.644391,0.03922071,9.249561,4.60517,4.644391,0,1,0,0.871,3,0.8148,MORE
28,50,59,9,109,59,50,3.912023,4.077537,0.1655144,7.98956,4.077537,3.912023,1,1,1,0.8103,4,0.7266,MORE
28,41,50,9,91,50,41,3.713572,3.912023,0.1984509,7.625595,3.912023,3.713572,1,1,1,0.9807,3,0.6649,MORE
28,44,50,6,94,50,44,3.78419,3.912023,0.1278334,7.696213,3.912023,3.78419,1,1,1,0.832,4,0.6811,MORE
28,45,50,5,95,50,45,3.806662,3.912023,0.1053605,7.718685,3.912023,3.806662,1,1,1,0.6262,3,1.2186,MORE
28,100,90,10,190,90,100,4.60517,4.49981,0.1053605,9.10498,4.49981,4.60517,1,0,0,0.9422,2,0.7018,MORE
28,80,100,20,180,80,100,4.382027,4.60517,0.2231436,8.987197,4.382027,4.60517,0,1,0,0.7608,3,0.7521,MORE
28,150,135,15,285,150,135,5.010635,4.905275,0.1053605,9.91591,5.010635,4.905275,0,0,1,0.7269,3,0.8473,MORE
28,41,50,9,91,50,41,3.713572,3.912023,0.1984509,7.625595,3.912023,3.713572,1,1,1,0.6564,4,0.7149,MORE
28,135,150,15,285,150,135,4.905275,5.010635,0.1053605,9.91591,5.010635,4.905275,1,1,1,0.7788,3,0.9236,MORE
28,150,138,12,288,150,138,5.010635,4.927254,0.08338161,9.937889,5.010635,4.927254,0,0,1,0.9605,2,0.6805,MORE
28,55,50,5,105,50,55,4.007333,3.912023,0.09531018,7.919356,3.912023,4.007333,1,0,0,0.8064,4,0.7182,MORE
28,50,59,9,109,59,50,3.912023,4.077537,0.1655144,7.98956,4.077537,3.912023,1,1,1,0.8272,3,0.7851,MORE
28,150,165,15,315,165,150,5.010635,5.105945,0.09531018,10.11658,5.105945,5.010635,1,1,1,0.8351,3,0.8503,MORE
28,51,50,1,101,50,51,3.931826,3.912023,0.01980263,7.843849,3.912023,3.931826,1,0,0,0.8963,3,0.6863,MORE
28,50,60,10,110,60,50,3.912023,4.094345,0.1823216,8.006368,4.094345,3.912023,1,1,1,0.7866,4,0.6223,MORE
28,50,47,3,97,47,50,3.912023,3.850148,0.0618754,7.762171,3.850148,3.912023,1,0,0,0.8374,2,0.7693,MORE
28,50,42,8,92,50,42,3.912023,3.73767,0.1743534,7.649693,3.912023,3.73767,0,0,1,0.9737,4,0.9551,MORE
28,54,50,4,104,54,50,3.988984,3.912023,0.07696104,7.901007,3.988984,3.912023,0,0,1,0.6872,2,0.7184,MORE
28,50,54,4,104,54,50,3.912023,3.988984,0.07696104,7.901007,3.988984,3.912023,1,1,1,0.601,3,0.715,MORE
28,150,156,6,306,156,150,5.010635,5.049856,0.03922071,10.06049,5.049856,5.010635,1,1,1,0.7754,1,0.9899,MORE
28,50,58,8,108,58,50,3.912023,4.060443,0.14842,7.972466,4.060443,3.912023,1,1,1,0.7649,3,0.781,MORE
28,100,88,12,188,100,88,4.60517,4.477337,0.1278334,9.082507,4.60517,4.477337,0,0,1,0.8269,3,0.6518,MORE
28,150,126,24,276,126,150,5.010635,4.836282,0.1743534,9.846917,4.836282,5.010635,1,0,0,0.727,2,0.7005,MORE
28,50,41,9,91,50,41,3.912023,3.713572,0.1984509,7.625595,3.912023,3.713572,0,0,1,0.832,3,0.7118,MORE
28,98,100,2,198,100,98,4.584967,4.60517,0.02020271,9.190138,4.60517,4.584967,1,1,1,0.6122,2,0.702,MORE
28,159,150,9,309,159,150,5.068904,5.010635,0.05826891,10.07954,5.068904,5.010635,0,0,1,0.7306,4,0.8012,MORE
28,120,100,20,220,120,100,4.787492,4.60517,0.1823216,9.392662,4.787492,4.60517,0,0,1,0.5978,3,1.24,MORE
28,150,159,9,309,159,150,5.010635,5.068904,0.05826891,10.07954,5.068904,5.010635,1,1,1,0.5553,3,0.8519,MORE
28,58,50,8,108,58,50,4.060443,3.912023,0.14842,7.972466,4.060443,3.912023,0,0,1,0.8621,3,0.8054,MORE
28,49,50,1,99,50,49,3.89182,3.912023,0.02020271,7.803843,3.912023,3.89182,1,1,1,1.0236,3,0.8039,MORE
28,112,100,12,212,112,100,4.718499,4.60517,0.1133287,9.323669,4.718499,4.60517,0,0,1,0.8846,3,0.6476,MORE
28,100,84,16,184,100,84,4.60517,4.430817,0.1743534,9.035987,4.60517,4.430817,0,0,1,0.8032,2,0.7184,MORE
28,57,50,7,107,50,57,4.043051,3.912023,0.1310283,7.955074,3.912023,4.043051,1,0,0,0.7004,1,0.7184,MORE
28,150,141,9,291,150,141,5.010635,4.94876,0.0618754,9.959395,5.010635,4.94876,0,0,1,0.6506,2,0.6429,MORE
28,100,92,8,192,92,100,4.60517,4.521789,0.08338161,9.126959,4.521789,4.60517,1,0,0,0.7154,3,0.6126,MORE
28,150,177,27,327,177,150,5.010635,5.17615,0.1655144,10.18679,5.17615,5.010635,1,1,1,0.5753,3,0.8231,MORE
28,100,102,2,202,100,102,4.60517,4.624973,0.01980263,9.230143,4.60517,4.624973,0,1,0,0.5635,2,0.8548,MORE
28,82,100,18,182,100,82,4.406719,4.60517,0.1984509,9.011889,4.60517,4.406719,1,1,1,0.6119,2,0.6851,MORE
28,150,168,18,318,168,150,5.010635,5.123964,0.1133287,10.1346,5.123964,5.010635,1,1,1,0.7534,2,0.9184,MORE
28,100,86,14,186,100,86,4.60517,4.454347,0.1508229,9.059517,4.60517,4.454347,0,0,1,0.6102,3,1.1987,MORE
28,162,150,12,312,162,150,5.087596,5.010635,0.07696104,10.09823,5.087596,5.010635,0,0,1,0.7084,3,0.6358,MORE
28,171,150,21,321,150,171,5.141664,5.010635,0.1310283,10.1523,5.010635,5.141664,1,0,0,0.7923,2,0.6359,MORE
28,46,50,4,96,50,46,3.828641,3.912023,0.08338161,7.740664,3.912023,3.828641,1,1,1,0.6996,3,0.8359,MORE
28,100,120,20,220,120,100,4.60517,4.787492,0.1823216,9.392662,4.787492,4.60517,1,1,1,0.7018,4,0.6214,MORE
28,100,118,18,218,118,100,4.60517,4.770685,0.1655144,9.375855,4.770685,4.60517,1,1,1,0.7008,3,0.6311,MORE
28,150,132,18,282,150,132,5.010635,4.882802,0.1278334,9.893437,5.010635,4.882802,0,0,1,0.8624,2,0.7469,MORE
28,50,54,4,104,54,50,3.912023,3.988984,0.07696104,7.901007,3.988984,3.912023,1,1,1,0.828,2,0.5991,MORE
28,108,100,8,208,108,100,4.682131,4.60517,0.07696104,9.287301,4.682131,4.60517,0,0,1,0.74,2,0.5819,MORE
28,150,159,9,309,159,150,5.010635,5.068904,0.05826891,10.07954,5.068904,5.010635,1,1,1,0.7675,3,0.5352,MORE
28,59,50,9,109,50,59,4.077537,3.912023,0.1655144,7.98956,3.912023,4.077537,1,0,0,0.8437,2,0.6485,MORE
28,150,144,6,294,144,150,5.010635,4.969813,0.04082199,9.980449,4.969813,5.010635,1,0,0,0.8026,3,0.6343,MORE
28,100,114,14,214,114,100,4.60517,4.736198,0.1310283,9.341369,4.736198,4.60517,1,1,1,0.6726,4,0.6511,MORE
28,48,50,2,98,50,48,3.871201,3.912023,0.04082199,7.783224,3.912023,3.871201,1,1,1,0.8115,2,0.6513,MORE
28,100,116,16,216,100,116,4.60517,4.75359,0.14842,9.35876,4.60517,4.75359,0,1,0,0.7975,3,0.599,MORE
28,50,56,6,106,56,50,3.912023,4.025352,0.1133287,7.937375,4.025352,3.912023,1,1,1,0.8175,1,0.5325,MORE
28,150,177,27,327,177,150,5.010635,5.17615,0.1655144,10.18679,5.17615,5.010635,1,1,1,0.7374,3,0.9017,MORE
28,53,50,3,103,53,50,3.970292,3.912023,0.05826891,7.882315,3.970292,3.912023,0,0,1,0.9361,4,0.6189,MORE
28,177,150,27,327,177,150,5.17615,5.010635,0.1655144,10.18679,5.17615,5.010635,0,0,1,0.7909,4,1.1016,MORE
28,96,100,4,196,100,96,4.564348,4.60517,0.04082199,9.169518,4.60517,4.564348,1,1,1,0.7099,3,1.0335,MORE
28,43,50,7,93,50,43,3.7612,3.912023,0.1508229,7.673223,3.912023,3.7612,1,1,1,0.7816,4,0.7818,MORE
28,50,47,3,97,50,47,3.912023,3.850148,0.0618754,7.762171,3.912023,3.850148,0,0,1,0.836,2,0.775,MORE
28,110,100,10,210,110,100,4.70048,4.60517,0.09531018,9.305651,4.70048,4.60517,0,0,1,0.5659,2,0.7169,MORE
28,86,100,14,186,100,86,4.454347,4.60517,0.1508229,9.059517,4.60517,4.454347,1,1,1,0.6282,1,0.8017,MORE
28,42,50,8,92,50,42,3.73767,3.912023,0.1743534,7.649693,3.912023,3.73767,1,1,1,0.7001,3,0.6706,MORE
28,150,168,18,318,168,150,5.010635,5.123964,0.1133287,10.1346,5.123964,5.010635,1,1,1,0.7919,4,0.6848,MORE
28,50,57,7,107,57,50,3.912023,4.043051,0.1310283,7.955074,4.043051,3.912023,1,1,1,0.7891,4,0.6465,MORE
28,153,150,3,303,150,153,5.030438,5.010635,0.01980263,10.04107,5.010635,5.030438,1,0,0,0.9067,3,1.1136,MORE
28,45,50,5,95,50,45,3.806662,3.912023,0.1053605,7.718685,3.912023,3.806662,1,1,1,0.7928,3,0.8324,MORE
28,129,150,21,279,150,129,4.859812,5.010635,0.1508229,9.870448,5.010635,4.859812,1,1,1,0.6176,3,0.6813,MORE
28,84,100,16,184,100,84,4.430817,4.60517,0.1743534,9.035987,4.60517,4.430817,1,1,1,0.8991,2,0.6184,MORE
28,100,110,10,210,110,100,4.60517,4.70048,0.09531018,9.305651,4.70048,4.60517,1,1,1,0.7277,2,0.599,MORE
28,153,150,3,303,150,153,5.030438,5.010635,0.01980263,10.04107,5.010635,5.030438,1,0,0,0.7653,3,0.5806,MORE
28,132,150,18,282,150,132,4.882802,5.010635,0.1278334,9.893437,5.010635,4.882802,1,1,1,0.8328,1,0.4105,MORE
28,129,150,21,279,150,129,4.859812,5.010635,0.1508229,9.870448,5.010635,4.859812,1,1,1,0.5792,3,0.6673,MORE
28,94,100,6,194,94,100,4.543295,4.60517,0.0618754,9.148465,4.543295,4.60517,0,1,0,0.8426,2,0.6018,MORE
28,50,51,1,101,51,50,3.912023,3.931826,0.01980263,7.843849,3.931826,3.912023,1,1,1,0.751,3,0.482,MORE
28,156,150,6,306,156,150,5.049856,5.010635,0.03922071,10.06049,5.049856,5.010635,0,0,1,0.8814,2,0.9855,MORE
28,50,48,2,98,50,48,3.912023,3.871201,0.04082199,7.783224,3.912023,3.871201,0,0,1,0.8106,3,1.116,MORE
28,100,120,20,220,120,100,4.60517,4.787492,0.1823216,9.392662,4.787492,4.60517,1,1,1,0.7295,3,0.5393,MORE
28,56,50,6,106,56,50,4.025352,3.912023,0.1133287,7.937375,4.025352,3.912023,0,0,1,0.8609,3,0.685,MORE
28,43,50,7,93,50,43,3.7612,3.912023,0.1508229,7.673223,3.912023,3.7612,1,1,1,0.6174,2,0.6928,MORE
28,50,55,5,105,55,50,3.912023,4.007333,0.09531018,7.919356,4.007333,3.912023,1,1,1,0.9003,3,0.4673,MORE
28,100,90,10,190,90,100,4.60517,4.49981,0.1053605,9.10498,4.49981,4.60517,1,0,0,0.8495,3,0.5527,MORE
28,100,80,20,180,100,80,4.60517,4.382027,0.2231436,8.987197,4.60517,4.382027,0,0,1,0.8526,3,0.5021,MORE
28,50,46,4,96,50,46,3.912023,3.828641,0.08338161,7.740664,3.912023,3.828641,0,0,1,0.8554,4,0.4976,MORE
28,94,100,6,194,100,94,4.543295,4.60517,0.0618754,9.148465,4.60517,4.543295,1,1,1,0.7711,4,0.7625,MORE
28,112,100,12,212,112,100,4.718499,4.60517,0.1133287,9.323669,4.718499,4.60517,0,0,1,0.9306,2,1.0682,MORE
28,150,153,3,303,153,150,5.010635,5.030438,0.01980263,10.04107,5.030438,5.010635,1,1,1,0.8277,2,0.5224,MORE
28,144,150,6,294,150,144,4.969813,5.010635,0.04082199,9.980449,5.010635,4.969813,1,1,1,0.8377,2,0.584,MORE
28,150,129,21,279,150,129,5.010635,4.859812,0.1508229,9.870448,5.010635,4.859812,0,0,1,0.7687,3,1.2199,MORE
28,100,104,4,204,104,100,4.60517,4.644391,0.03922071,9.249561,4.644391,4.60517,1,1,1,0.8277,2,0.565,MORE
28,174,150,24,324,174,150,5.159055,5.010635,0.14842,10.16969,5.159055,5.010635,0,0,1,0.8513,1,1.0848,MORE
28,147,150,3,297,150,147,4.990433,5.010635,0.02020271,10.00107,5.010635,4.990433,1,1,1,0.8848,3,0.6485,MORE
28,55,50,5,105,50,55,4.007333,3.912023,0.09531018,7.919356,3.912023,4.007333,1,0,0,0.8783,4,0.6146,MORE
28,177,150,27,327,150,177,5.17615,5.010635,0.1655144,10.18679,5.010635,5.17615,1,0,0,0.8118,3,0.5727,MORE
28,50,44,6,94,44,50,3.912023,3.78419,0.1278334,7.696213,3.78419,3.912023,1,0,0,0.9488,2,0.6003,MORE
28,50,56,6,106,56,50,3.912023,4.025352,0.1133287,7.937375,4.025352,3.912023,1,1,1,0.8529,4,0.6184,MORE
28,150,180,30,330,180,150,5.010635,5.192957,0.1823216,10.20359,5.192957,5.010635,1,1,1,0.8013,3,0.8358,MORE
28,50,48,2,98,48,50,3.912023,3.871201,0.04082199,7.783224,3.871201,3.912023,1,0,0,0.6606,2,0.9039,MORE
28,135,150,15,285,150,135,4.905275,5.010635,0.1053605,9.91591,5.010635,4.905275,1,1,1,0.6496,1,0.8449,MORE
28,90,100,10,190,100,90,4.49981,4.60517,0.1053605,9.10498,4.60517,4.49981,1,1,1,0.7852,3,0.6036,MORE
28,50,45,5,95,45,50,3.912023,3.806662,0.1053605,7.718685,3.806662,3.912023,1,0,0,0.616,4,0.7177,MORE
28,50,58,8,108,58,50,3.912023,4.060443,0.14842,7.972466,4.060443,3.912023,1,1,1,0.6227,3,0.6017,MORE
28,50,53,3,103,50,53,3.912023,3.970292,0.05826891,7.882315,3.912023,3.970292,0,1,0,0.6612,4,0.7315,MORE
28,100,106,6,206,106,100,4.60517,4.663439,0.05826891,9.268609,4.663439,4.60517,1,1,1,0.6831,3,0.5998,MORE
28,100,92,8,192,92,100,4.60517,4.521789,0.08338161,9.126959,4.521789,4.60517,1,0,0,0.7056,3,0.8743,MORE
28,100,110,10,210,100,110,4.60517,4.70048,0.09531018,9.305651,4.60517,4.70048,0,1,0,0.7763,2,0.6497,MORE
28,88,100,12,188,100,88,4.477337,4.60517,0.1278334,9.082507,4.60517,4.477337,1,1,1,0.6093,3,0.5687,MORE
28,114,100,14,214,114,100,4.736198,4.60517,0.1310283,9.341369,4.736198,4.60517,0,0,1,0.8835,1,1.4658,MORE
28,90,100,10,190,100,90,4.49981,4.60517,0.1053605,9.10498,4.60517,4.49981,1,1,1,0.5078,3,0.6859,MORE
28,82,100,18,182,100,82,4.406719,4.60517,0.1984509,9.011889,4.60517,4.406719,1,1,1,0.7312,4,0.6015,MORE
28,150,132,18,282,150,132,5.010635,4.882802,0.1278334,9.893437,5.010635,4.882802,0,0,1,0.7744,3,0.9909,MORE
28,50,46,4,96,46,50,3.912023,3.828641,0.08338161,7.740664,3.828641,3.912023,1,0,0,0.7024,3,0.7521,MORE
28,100,86,14,186,100,86,4.60517,4.454347,0.1508229,9.059517,4.60517,4.454347,0,0,1,0.5747,4,0.6522,MORE
28,165,150,15,315,150,165,5.105945,5.010635,0.09531018,10.11658,5.010635,5.105945,1,0,0,0.595,3,0.7352,MORE
28,100,118,18,218,118,100,4.60517,4.770685,0.1655144,9.375855,4.770685,4.60517,1,1,1,0.6108,3,0.6052,MORE
28,50,60,10,110,60,50,3.912023,4.094345,0.1823216,8.006368,4.094345,3.912023,1,1,1,0.611,4,0.6351,MORE
28,102,100,2,202,100,102,4.624973,4.60517,0.01980263,9.230143,4.60517,4.624973,1,0,0,0.672,3,0.6033,MORE
28,180,150,30,330,180,150,5.192957,5.010635,0.1823216,10.20359,5.192957,5.010635,0,0,1,0.6394,4,0.6159,MORE
28,96,100,4,196,100,96,4.564348,4.60517,0.04082199,9.169518,4.60517,4.564348,1,1,1,0.6225,3,0.8683,MORE
28,50,51,1,101,51,50,3.912023,3.931826,0.01980263,7.843849,3.931826,3.912023,1,1,1,0.6302,3,0.8728,MORE
28,100,116,16,216,116,100,4.60517,4.75359,0.14842,9.35876,4.75359,4.60517,1,1,1,0.7372,3,0.5187,MORE
28,150,180,30,330,180,150,5.010635,5.192957,0.1823216,10.20359,5.192957,5.010635,1,1,1,0.714,3,0.7075,MORE
28,50,43,7,93,50,43,3.912023,3.7612,0.1508229,7.673223,3.912023,3.7612,0,0,1,0.7003,2,0.8018,MORE
28,150,123,27,273,150,123,5.010635,4.812184,0.1984509,9.82282,5.010635,4.812184,0,0,1,0.6877,3,0.6609,MORE
28,52,50,2,102,50,52,3.951244,3.912023,0.03922071,7.863267,3.912023,3.951244,1,0,0,0.7785,2,0.6183,MORE
28,84,100,16,184,100,84,4.430817,4.60517,0.1743534,9.035987,4.60517,4.430817,1,1,1,0.6231,4,0.7017,MORE
28,100,106,6,206,100,106,4.60517,4.663439,0.05826891,9.268609,4.60517,4.663439,0,1,0,0.6449,2,0.6551,MORE
28,100,84,16,184,84,100,4.60517,4.430817,0.1743534,9.035987,4.430817,4.60517,1,0,0,0.6382,1,0.7489,MORE
28,104,100,4,204,100,104,4.644391,4.60517,0.03922071,9.249561,4.60517,4.644391,1,0,0,0.741,2,1.548,MORE
28,56,50,6,106,50,56,4.025352,3.912023,0.1133287,7.937375,3.912023,4.025352,1,0,0,0.7312,2,0.6519,MORE
28,150,171,21,321,171,150,5.010635,5.141664,0.1310283,10.1523,5.141664,5.010635,1,1,1,0.6483,4,0.6018,MORE
28,100,88,12,188,88,100,4.60517,4.477337,0.1278334,9.082507,4.477337,4.60517,1,0,0,0.8016,2,0.6959,MORE
28,60,50,10,110,50,60,4.094345,3.912023,0.1823216,8.006368,3.912023,4.094345,1,0,0,0.8657,3,0.5691,MORE
28,123,150,27,273,150,123,4.812184,5.010635,0.1984509,9.82282,5.010635,4.812184,1,1,1,0.5223,3,0.6517,MORE
28,92,100,8,192,100,92,4.521789,4.60517,0.08338161,9.126959,4.60517,4.521789,1,1,1,0.7928,2,0.4308,MORE
28,150,123,27,273,123,150,5.010635,4.812184,0.1984509,9.82282,4.812184,5.010635,1,0,0,0.8152,1,0.5055,MORE
28,150,120,30,270,150,120,5.010635,4.787492,0.2231436,9.798127,5.010635,4.787492,0,0,1,0.6758,3,0.6018,MORE
28,100,98,2,198,98,100,4.60517,4.584967,0.02020271,9.190138,4.584967,4.60517,1,0,0,0.9873,3,0.598,MORE
28,123,150,27,273,150,123,4.812184,5.010635,0.1984509,9.82282,5.010635,4.812184,1,1,1,0.5523,3,0.9785,MORE
28,150,147,3,297,147,150,5.010635,4.990433,0.02020271,10.00107,4.990433,5.010635,1,0,0,0.7059,2,0.5754,MORE
28,159,150,9,309,150,159,5.068904,5.010635,0.05826891,10.07954,5.010635,5.068904,1,0,0,0.7447,3,0.5332,MORE
28,92,100,8,192,100,92,4.521789,4.60517,0.08338161,9.126959,4.60517,4.521789,1,1,1,0.6579,2,0.6019,MORE
28,50,52,2,102,52,50,3.912023,3.951244,0.03922071,7.863267,3.951244,3.912023,1,1,1,0.7288,3,0.5672,MORE
28,54,50,4,104,50,54,3.988984,3.912023,0.07696104,7.901007,3.912023,3.988984,1,0,0,0.6318,3,0.5362,MORE
28,150,126,24,276,126,150,5.010635,4.836282,0.1743534,9.846917,4.836282,5.010635,1,0,0,0.6697,1,0.7361,MORE
28,150,120,30,270,120,150,5.010635,4.787492,0.2231436,9.798127,4.787492,5.010635,1,0,0,0.6689,3,0.5642,MORE
28,120,150,30,270,150,120,4.787492,5.010635,0.2231436,9.798127,5.010635,4.787492,1,1,1,0.6117,3,0.5403,MORE
28,114,100,14,214,114,100,4.736198,4.60517,0.1310283,9.341369,4.736198,4.60517,0,0,1,0.7634,2,1.0902,MORE
28,165,150,15,315,165,150,5.105945,5.010635,0.09531018,10.11658,5.105945,5.010635,0,0,1,0.7815,3,0.5745,MORE
28,50,43,7,93,43,50,3.912023,3.7612,0.1508229,7.673223,3.7612,3.912023,1,0,0,0.8959,4,0.4854,MORE
28,50,49,1,99,49,50,3.912023,3.89182,0.02020271,7.803843,3.89182,3.912023,1,0,0,0.8411,4,0.892,MORE
28,58,50,8,108,50,58,4.060443,3.912023,0.14842,7.972466,3.912023,4.060443,1,0,0,0.6203,1,0.9096,MORE
28,106,100,6,206,100,106,4.663439,4.60517,0.05826891,9.268609,4.60517,4.663439,1,0,0,0.6729,2,1.1915,MORE
28,110,100,10,210,110,100,4.70048,4.60517,0.09531018,9.305651,4.70048,4.60517,0,0,1,0.6538,3,0.6151,MORE
28,100,102,2,202,102,100,4.60517,4.624973,0.01980263,9.230143,4.624973,4.60517,1,1,1,0.774,3,0.6134,MORE
28,150,147,3,297,147,150,5.010635,4.990433,0.02020271,10.00107,4.990433,5.010635,1,0,0,0.6629,2,1.1553,MORE
28,49,50,1,99,50,49,3.89182,3.912023,0.02020271,7.803843,3.912023,3.89182,1,1,1,0.8602,1,0.4527,MORE
28,50,52,2,102,52,50,3.912023,3.951244,0.03922071,7.863267,3.951244,3.912023,1,1,1,0.8193,2,0.6185,MORE
28,100,80,20,180,100,80,4.60517,4.382027,0.2231436,8.987197,4.60517,4.382027,0,0,1,0.666,3,1.0363,MORE
28,44,50,6,94,44,50,3.78419,3.912023,0.1278334,7.696213,3.78419,3.912023,0,1,0,0.7918,3,0.6858,MORE
28,80,100,20,180,100,80,4.382027,4.60517,0.2231436,8.987197,4.60517,4.382027,1,1,1,0.6764,4,0.6684,MORE
28,118,100,18,218,118,100,4.770685,4.60517,0.1655144,9.375855,4.770685,4.60517,0,0,1,0.8013,3,0.6978,MORE
28,98,100,2,198,100,98,4.584967,4.60517,0.02020271,9.190138,4.60517,4.584967,1,1,1,0.5668,3,0.6688,MORE
28,50,55,5,105,50,55,3.912023,4.007333,0.09531018,7.919356,3.912023,4.007333,0,1,0,0.7987,3,0.6836,MORE
28,47,50,3,97,50,47,3.850148,3.912023,0.0618754,7.762171,3.912023,3.850148,1,1,1,0.8034,4,0.6145,MORE
28,47,50,3,97,50,47,3.850148,3.912023,0.0618754,7.762171,3.912023,3.850148,1,1,1,0.7889,3,0.5807,MORE
28,106,100,6,206,100,106,4.663439,4.60517,0.05826891,9.268609,4.60517,4.663439,1,0,0,0.755,2,0.4478,MORE
28,40,50,10,90,50,40,3.688879,3.912023,0.2231436,7.600902,3.912023,3.688879,1,1,1,0.5809,4,0.9684,MORE
28,174,150,24,324,174,150,5.159055,5.010635,0.14842,10.16969,5.159055,5.010635,0,0,1,0.6872,4,0.6848,MORE
28,59,50,9,109,50,59,4.077537,3.912023,0.1655144,7.98956,3.912023,4.077537,1,0,0,0.7371,2,0.819,MORE
28,50,40,10,90,50,40,3.912023,3.688879,0.2231436,7.600902,3.912023,3.688879,0,0,1,0.7334,1,1.0689,MORE
28,100,112,12,212,112,100,4.60517,4.718499,0.1133287,9.323669,4.718499,4.60517,1,1,1,0.4855,3,0.6957,MORE
28,150,162,12,312,162,150,5.010635,5.087596,0.07696104,10.09823,5.087596,5.010635,1,1,1,0.6983,3,0.5521,MORE
28,150,135,15,285,150,135,5.010635,4.905275,0.1053605,9.91591,5.010635,4.905275,0,0,1,0.8633,3,0.7021,MORE
28,52,50,2,102,50,52,3.951244,3.912023,0.03922071,7.863267,3.912023,3.951244,1,0,0,0.7429,2,0.6353,MORE
28,150,171,21,321,171,150,5.010635,5.141664,0.1310283,10.1523,5.141664,5.010635,1,1,1,0.7829,2,0.4522,MORE
28,100,96,4,196,96,100,4.60517,4.564348,0.04082199,9.169518,4.564348,4.60517,1,0,0,0.7723,2,0.5315,MORE
28,48,50,2,98,50,48,3.871201,3.912023,0.04082199,7.783224,3.912023,3.871201,1,1,1,0.5925,3,0.6679,MORE
28,86,100,14,186,100,86,4.454347,4.60517,0.1508229,9.059517,4.60517,4.454347,1,1,1,0.6215,3,0.5186,MORE
28,150,138,12,288,150,138,5.010635,4.927254,0.08338161,9.937889,5.010635,4.927254,0,0,1,0.7635,3,1.2349,MORE
28,100,82,18,182,100,82,4.60517,4.406719,0.1984509,9.011889,4.60517,4.406719,0,0,1,0.712,2,1.0518,MORE
28,40,50,10,90,50,40,3.688879,3.912023,0.2231436,7.600902,3.912023,3.688879,1,1,1,0.5387,2,2.2695,MORE
28,150,153,3,303,150,153,5.010635,5.030438,0.01980263,10.04107,5.010635,5.030438,0,1,0,0.7179,3,0.5852,MORE
28,50,53,3,103,53,50,3.912023,3.970292,0.05826891,7.882315,3.970292,3.912023,1,1,1,0.8248,4,0.6504,MORE
28,132,150,18,282,132,150,4.882802,5.010635,0.1278334,9.893437,4.882802,5.010635,0,1,0,0.7663,1,0.6129,MORE
28,118,100,18,218,118,100,4.770685,4.60517,0.1655144,9.375855,4.770685,4.60517,0,0,1,0.6734,3,0.5677,MORE
28,100,82,18,182,82,100,4.60517,4.406719,0.1984509,9.011889,4.406719,4.60517,1,0,0,0.8449,2,1.2834,MORE
28,147,150,3,297,150,147,4.990433,5.010635,0.02020271,10.00107,5.010635,4.990433,1,1,1,0.6226,2,2.1373,MORE
28,120,150,30,270,150,120,4.787492,5.010635,0.2231436,9.798127,5.010635,4.787492,1,1,1,0.6327,3,0.5506,MORE
28,116,100,16,216,116,100,4.75359,4.60517,0.14842,9.35876,4.75359,4.60517,0,0,1,0.7795,3,0.5823,MORE
28,53,50,3,103,50,53,3.970292,3.912023,0.05826891,7.882315,3.912023,3.970292,1,0,0,0.6876,4,0.7851,MORE
28,162,150,12,312,162,150,5.087596,5.010635,0.07696104,10.09823,5.087596,5.010635,0,0,1,0.5826,3,1.8889,MORE
28,100,98,2,198,100,98,4.60517,4.584967,0.02020271,9.190138,4.60517,4.584967,0,0,1,0.7632,2,0.9413,MORE
28,100,108,8,208,100,108,4.60517,4.682131,0.07696104,9.287301,4.60517,4.682131,0,1,0,0.74,3,0.6518,MORE
28,104,100,4,204,100,104,4.644391,4.60517,0.03922071,9.249561,4.60517,4.644391,1,0,0,0.6279,3,0.6016,MORE
28,102,100,2,202,100,102,4.624973,4.60517,0.01980263,9.230143,4.60517,4.624973,1,0,0,0.6923,2,0.5683,MORE
28,120,100,20,220,120,100,4.787492,4.60517,0.1823216,9.392662,4.787492,4.60517,0,0,1,0.5696,4,1.0547,MORE
28,50,49,1,99,49,50,3.912023,3.89182,0.02020271,7.803843,3.89182,3.912023,1,0,0,0.6589,1,2.3214,MORE
28,51,50,1,101,50,51,3.931826,3.912023,0.01980263,7.843849,3.912023,3.931826,1,0,0,0.9094,1,0.5323,MORE
29,50,45,5,95,45,50,3.912023,3.806662,0.1053605,7.718685,3.806662,3.912023,1,0,0,0.6567,1,0.792,MORE
29,50,48,2,98,48,50,3.912023,3.871201,0.04082199,7.783224,3.871201,3.912023,1,0,0,0.9806,2,0.7524,MORE
29,50,57,7,107,57,50,3.912023,4.043051,0.1310283,7.955074,4.043051,3.912023,1,1,1,0.6146,2,0.7408,MORE
29,100,86,14,186,86,100,4.60517,4.454347,0.1508229,9.059517,4.454347,4.60517,1,0,0,0.6581,2,0.458,MORE
29,150,165,15,315,165,150,5.010635,5.105945,0.09531018,10.11658,5.105945,5.010635,1,1,1,0.5997,2,0.5901,MORE
29,50,57,7,107,57,50,3.912023,4.043051,0.1310283,7.955074,4.043051,3.912023,1,1,1,0.5849,3,0.5709,MORE
29,50,42,8,92,42,50,3.912023,3.73767,0.1743534,7.649693,3.73767,3.912023,1,0,0,0.723,2,0.443,MORE
29,150,165,15,315,150,165,5.010635,5.105945,0.09531018,10.11658,5.010635,5.105945,0,1,0,0.5675,2,0.3998,MORE
29,86,100,14,186,100,86,4.454347,4.60517,0.1508229,9.059517,4.60517,4.454347,1,1,1,0.8009,2,0.647,MORE
29,100,90,10,190,100,90,4.60517,4.49981,0.1053605,9.10498,4.60517,4.49981,0,0,1,0.7368,1,0.4364,MORE
29,50,51,1,101,50,51,3.912023,3.931826,0.01980263,7.843849,3.912023,3.931826,0,1,0,1.1297,1,0.2525,MORE
29,165,150,15,315,150,165,5.105945,5.010635,0.09531018,10.11658,5.010635,5.105945,1,0,0,0.9216,2,0.7028,MORE
29,129,150,21,279,129,150,4.859812,5.010635,0.1508229,9.870448,4.859812,5.010635,0,1,0,1.2508,1,0.4623,MORE
29,100,118,18,218,118,100,4.60517,4.770685,0.1655144,9.375855,4.770685,4.60517,1,1,1,0.8368,3,0.7973,MORE
29,150,138,12,288,138,150,5.010635,4.927254,0.08338161,9.937889,4.927254,5.010635,1,0,0,0.8216,3,0.3553,MORE
29,150,174,24,324,174,150,5.010635,5.159055,0.14842,10.16969,5.159055,5.010635,1,1,1,0.7007,3,0.2757,MORE
29,50,44,6,94,44,50,3.912023,3.78419,0.1278334,7.696213,3.78419,3.912023,1,0,0,1.1645,1,0.412,MORE
29,44,50,6,94,50,44,3.78419,3.912023,0.1278334,7.696213,3.912023,3.78419,1,1,1,0.8798,1,0.3324,MORE
29,118,100,18,218,100,118,4.770685,4.60517,0.1655144,9.375855,4.60517,4.770685,1,0,0,0.9943,1,0.3249,MORE
29,50,49,1,99,50,49,3.912023,3.89182,0.02020271,7.803843,3.912023,3.89182,0,0,1,0.9853,1,0.3379,MORE
29,114,100,14,214,100,114,4.736198,4.60517,0.1310283,9.341369,4.60517,4.736198,1,0,0,0.7992,1,0.2833,MORE
29,52,50,2,102,50,52,3.951244,3.912023,0.03922071,7.863267,3.912023,3.951244,1,0,0,0.8755,1,0.2913,MORE
29,47,50,3,97,47,50,3.850148,3.912023,0.0618754,7.762171,3.850148,3.912023,0,1,0,0.9639,1,0.2553,MORE
29,50,59,9,109,59,50,3.912023,4.077537,0.1655144,7.98956,4.077537,3.912023,1,1,1,0.7605,1,0.2875,MORE
29,106,100,6,206,106,100,4.663439,4.60517,0.05826891,9.268609,4.663439,4.60517,0,0,1,1.3977,1,0.4602,MORE
29,45,50,5,95,45,50,3.806662,3.912023,0.1053605,7.718685,3.806662,3.912023,0,1,0,1.0531,1,0.2488,MORE
29,92,100,8,192,100,92,4.521789,4.60517,0.08338161,9.126959,4.60517,4.521789,1,1,1,0.6237,1,0.3435,MORE
29,153,150,3,303,150,153,5.030438,5.010635,0.01980263,10.04107,5.010635,5.030438,1,0,0,1.1123,1,0.324,MORE
29,100,106,6,206,106,100,4.60517,4.663439,0.05826891,9.268609,4.663439,4.60517,1,1,1,0.6565,1,0.2663,MORE
29,174,150,24,324,150,174,5.159055,5.010635,0.14842,10.16969,5.010635,5.159055,1,0,0,0.5465,1,0.2529,MORE
29,94,100,6,194,100,94,4.543295,4.60517,0.0618754,9.148465,4.60517,4.543295,1,1,1,0.6141,1,0.3575,MORE
29,55,50,5,105,55,50,4.007333,3.912023,0.09531018,7.919356,4.007333,3.912023,0,0,1,0.8615,1,0.2937,MORE
29,168,150,18,318,168,150,5.123964,5.010635,0.1133287,10.1346,5.123964,5.010635,0,0,1,0.8776,1,0.2317,MORE
29,162,150,12,312,150,162,5.087596,5.010635,0.07696104,10.09823,5.010635,5.087596,1,0,0,0.6047,1,0.3771,MORE
29,50,48,2,98,50,48,3.912023,3.871201,0.04082199,7.783224,3.912023,3.871201,0,0,1,0.8457,1,0.2762,MORE
29,50,40,10,90,50,40,3.912023,3.688879,0.2231436,7.600902,3.912023,3.688879,0,0,1,0.8862,1,0.2462,MORE
29,50,58,8,108,58,50,3.912023,4.060443,0.14842,7.972466,4.060443,3.912023,1,1,1,0.7169,1,0.3178,MORE
29,100,112,12,212,112,100,4.60517,4.718499,0.1133287,9.323669,4.718499,4.60517,1,1,1,0.5895,1,0.2307,MORE
29,150,135,15,285,150,135,5.010635,4.905275,0.1053605,9.91591,5.010635,4.905275,0,0,1,0.7115,1,0.2425,MORE
29,150,168,18,318,168,150,5.010635,5.123964,0.1133287,10.1346,5.123964,5.010635,1,1,1,0.7132,1,0.2763,MORE
29,150,123,27,273,150,123,5.010635,4.812184,0.1984509,9.82282,5.010635,4.812184,0,0,1,0.8192,1,0.2535,MORE
29,100,94,6,194,100,94,4.60517,4.543295,0.0618754,9.148465,4.60517,4.543295,0,0,1,1.1255,1,0.2421,MORE
29,138,150,12,288,150,138,4.927254,5.010635,0.08338161,9.937889,5.010635,4.927254,1,1,1,0.6957,1,0.2685,MORE
29,55,50,5,105,55,50,4.007333,3.912023,0.09531018,7.919356,4.007333,3.912023,0,0,1,0.8094,1,0.2546,MORE
29,150,120,30,270,120,150,5.010635,4.787492,0.2231436,9.798127,4.787492,5.010635,1,0,0,0.7008,1,0.2377,MORE
29,150,138,12,288,138,150,5.010635,4.927254,0.08338161,9.937889,4.927254,5.010635,1,0,0,0.5282,1,0.2384,MORE
29,59,50,9,109,59,50,4.077537,3.912023,0.1655144,7.98956,4.077537,3.912023,0,0,1,0.6299,1,0.2931,MORE
29,50,60,10,110,50,60,3.912023,4.094345,0.1823216,8.006368,3.912023,4.094345,0,1,0,0.8078,1,0.2756,MORE
29,41,50,9,91,50,41,3.713572,3.912023,0.1984509,7.625595,3.912023,3.713572,1,1,1,0.6663,1,0.2917,MORE
29,112,100,12,212,100,112,4.718499,4.60517,0.1133287,9.323669,4.60517,4.718499,1,0,0,0.8039,1,0.2135,MORE
29,150,156,6,306,156,150,5.010635,5.049856,0.03922071,10.06049,5.049856,5.010635,1,1,1,0.6212,1,0.2676,MORE
29,100,112,12,212,112,100,4.60517,4.718499,0.1133287,9.323669,4.718499,4.60517,1,1,1,0.5304,1,0.2993,MORE
29,100,80,20,180,100,80,4.60517,4.382027,0.2231436,8.987197,4.60517,4.382027,0,0,1,0.5421,1,0.2946,MORE
29,147,150,3,297,150,147,4.990433,5.010635,0.02020271,10.00107,5.010635,4.990433,1,1,1,0.7725,1,0.2967,MORE
29,120,100,20,220,120,100,4.787492,4.60517,0.1823216,9.392662,4.787492,4.60517,0,0,1,0.6054,1,0.3005,MORE
29,104,100,4,204,100,104,4.644391,4.60517,0.03922071,9.249561,4.60517,4.644391,1,0,0,0.6636,1,0.2442,MORE
29,58,50,8,108,50,58,4.060443,3.912023,0.14842,7.972466,3.912023,4.060443,1,0,0,0.87,1,0.2607,MORE
29,54,50,4,104,54,50,3.988984,3.912023,0.07696104,7.901007,3.988984,3.912023,0,0,1,1.1968,1,0.2478,MORE
29,144,150,6,294,150,144,4.969813,5.010635,0.04082199,9.980449,5.010635,4.969813,1,1,1,0.5872,1,0.3007,MORE
29,42,50,8,92,50,42,3.73767,3.912023,0.1743534,7.649693,3.912023,3.73767,1,1,1,0.8436,1,0.2751,MORE
29,100,84,16,184,84,100,4.60517,4.430817,0.1743534,9.035987,4.430817,4.60517,1,0,0,0.5747,1,0.2765,MORE
29,132,150,18,282,150,132,4.882802,5.010635,0.1278334,9.893437,5.010635,4.882802,1,1,1,0.5611,1,0.2843,MORE
29,150,129,21,279,150,129,5.010635,4.859812,0.1508229,9.870448,5.010635,4.859812,0,0,1,0.6234,1,0.3258,MORE
29,150,120,30,270,120,150,5.010635,4.787492,0.2231436,9.798127,4.787492,5.010635,1,0,0,0.6773,1,0.2783,MORE
29,110,100,10,210,110,100,4.70048,4.60517,0.09531018,9.305651,4.70048,4.60517,0,0,1,0.6567,1,0.2673,MORE
29,171,150,21,321,171,150,5.141664,5.010635,0.1310283,10.1523,5.141664,5.010635,0,0,1,0.687,1,0.3299,MORE
29,82,100,18,182,100,82,4.406719,4.60517,0.1984509,9.011889,4.60517,4.406719,1,1,1,0.4449,1,0.3301,MORE
29,150,147,3,297,147,150,5.010635,4.990433,0.02020271,10.00107,4.990433,5.010635,1,0,0,0.526,1,0.3199,MORE
29,50,46,4,96,46,50,3.912023,3.828641,0.08338161,7.740664,3.828641,3.912023,1,0,0,1.1005,1,0.162,MORE
29,150,177,27,327,177,150,5.010635,5.17615,0.1655144,10.18679,5.17615,5.010635,1,1,1,0.5648,1,0.2136,MORE
29,50,55,5,105,55,50,3.912023,4.007333,0.09531018,7.919356,4.007333,3.912023,1,1,1,0.6343,1,0.2767,MORE
29,80,100,20,180,100,80,4.382027,4.60517,0.2231436,8.987197,4.60517,4.382027,1,1,1,0.5209,1,0.228,MORE
29,100,104,4,204,100,104,4.60517,4.644391,0.03922071,9.249561,4.60517,4.644391,0,1,0,0.7095,1,0.1945,MORE
29,135,150,15,285,150,135,4.905275,5.010635,0.1053605,9.91591,5.010635,4.905275,1,1,1,0.6337,1,0.1508,MORE
29,45,50,5,95,45,50,3.806662,3.912023,0.1053605,7.718685,3.806662,3.912023,0,1,0,1.0554,1,0.1861,MORE
29,150,144,6,294,144,150,5.010635,4.969813,0.04082199,9.980449,4.969813,5.010635,1,0,0,0.5363,1,0.2637,MORE
29,96,100,4,196,100,96,4.564348,4.60517,0.04082199,9.169518,4.60517,4.564348,1,1,1,0.6137,1,0.2916,MORE
29,100,92,8,192,92,100,4.60517,4.521789,0.08338161,9.126959,4.521789,4.60517,1,0,0,0.712,1,0.2415,MORE
29,94,100,6,194,100,94,4.543295,4.60517,0.0618754,9.148465,4.60517,4.543295,1,1,1,0.5825,1,0.2386,MORE
29,42,50,8,92,50,42,3.73767,3.912023,0.1743534,7.649693,3.912023,3.73767,1,1,1,0.7663,2,0.2559,MORE
29,150,153,3,303,150,153,5.010635,5.030438,0.01980263,10.04107,5.010635,5.030438,0,1,0,1.1688,1,0.4566,MORE
29,100,108,8,208,108,100,4.60517,4.682131,0.07696104,9.287301,4.682131,4.60517,1,1,1,0.58,1,0.1781,MORE
29,150,168,18,318,168,150,5.010635,5.123964,0.1133287,10.1346,5.123964,5.010635,1,1,1,0.4662,1,0.2357,MORE
29,100,94,6,194,94,100,4.60517,4.543295,0.0618754,9.148465,4.543295,4.60517,1,0,0,0.5313,1,0.2415,MORE
29,80,100,20,180,100,80,4.382027,4.60517,0.2231436,8.987197,4.60517,4.382027,1,1,1,0.5309,1,0.2362,MORE
29,108,100,8,208,100,108,4.682131,4.60517,0.07696104,9.287301,4.60517,4.682131,1,0,0,0.7748,1,0.294,MORE
29,88,100,12,188,100,88,4.477337,4.60517,0.1278334,9.082507,4.60517,4.477337,1,1,1,0.7211,1,0.2292,MORE
29,100,116,16,216,100,116,4.60517,4.75359,0.14842,9.35876,4.60517,4.75359,0,1,0,0.8422,1,0.1115,MORE
29,153,150,3,303,150,153,5.030438,5.010635,0.01980263,10.04107,5.010635,5.030438,1,0,0,0.7506,1,0.2602,MORE
29,100,80,20,180,100,80,4.60517,4.382027,0.2231436,8.987197,4.60517,4.382027,0,0,1,0.8923,1,0.2402,MORE
29,98,100,2,198,100,98,4.584967,4.60517,0.02020271,9.190138,4.60517,4.584967,1,1,1,0.5744,1,0.243,MORE
29,100,90,10,190,90,100,4.60517,4.49981,0.1053605,9.10498,4.49981,4.60517,1,0,0,0.5264,1,0.2453,MORE
29,150,177,27,327,177,150,5.010635,5.17615,0.1655144,10.18679,5.17615,5.010635,1,1,1,0.7537,1,0.2774,MORE
29,156,150,6,306,150,156,5.049856,5.010635,0.03922071,10.06049,5.010635,5.049856,1,0,0,0.8449,1,0.2432,MORE
29,50,56,6,106,56,50,3.912023,4.025352,0.1133287,7.937375,4.025352,3.912023,1,1,1,0.856,1,0.247,MORE
29,114,100,14,214,100,114,4.736198,4.60517,0.1310283,9.341369,4.60517,4.736198,1,0,0,0.5115,1,0.3102,MORE
29,102,100,2,202,102,100,4.624973,4.60517,0.01980263,9.230143,4.624973,4.60517,0,0,1,1.3585,1,0.2983,MORE
29,100,120,20,220,120,100,4.60517,4.787492,0.1823216,9.392662,4.787492,4.60517,1,1,1,0.5697,1,0.2672,MORE
29,50,44,6,94,44,50,3.912023,3.78419,0.1278334,7.696213,3.78419,3.912023,1,0,0,0.9266,2,0.2588,MORE
29,104,100,4,204,100,104,4.644391,4.60517,0.03922071,9.249561,4.60517,4.644391,1,0,0,0.7016,2,0.2583,MORE
29,100,82,18,182,82,100,4.60517,4.406719,0.1984509,9.011889,4.406719,4.60517,1,0,0,0.584,2,0.2265,MORE
29,174,150,24,324,174,150,5.159055,5.010635,0.14842,10.16969,5.159055,5.010635,0,0,1,0.6686,2,0.2874,MORE
29,50,43,7,93,50,43,3.912023,3.7612,0.1508229,7.673223,3.912023,3.7612,0,0,1,0.9513,1,0.2323,MORE
29,177,150,27,327,177,150,5.17615,5.010635,0.1655144,10.18679,5.17615,5.010635,0,0,1,0.913,2,0.5579,MORE
29,150,153,3,303,150,153,5.010635,5.030438,0.01980263,10.04107,5.010635,5.030438,0,1,0,0.7477,2,0.492,MORE
29,90,100,10,190,100,90,4.49981,4.60517,0.1053605,9.10498,4.60517,4.49981,1,1,1,0.6189,2,0.3188,MORE
29,51,50,1,101,51,50,3.931826,3.912023,0.01980263,7.843849,3.931826,3.912023,0,0,1,0.7324,1,0.2587,MORE
29,180,150,30,330,180,150,5.192957,5.010635,0.1823216,10.20359,5.192957,5.010635,0,0,1,0.6141,2,0.2435,MORE
29,156,150,6,306,150,156,5.049856,5.010635,0.03922071,10.06049,5.010635,5.049856,1,0,0,0.4449,2,0.504,MORE
29,46,50,4,96,50,46,3.828641,3.912023,0.08338161,7.740664,3.912023,3.828641,1,1,1,0.8845,2,0.2881,MORE
29,150,123,27,273,150,123,5.010635,4.812184,0.1984509,9.82282,5.010635,4.812184,0,0,1,2.7097,2,0.5242,MORE
29,150,162,12,312,162,150,5.010635,5.087596,0.07696104,10.09823,5.087596,5.010635,1,1,1,0.8426,2,0.2768,MORE
29,100,88,12,188,88,100,4.60517,4.477337,0.1278334,9.082507,4.477337,4.60517,1,0,0,0.5937,2,0.2615,MORE
29,123,150,27,273,150,123,4.812184,5.010635,0.1984509,9.82282,5.010635,4.812184,1,1,1,0.5477,2,0.2186,MORE
29,50,40,10,90,50,40,3.912023,3.688879,0.2231436,7.600902,3.912023,3.688879,0,0,1,0.9353,1,0.4787,MORE
29,56,50,6,106,56,50,4.025352,3.912023,0.1133287,7.937375,4.025352,3.912023,0,0,1,0.8746,1,0.2646,MORE
29,92,100,8,192,100,92,4.521789,4.60517,0.08338161,9.126959,4.60517,4.521789,1,1,1,0.7113,2,0.3207,MORE
29,50,56,6,106,56,50,3.912023,4.025352,0.1133287,7.937375,4.025352,3.912023,1,1,1,0.8585,2,0.2814,MORE
29,50,42,8,92,50,42,3.912023,3.73767,0.1743534,7.649693,3.912023,3.73767,0,0,1,0.7229,1,0.2936,MORE
29,141,150,9,291,141,150,4.94876,5.010635,0.0618754,9.959395,4.94876,5.010635,0,1,0,0.578,1,0.3613,MORE
29,100,104,4,204,104,100,4.60517,4.644391,0.03922071,9.249561,4.644391,4.60517,1,1,1,0.7019,2,0.3429,MORE
29,150,132,18,282,150,132,5.010635,4.882802,0.1278334,9.893437,5.010635,4.882802,0,0,1,0.6108,2,0.2222,MORE
29,50,53,3,103,50,53,3.912023,3.970292,0.05826891,7.882315,3.912023,3.970292,0,1,0,0.6943,1,0.3168,MORE
29,88,100,12,188,100,88,4.477337,4.60517,0.1278334,9.082507,4.60517,4.477337,1,1,1,0.4733,2,0.2416,MORE
29,96,100,4,196,96,100,4.564348,4.60517,0.04082199,9.169518,4.564348,4.60517,0,1,0,0.5614,2,0.4125,MORE
29,41,50,9,91,50,41,3.713572,3.912023,0.1984509,7.625595,3.912023,3.713572,1,1,1,0.7536,2,0.3093,MORE
29,120,150,30,270,150,120,4.787492,5.010635,0.2231436,9.798127,5.010635,4.787492,1,1,1,0.7267,1,0.2605,MORE
29,47,50,3,97,47,50,3.850148,3.912023,0.0618754,7.762171,3.850148,3.912023,0,1,0,0.7335,1,0.2273,MORE
29,180,150,30,330,150,180,5.192957,5.010635,0.1823216,10.20359,5.010635,5.192957,1,0,0,0.8214,1,0.2781,MORE
29,120,150,30,270,150,120,4.787492,5.010635,0.2231436,9.798127,5.010635,4.787492,1,1,1,0.698,1,0.2287,MORE
29,150,171,21,321,171,150,5.010635,5.141664,0.1310283,10.1523,5.141664,5.010635,1,1,1,0.6426,1,0.3178,MORE
29,50,41,9,91,50,41,3.912023,3.713572,0.1984509,7.625595,3.912023,3.713572,0,0,1,0.7528,2,0.6253,MORE
29,126,150,24,276,150,126,4.836282,5.010635,0.1743534,9.846917,5.010635,4.836282,1,1,1,0.8376,1,0.1941,MORE
29,100,108,8,208,100,108,4.60517,4.682131,0.07696104,9.287301,4.60517,4.682131,0,1,0,0.9253,2,0.5207,MORE
29,110,100,10,210,110,100,4.70048,4.60517,0.09531018,9.305651,4.70048,4.60517,0,0,1,0.5602,1,0.2773,MORE
29,50,46,4,96,46,50,3.912023,3.828641,0.08338161,7.740664,3.828641,3.912023,1,0,0,0.7622,1,0.1624,MORE
29,159,150,9,309,150,159,5.068904,5.010635,0.05826891,10.07954,5.010635,5.068904,1,0,0,0.8103,1,0.2501,MORE
29,150,180,30,330,180,150,5.010635,5.192957,0.1823216,10.20359,5.192957,5.010635,1,1,1,0.5848,1,0.2437,MORE
29,50,43,7,93,50,43,3.912023,3.7612,0.1508229,7.673223,3.912023,3.7612,0,0,1,0.754,2,0.4421,MORE
29,100,114,14,214,100,114,4.60517,4.736198,0.1310283,9.341369,4.60517,4.736198,0,1,0,0.7206,4,0.2643,MORE
29,150,141,9,291,150,141,5.010635,4.94876,0.0618754,9.959395,5.010635,4.94876,0,0,1,0.6702,2,0.2929,MORE
29,84,100,16,184,100,84,4.430817,4.60517,0.1743534,9.035987,4.60517,4.430817,1,1,1,0.6732,4,0.2105,MORE
29,60,50,10,110,60,50,4.094345,3.912023,0.1823216,8.006368,4.094345,3.912023,0,0,1,0.6887,4,0.2649,MORE
29,126,150,24,276,126,150,4.836282,5.010635,0.1743534,9.846917,4.836282,5.010635,0,1,0,0.6411,4,0.2933,MORE
29,100,110,10,210,100,110,4.60517,4.70048,0.09531018,9.305651,4.60517,4.70048,0,1,0,0.6633,4,0.206,MORE
29,57,50,7,107,50,57,4.043051,3.912023,0.1310283,7.955074,3.912023,4.043051,1,0,0,0.9578,4,0.1982,MORE
29,48,50,2,98,50,48,3.871201,3.912023,0.04082199,7.783224,3.912023,3.871201,1,1,1,0.888,4,0.238,MORE
29,150,126,24,276,150,126,5.010635,4.836282,0.1743534,9.846917,5.010635,4.836282,0,0,1,0.6286,4,0.2146,MORE
29,50,54,4,104,50,54,3.912023,3.988984,0.07696104,7.901007,3.912023,3.988984,0,1,0,0.6947,4,0.2307,MORE
29,54,50,4,104,54,50,3.988984,3.912023,0.07696104,7.901007,3.988984,3.912023,0,0,1,1.0591,4,0.22,MORE
29,165,150,15,315,165,150,5.105945,5.010635,0.09531018,10.11658,5.105945,5.010635,0,0,1,0.6372,4,0.2243,MORE
29,168,150,18,318,168,150,5.123964,5.010635,0.1133287,10.1346,5.123964,5.010635,0,0,1,0.5955,4,0.2444,MORE
29,51,50,1,101,51,50,3.931826,3.912023,0.01980263,7.843849,3.931826,3.912023,0,0,1,0.6985,4,0.2639,MORE
29,171,150,21,321,171,150,5.141664,5.010635,0.1310283,10.1523,5.141664,5.010635,0,0,1,0.6402,4,0.2068,MORE
29,150,180,30,330,150,180,5.010635,5.192957,0.1823216,10.20359,5.010635,5.192957,0,1,0,0.8101,4,0.1602,MORE
29,123,150,27,273,150,123,4.812184,5.010635,0.1984509,9.82282,5.010635,4.812184,1,1,1,0.49,4,0.2432,MORE
29,46,50,4,96,46,50,3.828641,3.912023,0.08338161,7.740664,3.828641,3.912023,0,1,0,0.8216,4,0.2454,MORE
29,147,150,3,297,150,147,4.990433,5.010635,0.02020271,10.00107,5.010635,4.990433,1,1,1,0.6972,4,0.2913,MORE
29,53,50,3,103,53,50,3.970292,3.912023,0.05826891,7.882315,3.970292,3.912023,0,0,1,0.5637,4,0.2951,MORE
29,112,100,12,212,112,100,4.718499,4.60517,0.1133287,9.323669,4.718499,4.60517,0,0,1,0.6714,4,0.2599,MORE
29,58,50,8,108,58,50,4.060443,3.912023,0.14842,7.972466,4.060443,3.912023,0,0,1,0.5475,4,0.2524,MORE
29,100,102,2,202,100,102,4.60517,4.624973,0.01980263,9.230143,4.60517,4.624973,0,1,0,0.5088,4,0.2488,MORE
29,150,126,24,276,150,126,5.010635,4.836282,0.1743534,9.846917,5.010635,4.836282,0,0,1,0.433,4,0.2344,MORE
29,100,110,10,210,110,100,4.60517,4.70048,0.09531018,9.305651,4.70048,4.60517,1,1,1,0.6801,4,0.1452,MORE
29,90,100,10,190,90,100,4.49981,4.60517,0.1053605,9.10498,4.49981,4.60517,0,1,0,0.5289,4,0.2686,MORE
29,141,150,9,291,141,150,4.94876,5.010635,0.0618754,9.959395,4.94876,5.010635,0,1,0,0.7492,4,0.2491,MORE
29,100,84,16,184,100,84,4.60517,4.430817,0.1743534,9.035987,4.60517,4.430817,0,0,1,0.5344,4,0.2468,MORE
29,135,150,15,285,135,150,4.905275,5.010635,0.1053605,9.91591,4.905275,5.010635,0,1,0,0.4859,4,0.2468,MORE
29,98,100,2,198,98,100,4.584967,4.60517,0.02020271,9.190138,4.584967,4.60517,0,1,0,0.6925,4,0.209,MORE
29,177,150,27,327,150,177,5.17615,5.010635,0.1655144,10.18679,5.010635,5.17615,1,0,0,0.3701,4,0.2437,MORE
29,106,100,6,206,100,106,4.663439,4.60517,0.05826891,9.268609,4.60517,4.663439,1,0,0,0.7355,4,0.2768,MORE
29,150,135,15,285,150,135,5.010635,4.905275,0.1053605,9.91591,5.010635,4.905275,0,0,1,0.5559,4,0.1953,MORE
29,162,150,12,312,162,150,5.087596,5.010635,0.07696104,10.09823,5.087596,5.010635,0,0,1,0.4967,4,0.2269,MORE
29,50,49,1,99,50,49,3.912023,3.89182,0.02020271,7.803843,3.912023,3.89182,0,0,1,0.7697,4,0.2699,MORE
29,138,150,12,288,150,138,4.927254,5.010635,0.08338161,9.937889,5.010635,4.927254,1,1,1,0.5396,4,0.2442,MORE
29,100,102,2,202,100,102,4.60517,4.624973,0.01980263,9.230143,4.60517,4.624973,0,1,0,0.5203,4,0.231,MORE
29,50,52,2,102,52,50,3.912023,3.951244,0.03922071,7.863267,3.951244,3.912023,1,1,1,0.7721,4,0.2594,MORE
29,53,50,3,103,53,50,3.970292,3.912023,0.05826891,7.882315,3.970292,3.912023,0,0,1,0.7777,4,0.2358,MORE
29,100,118,18,218,118,100,4.60517,4.770685,0.1655144,9.375855,4.770685,4.60517,1,1,1,0.5702,4,0.263,MORE
29,150,159,9,309,150,159,5.010635,5.068904,0.05826891,10.07954,5.010635,5.068904,0,1,0,0.5736,4,0.2108,MORE
29,150,129,21,279,129,150,5.010635,4.859812,0.1508229,9.870448,4.859812,5.010635,1,0,0,0.6404,4,0.2832,MORE
29,150,147,3,297,147,150,5.010635,4.990433,0.02020271,10.00107,4.990433,5.010635,1,0,0,0.6213,4,0.2744,MORE
29,49,50,1,99,49,50,3.89182,3.912023,0.02020271,7.803843,3.89182,3.912023,0,1,0,0.8944,4,0.2851,MORE
29,102,100,2,202,100,102,4.624973,4.60517,0.01980263,9.230143,4.60517,4.624973,1,0,0,1.0763,4,0.2796,MORE
29,100,82,18,182,100,82,4.60517,4.406719,0.1984509,9.011889,4.60517,4.406719,0,0,1,0.798,4,0.2013,MORE
29,100,98,2,198,100,98,4.60517,4.584967,0.02020271,9.190138,4.60517,4.584967,0,0,1,0.7507,4,0.2165,MORE
29,100,106,6,206,106,100,4.60517,4.663439,0.05826891,9.268609,4.663439,4.60517,1,1,1,0.5838,4,0.2442,MORE
29,52,50,2,102,52,50,3.951244,3.912023,0.03922071,7.863267,3.951244,3.912023,0,0,1,0.84,4,0.2303,MORE
29,40,50,10,90,50,40,3.688879,3.912023,0.2231436,7.600902,3.912023,3.688879,1,1,1,0.7877,4,0.2552,MORE
29,50,53,3,103,50,53,3.912023,3.970292,0.05826891,7.882315,3.912023,3.970292,0,1,0,0.6448,4,0.2764,MORE
29,150,141,9,291,141,150,5.010635,4.94876,0.0618754,9.959395,4.94876,5.010635,1,0,0,0.9301,4,0.251,MORE
29,150,162,12,312,162,150,5.010635,5.087596,0.07696104,10.09823,5.087596,5.010635,1,1,1,0.6147,4,0.2367,MORE
29,144,150,6,294,150,144,4.969813,5.010635,0.04082199,9.980449,5.010635,4.969813,1,1,1,0.5518,4,0.2555,MORE
29,108,100,8,208,108,100,4.682131,4.60517,0.07696104,9.287301,4.682131,4.60517,0,0,1,0.5097,4,0.243,MORE
29,132,150,18,282,150,132,4.882802,5.010635,0.1278334,9.893437,5.010635,4.882802,1,1,1,0.597,4,0.2181,MORE
29,50,47,3,97,50,47,3.912023,3.850148,0.0618754,7.762171,3.912023,3.850148,0,0,1,0.6954,4,1.1075,MORE
29,150,156,6,306,156,150,5.010635,5.049856,0.03922071,10.06049,5.049856,5.010635,1,1,1,0.6881,4,0.2504,MORE
29,86,100,14,186,100,86,4.454347,4.60517,0.1508229,9.059517,4.60517,4.454347,1,1,1,1.0807,4,0.3584,MORE
29,82,100,18,182,82,100,4.406719,4.60517,0.1984509,9.011889,4.406719,4.60517,0,1,0,0.7955,4,0.2423,MORE
29,100,88,12,188,100,88,4.60517,4.477337,0.1278334,9.082507,4.60517,4.477337,0,0,1,0.6299,4,0.2423,MORE
29,150,171,21,321,171,150,5.010635,5.141664,0.1310283,10.1523,5.141664,5.010635,1,1,1,0.5764,4,0.2103,MORE
29,100,114,14,214,114,100,4.60517,4.736198,0.1310283,9.341369,4.736198,4.60517,1,1,1,0.4751,4,0.2583,MORE
29,100,92,8,192,92,100,4.60517,4.521789,0.08338161,9.126959,4.521789,4.60517,1,0,0,0.5931,4,0.2171,MORE
29,129,150,21,279,150,129,4.859812,5.010635,0.1508229,9.870448,5.010635,4.859812,1,1,1,0.6061,4,0.2755,MORE
29,118,100,18,218,118,100,4.770685,4.60517,0.1655144,9.375855,4.770685,4.60517,0,0,1,0.5475,4,0.2863,MORE
29,50,54,4,104,54,50,3.912023,3.988984,0.07696104,7.901007,3.988984,3.912023,1,1,1,0.8223,4,0.2801,MORE
29,50,45,5,95,50,45,3.912023,3.806662,0.1053605,7.718685,3.912023,3.806662,0,0,1,0.6672,4,0.2659,MORE
29,116,100,16,216,116,100,4.75359,4.60517,0.14842,9.35876,4.75359,4.60517,0,0,1,0.6931,4,0.2387,MORE
29,57,50,7,107,50,57,4.043051,3.912023,0.1310283,7.955074,3.912023,4.043051,1,0,0,0.7218,4,0.245,MORE
29,50,60,10,110,60,50,3.912023,4.094345,0.1823216,8.006368,4.094345,3.912023,1,1,1,0.6496,4,0.2648,MORE
29,50,52,2,102,50,52,3.912023,3.951244,0.03922071,7.863267,3.912023,3.951244,0,1,0,0.8205,4,0.1774,MORE
29,59,50,9,109,50,59,4.077537,3.912023,0.1655144,7.98956,3.912023,4.077537,1,0,0,0.7412,4,0.2433,MORE
29,100,120,20,220,120,100,4.60517,4.787492,0.1823216,9.392662,4.787492,4.60517,1,1,1,0.6273,4,0.2416,MORE
29,50,47,3,97,47,50,3.912023,3.850148,0.0618754,7.762171,3.850148,3.912023,1,0,0,0.723,4,0.2422,MORE
29,56,50,6,106,56,50,4.025352,3.912023,0.1133287,7.937375,4.025352,3.912023,0,0,1,0.5882,4,0.294,MORE
29,40,50,10,90,50,40,3.688879,3.912023,0.2231436,7.600902,3.912023,3.688879,1,1,1,0.799,4,0.2575,MORE
29,50,55,5,105,55,50,3.912023,4.007333,0.09531018,7.919356,4.007333,3.912023,1,1,1,0.693,4,0.2414,MORE
29,100,96,4,196,96,100,4.60517,4.564348,0.04082199,9.169518,4.564348,4.60517,1,0,0,0.5191,4,0.2618,MORE
29,84,100,16,184,100,84,4.430817,4.60517,0.1743534,9.035987,4.60517,4.430817,1,1,1,0.5057,4,0.2693,MORE
29,50,41,9,91,50,41,3.912023,3.713572,0.1984509,7.625595,3.912023,3.713572,0,0,1,0.6511,4,0.2839,MORE
29,60,50,10,110,50,60,4.094345,3.912023,0.1823216,8.006368,3.912023,4.094345,1,0,0,0.7153,4,0.2189,MORE
29,159,150,9,309,150,159,5.068904,5.010635,0.05826891,10.07954,5.010635,5.068904,1,0,0,0.9747,4,0.2727,MORE
29,150,159,9,309,159,150,5.010635,5.068904,0.05826891,10.07954,5.068904,5.010635,1,1,1,0.5959,4,0.2272,MORE
29,50,59,9,109,59,50,3.912023,4.077537,0.1655144,7.98956,4.077537,3.912023,1,1,1,0.9138,4,0.2606,MORE
29,100,86,14,186,100,86,4.60517,4.454347,0.1508229,9.059517,4.60517,4.454347,0,0,1,0.5442,4,0.2817,MORE
29,48,50,2,98,50,48,3.871201,3.912023,0.04082199,7.783224,3.912023,3.871201,1,1,1,0.6655,4,0.2623,MORE
29,49,50,1,99,50,49,3.89182,3.912023,0.02020271,7.803843,3.912023,3.89182,1,1,1,0.6597,4,0.291,MORE
29,43,50,7,93,50,43,3.7612,3.912023,0.1508229,7.673223,3.912023,3.7612,1,1,1,0.6093,4,0.3002,MORE
29,100,116,16,216,116,100,4.60517,4.75359,0.14842,9.35876,4.75359,4.60517,1,1,1,0.5084,4,0.2797,MORE
29,100,98,2,198,98,100,4.60517,4.584967,0.02020271,9.190138,4.584967,4.60517,1,0,0,0.6034,4,0.3117,MORE
29,50,58,8,108,58,50,3.912023,4.060443,0.14842,7.972466,4.060443,3.912023,1,1,1,0.6246,4,0.2714,MORE
29,150,144,6,294,150,144,5.010635,4.969813,0.04082199,9.980449,5.010635,4.969813,0,0,1,0.7132,4,0.2165,MORE
29,116,100,16,216,100,116,4.75359,4.60517,0.14842,9.35876,4.60517,4.75359,1,0,0,0.5386,4,0.2423,MORE
29,50,51,1,101,51,50,3.912023,3.931826,0.01980263,7.843849,3.931826,3.912023,1,1,1,0.6773,4,0.3078,MORE
29,100,96,4,196,96,100,4.60517,4.564348,0.04082199,9.169518,4.564348,4.60517,1,0,0,0.6056,4,0.2099,MORE
29,43,50,7,93,50,43,3.7612,3.912023,0.1508229,7.673223,3.912023,3.7612,1,1,1,0.649,4,0.2745,MORE
29,120,100,20,220,120,100,4.787492,4.60517,0.1823216,9.392662,4.787492,4.60517,0,0,1,0.5384,4,0.2242,MORE
29,44,50,6,94,50,44,3.78419,3.912023,0.1278334,7.696213,3.912023,3.78419,1,1,1,0.661,4,0.2589,MORE
29,150,174,24,324,174,150,5.010635,5.159055,0.14842,10.16969,5.159055,5.010635,1,1,1,0.4618,4,0.2497,MORE
29,150,132,18,282,132,150,5.010635,4.882802,0.1278334,9.893437,4.882802,5.010635,1,0,0,0.5853,4,0.2376,MORE
30,50,42,8,92,42,50,3.912023,3.73767,0.1743534,7.649693,3.73767,3.912023,1,0,0,1.2183,4,1.5261,MORE
30,150,165,15,315,165,150,5.010635,5.105945,0.09531018,10.11658,5.105945,5.010635,1,1,1,3.09,3,1.9403,MORE
30,100,94,6,194,94,100,4.60517,4.543295,0.0618754,9.148465,4.543295,4.60517,1,0,0,3.4324,3,1.1141,MORE
30,150,126,24,276,126,150,5.010635,4.836282,0.1743534,9.846917,4.836282,5.010635,1,0,0,2.432,2,1.2171,MORE
30,138,150,12,288,150,138,4.927254,5.010635,0.08338161,9.937889,5.010635,4.927254,1,1,1,2.3903,3,0.7013,MORE
30,102,100,2,202,100,102,4.624973,4.60517,0.01980263,9.230143,4.60517,4.624973,1,0,0,2.2681,2,0.8536,MORE
30,50,59,9,109,50,59,3.912023,4.077537,0.1655144,7.98956,3.912023,4.077537,0,1,0,3.3258,1,1.822,MORE
30,150,138,12,288,138,150,5.010635,4.927254,0.08338161,9.937889,4.927254,5.010635,1,0,0,2.971,1,1.3198,MORE
30,123,150,27,273,150,123,4.812184,5.010635,0.1984509,9.82282,5.010635,4.812184,1,1,1,2.2334,3,1.2393,MORE
30,50,43,7,93,50,43,3.912023,3.7612,0.1508229,7.673223,3.912023,3.7612,0,0,1,2.0345,2,1.9091,MORE
30,50,48,2,98,50,48,3.912023,3.871201,0.04082199,7.783224,3.912023,3.871201,0,0,1,1.7587,2,1.4912,MORE
30,150,153,3,303,153,150,5.010635,5.030438,0.01980263,10.04107,5.030438,5.010635,1,1,1,2.095,3,1.0873,MORE
30,50,53,3,103,50,53,3.912023,3.970292,0.05826891,7.882315,3.912023,3.970292,0,1,0,2.6922,2,0.976,MORE
30,94,100,6,194,100,94,4.543295,4.60517,0.0618754,9.148465,4.60517,4.543295,1,1,1,1.6897,3,0.8767,MORE
30,116,100,16,216,116,100,4.75359,4.60517,0.14842,9.35876,4.75359,4.60517,0,0,1,1.5542,2,1.0821,MORE
30,60,50,10,110,60,50,4.094345,3.912023,0.1823216,8.006368,4.094345,3.912023,0,0,1,2.029,3,1.6778,MORE
30,144,150,6,294,150,144,4.969813,5.010635,0.04082199,9.980449,5.010635,4.969813,1,1,1,1.6769,4,1.1072,MORE
30,50,46,4,96,50,46,3.912023,3.828641,0.08338161,7.740664,3.912023,3.828641,0,0,1,2.2992,1,2.6676,MORE
30,112,100,12,212,100,112,4.718499,4.60517,0.1133287,9.323669,4.60517,4.718499,1,0,0,1.7224,3,0.8043,MORE
30,100,104,4,204,104,100,4.60517,4.644391,0.03922071,9.249561,4.644391,4.60517,1,1,1,2.0268,4,0.9905,MORE
30,100,106,6,206,100,106,4.60517,4.663439,0.05826891,9.268609,4.60517,4.663439,0,1,0,1.9761,1,1.1822,MORE
30,150,177,27,327,150,177,5.010635,5.17615,0.1655144,10.18679,5.010635,5.17615,0,1,0,2.3183,2,1.0595,MORE
30,150,180,30,330,180,150,5.010635,5.192957,0.1823216,10.20359,5.192957,5.010635,1,1,1,1.7618,2,0.8592,MORE
30,100,96,4,196,100,96,4.60517,4.564348,0.04082199,9.169518,4.60517,4.564348,0,0,1,2.6716,2,1.5257,MORE
30,120,150,30,270,150,120,4.787492,5.010635,0.2231436,9.798127,5.010635,4.787492,1,1,1,2.0043,3,0.5018,MORE
30,132,150,18,282,150,132,4.882802,5.010635,0.1278334,9.893437,5.010635,4.882802,1,1,1,2.3995,2,1.0392,MORE
30,168,150,18,318,150,168,5.123964,5.010635,0.1133287,10.1346,5.010635,5.123964,1,0,0,2.0301,2,0.7472,MORE
30,50,41,9,91,50,41,3.912023,3.713572,0.1984509,7.625595,3.912023,3.713572,0,0,1,2.4164,2,2.0358,MORE
30,150,123,27,273,123,150,5.010635,4.812184,0.1984509,9.82282,4.812184,5.010635,1,0,0,1.5915,4,1.0716,MORE
30,150,120,30,270,150,120,5.010635,4.787492,0.2231436,9.798127,5.010635,4.787492,0,0,1,1.9835,4,1.6909,MORE
30,150,144,6,294,144,150,5.010635,4.969813,0.04082199,9.980449,4.969813,5.010635,1,0,0,3.2229,2,1.159,MORE
30,112,100,12,212,100,112,4.718499,4.60517,0.1133287,9.323669,4.60517,4.718499,1,0,0,2.5407,2,3.5353,MORE
30,100,82,18,182,100,82,4.60517,4.406719,0.1984509,9.011889,4.60517,4.406719,0,0,1,1.5838,1,0.9867,MORE
30,50,40,10,90,50,40,3.912023,3.688879,0.2231436,7.600902,3.912023,3.688879,0,0,1,2.963,2,0.7971,MORE
30,49,50,1,99,50,49,3.89182,3.912023,0.02020271,7.803843,3.912023,3.89182,1,1,1,2.3347,1,0.99,MORE
30,88,100,12,188,100,88,4.477337,4.60517,0.1278334,9.082507,4.60517,4.477337,1,1,1,3.363,1,1.4377,MORE
30,106,100,6,206,106,100,4.663439,4.60517,0.05826891,9.268609,4.663439,4.60517,0,0,1,1.8834,2,1.2513,MORE
30,100,84,16,184,84,100,4.60517,4.430817,0.1743534,9.035987,4.430817,4.60517,1,0,0,2.0776,3,0.8329,MORE
30,153,150,3,303,153,150,5.030438,5.010635,0.01980263,10.04107,5.030438,5.010635,0,0,1,1.6376,3,2.6173,MORE
30,150,171,21,321,150,171,5.010635,5.141664,0.1310283,10.1523,5.010635,5.141664,0,1,0,1.8935,1,1.14,MORE
30,50,60,10,110,60,50,3.912023,4.094345,0.1823216,8.006368,4.094345,3.912023,1,1,1,1.814,2,2.688,MORE
30,100,120,20,220,120,100,4.60517,4.787492,0.1823216,9.392662,4.787492,4.60517,1,1,1,1.8667,2,1.0429,MORE
30,118,100,18,218,118,100,4.770685,4.60517,0.1655144,9.375855,4.770685,4.60517,0,0,1,1.5833,3,1.1978,MORE
30,147,150,3,297,147,150,4.990433,5.010635,0.02020271,10.00107,4.990433,5.010635,0,1,0,2.2493,3,1.5475,MORE
30,100,116,16,216,116,100,4.60517,4.75359,0.14842,9.35876,4.75359,4.60517,1,1,1,2.7223,3,1.1191,MORE
30,50,45,5,95,45,50,3.912023,3.806662,0.1053605,7.718685,3.806662,3.912023,1,0,0,3.3853,2,0.6176,MORE
30,165,150,15,315,165,150,5.105945,5.010635,0.09531018,10.11658,5.105945,5.010635,0,0,1,2.0417,4,0.6761,MORE
30,52,50,2,102,52,50,3.951244,3.912023,0.03922071,7.863267,3.951244,3.912023,0,0,1,2.986,2,0.4016,MORE
30,100,80,20,180,100,80,4.60517,4.382027,0.2231436,8.987197,4.60517,4.382027,0,0,1,1.6311,2,0.8938,MORE
30,104,100,4,204,100,104,4.644391,4.60517,0.03922071,9.249561,4.60517,4.644391,1,0,0,1.9671,1,0.9244,MORE
30,50,55,5,105,50,55,3.912023,4.007333,0.09531018,7.919356,3.912023,4.007333,0,1,0,2.0598,1,1.7428,MORE
30,153,150,3,303,153,150,5.030438,5.010635,0.01980263,10.04107,5.030438,5.010635,0,0,1,1.6255,3,0.7597,MORE
30,165,150,15,315,150,165,5.105945,5.010635,0.09531018,10.11658,5.010635,5.105945,1,0,0,1.3707,3,0.7089,MORE
30,50,49,1,99,50,49,3.912023,3.89182,0.02020271,7.803843,3.912023,3.89182,0,0,1,3.797,2,0.8151,MORE
30,150,180,30,330,180,150,5.010635,5.192957,0.1823216,10.20359,5.192957,5.010635,1,1,1,1.3264,4,0.5658,MORE
30,100,108,8,208,100,108,4.60517,4.682131,0.07696104,9.287301,4.60517,4.682131,0,1,0,1.8579,3,0.8201,MORE
30,86,100,14,186,100,86,4.454347,4.60517,0.1508229,9.059517,4.60517,4.454347,1,1,1,2.8919,3,0.9102,MORE
30,129,150,21,279,150,129,4.859812,5.010635,0.1508229,9.870448,5.010635,4.859812,1,1,1,1.4882,3,1.2298,MORE
30,150,162,12,312,150,162,5.010635,5.087596,0.07696104,10.09823,5.010635,5.087596,0,1,0,2.0829,2,0.7059,MORE
30,59,50,9,109,50,59,4.077537,3.912023,0.1655144,7.98956,3.912023,4.077537,1,0,0,2.5782,3,0.9474,MORE
30,100,102,2,202,102,100,4.60517,4.624973,0.01980263,9.230143,4.624973,4.60517,1,1,1,2.6763,2,0.9675,MORE
30,90,100,10,190,90,100,4.49981,4.60517,0.1053605,9.10498,4.49981,4.60517,0,1,0,2.0147,1,0.5739,MORE
30,49,50,1,99,49,50,3.89182,3.912023,0.02020271,7.803843,3.89182,3.912023,0,1,0,2.3896,1,2.1209,MORE
30,80,100,20,180,100,80,4.382027,4.60517,0.2231436,8.987197,4.60517,4.382027,1,1,1,1.9063,2,0.7094,MORE
30,58,50,8,108,58,50,4.060443,3.912023,0.14842,7.972466,4.060443,3.912023,0,0,1,2.1096,3,1.1267,MORE
30,162,150,12,312,150,162,5.087596,5.010635,0.07696104,10.09823,5.010635,5.087596,1,0,0,1.6786,3,0.9966,MORE
30,135,150,15,285,150,135,4.905275,5.010635,0.1053605,9.91591,5.010635,4.905275,1,1,1,3.152,2,0.8647,MORE
30,51,50,1,101,50,51,3.931826,3.912023,0.01980263,7.843849,3.912023,3.931826,1,0,0,2.5403,2,0.5055,MORE
30,159,150,9,309,159,150,5.068904,5.010635,0.05826891,10.07954,5.068904,5.010635,0,0,1,1.4571,2,3.1163,MORE
30,150,171,21,321,171,150,5.010635,5.141664,0.1310283,10.1523,5.141664,5.010635,1,1,1,2.2725,1,0.8618,MORE
30,50,60,10,110,60,50,3.912023,4.094345,0.1823216,8.006368,4.094345,3.912023,1,1,1,3.068,1,0.7725,MORE
30,147,150,3,297,150,147,4.990433,5.010635,0.02020271,10.00107,5.010635,4.990433,1,1,1,1.7878,3,1.1474,MORE
30,100,90,10,190,100,90,4.60517,4.49981,0.1053605,9.10498,4.60517,4.49981,0,0,1,2.6394,1,0.8342,MORE
30,116,100,16,216,100,116,4.75359,4.60517,0.14842,9.35876,4.60517,4.75359,1,0,0,2.1895,1,0.8912,MORE
30,48,50,2,98,50,48,3.871201,3.912023,0.04082199,7.783224,3.912023,3.871201,1,1,1,1.9514,2,0.9581,MORE
30,100,114,14,214,100,114,4.60517,4.736198,0.1310283,9.341369,4.60517,4.736198,0,1,0,3.3664,1,0.6992,MORE
30,180,150,30,330,150,180,5.192957,5.010635,0.1823216,10.20359,5.010635,5.192957,1,0,0,2.5894,1,0.7462,MORE
30,141,150,9,291,141,150,4.94876,5.010635,0.0618754,9.959395,4.94876,5.010635,0,1,0,1.8521,1,0.9731,MORE
30,98,100,2,198,100,98,4.584967,4.60517,0.02020271,9.190138,4.60517,4.584967,1,1,1,1.8857,2,1.2113,MORE
30,50,41,9,91,50,41,3.912023,3.713572,0.1984509,7.625595,3.912023,3.713572,0,0,1,1.6047,2,2.0744,MORE
30,100,92,8,192,100,92,4.60517,4.521789,0.08338161,9.126959,4.60517,4.521789,0,0,1,1.3968,4,0.7855,MORE
30,174,150,24,324,174,150,5.159055,5.010635,0.14842,10.16969,5.159055,5.010635,0,0,1,1.7145,3,0.5401,MORE
30,50,49,1,99,49,50,3.912023,3.89182,0.02020271,7.803843,3.89182,3.912023,1,0,0,1.9397,2,0.8192,MORE
30,150,141,9,291,150,141,5.010635,4.94876,0.0618754,9.959395,5.010635,4.94876,0,0,1,1.5907,3,1.5989,MORE
30,100,106,6,206,106,100,4.60517,4.663439,0.05826891,9.268609,4.663439,4.60517,1,1,1,2.1057,1,0.6092,MORE
30,43,50,7,93,50,43,3.7612,3.912023,0.1508229,7.673223,3.912023,3.7612,1,1,1,1.8262,4,0.5769,MORE
30,100,80,20,180,100,80,4.60517,4.382027,0.2231436,8.987197,4.60517,4.382027,0,0,1,1.9597,1,0.9072,MORE
30,94,100,6,194,100,94,4.543295,4.60517,0.0618754,9.148465,4.60517,4.543295,1,1,1,2.674,2,0.7149,MORE
30,50,54,4,104,54,50,3.912023,3.988984,0.07696104,7.901007,3.988984,3.912023,1,1,1,2.0742,3,1.2555,MORE
30,120,150,30,270,150,120,4.787492,5.010635,0.2231436,9.798127,5.010635,4.787492,1,1,1,1.3572,4,0.5045,MORE
30,150,156,6,306,150,156,5.010635,5.049856,0.03922071,10.06049,5.010635,5.049856,0,1,0,1.657,2,0.6244,MORE
30,47,50,3,97,50,47,3.850148,3.912023,0.0618754,7.762171,3.912023,3.850148,1,1,1,2.5724,3,0.6008,MORE
30,100,88,12,188,100,88,4.60517,4.477337,0.1278334,9.082507,4.60517,4.477337,0,0,1,1.6827,4,0.7973,MORE
30,100,118,18,218,118,100,4.60517,4.770685,0.1655144,9.375855,4.770685,4.60517,1,1,1,1.5041,3,0.5282,MORE
30,114,100,14,214,114,100,4.736198,4.60517,0.1310283,9.341369,4.736198,4.60517,0,0,1,1.2414,2,2.5557,MORE
30,80,100,20,180,100,80,4.382027,4.60517,0.2231436,8.987197,4.60517,4.382027,1,1,1,1.2787,4,0.8152,MORE
30,100,112,12,212,112,100,4.60517,4.718499,0.1133287,9.323669,4.718499,4.60517,1,1,1,1.4603,4,0.6716,MORE
30,110,100,10,210,110,100,4.70048,4.60517,0.09531018,9.305651,4.70048,4.60517,0,0,1,1.3068,2,1.2773,MORE
30,110,100,10,210,100,110,4.70048,4.60517,0.09531018,9.305651,4.60517,4.70048,1,0,0,1.3388,2,1.392,MORE
30,108,100,8,208,108,100,4.682131,4.60517,0.07696104,9.287301,4.682131,4.60517,0,0,1,1.4046,2,1.2105,MORE
30,118,100,18,218,100,118,4.770685,4.60517,0.1655144,9.375855,4.60517,4.770685,1,0,0,2.6285,2,0.7751,MORE
30,59,50,9,109,50,59,4.077537,3.912023,0.1655144,7.98956,3.912023,4.077537,1,0,0,1.9222,3,0.6435,MORE
30,150,174,24,324,174,150,5.010635,5.159055,0.14842,10.16969,5.159055,5.010635,1,1,1,2.0581,4,0.429,MORE
30,100,98,2,198,100,98,4.60517,4.584967,0.02020271,9.190138,4.60517,4.584967,0,0,1,1.5107,3,1.1039,MORE
30,100,110,10,210,110,100,4.60517,4.70048,0.09531018,9.305651,4.70048,4.60517,1,1,1,1.3487,4,0.8274,MORE
30,51,50,1,101,51,50,3.931826,3.912023,0.01980263,7.843849,3.931826,3.912023,0,0,1,1.4491,4,1.1315,MORE
30,150,129,21,279,150,129,5.010635,4.859812,0.1508229,9.870448,5.010635,4.859812,0,0,1,1.9777,2,2.4763,MORE
30,50,47,3,97,47,50,3.912023,3.850148,0.0618754,7.762171,3.850148,3.912023,1,0,0,1.6172,2,2.3519,MORE
30,100,86,14,186,86,100,4.60517,4.454347,0.1508229,9.059517,4.454347,4.60517,1,0,0,2.565,1,0.7699,MORE
30,104,100,4,204,104,100,4.644391,4.60517,0.03922071,9.249561,4.644391,4.60517,0,0,1,2.6406,1,0.5496,MORE
30,150,162,12,312,162,150,5.010635,5.087596,0.07696104,10.09823,5.087596,5.010635,1,1,1,2.0643,3,1.0784,MORE
30,150,135,15,285,150,135,5.010635,4.905275,0.1053605,9.91591,5.010635,4.905275,0,0,1,1.6291,4,2.5315,MORE
30,100,82,18,182,82,100,4.60517,4.406719,0.1984509,9.011889,4.406719,4.60517,1,0,0,2.2129,1,0.6306,MORE
30,150,159,9,309,159,150,5.010635,5.068904,0.05826891,10.07954,5.068904,5.010635,1,1,1,3.2034,1,1.4751,MORE
30,53,50,3,103,50,53,3.970292,3.912023,0.05826891,7.882315,3.912023,3.970292,1,0,0,3.268,2,0.9537,MORE
30,177,150,27,327,177,150,5.17615,5.010635,0.1655144,10.18679,5.17615,5.010635,0,0,1,1.3921,4,0.7033,MORE
30,50,56,6,106,56,50,3.912023,4.025352,0.1133287,7.937375,4.025352,3.912023,1,1,1,1.5767,4,0.6316,MORE
30,180,150,30,330,180,150,5.192957,5.010635,0.1823216,10.20359,5.192957,5.010635,0,0,1,1.3064,4,0.6043,MORE
30,41,50,9,91,41,50,3.713572,3.912023,0.1984509,7.625595,3.713572,3.912023,0,1,0,1.908,1,2.5384,MORE
30,150,177,27,327,177,150,5.010635,5.17615,0.1655144,10.18679,5.17615,5.010635,1,1,1,1.6352,2,1.6692,MORE
30,84,100,16,184,100,84,4.430817,4.60517,0.1743534,9.035987,4.60517,4.430817,1,1,1,2.6398,2,0.5922,MORE
30,50,45,5,95,50,45,3.912023,3.806662,0.1053605,7.718685,3.912023,3.806662,0,0,1,2.0392,2,1.8169,MORE
30,82,100,18,182,100,82,4.406719,4.60517,0.1984509,9.011889,4.60517,4.406719,1,1,1,1.3277,4,0.6817,MORE
30,156,150,6,306,156,150,5.049856,5.010635,0.03922071,10.06049,5.049856,5.010635,0,0,1,3.8419,1,2.6137,MORE
30,150,132,18,282,132,150,5.010635,4.882802,0.1278334,9.893437,4.882802,5.010635,1,0,0,2.0468,3,0.6979,MORE
30,100,120,20,220,120,100,4.60517,4.787492,0.1823216,9.392662,4.787492,4.60517,1,1,1,1.4335,3,0.6813,MORE
30,120,100,20,220,120,100,4.787492,4.60517,0.1823216,9.392662,4.787492,4.60517,0,0,1,3.2268,1,1.5389,MORE
30,50,58,8,108,58,50,3.912023,4.060443,0.14842,7.972466,4.060443,3.912023,1,1,1,1.4829,3,1.4386,MORE
30,50,52,2,102,50,52,3.912023,3.951244,0.03922071,7.863267,3.912023,3.951244,0,1,0,1.5436,2,1.2198,MORE
30,102,100,2,202,100,102,4.624973,4.60517,0.01980263,9.230143,4.60517,4.624973,1,0,0,1.4094,2,1.4514,MORE
30,100,108,8,208,108,100,4.60517,4.682131,0.07696104,9.287301,4.682131,4.60517,1,1,1,3.0284,1,0.8379,MORE
30,50,44,6,94,44,50,3.912023,3.78419,0.1278334,7.696213,3.78419,3.912023,1,0,0,1.3876,4,0.7821,MORE
30,100,118,18,218,100,118,4.60517,4.770685,0.1655144,9.375855,4.60517,4.770685,0,1,0,1.7124,1,1.1633,MORE
30,50,51,1,101,51,50,3.912023,3.931826,0.01980263,7.843849,3.931826,3.912023,1,1,1,1.2795,3,1.3339,MORE
30,50,54,4,104,54,50,3.912023,3.988984,0.07696104,7.901007,3.988984,3.912023,1,1,1,1.6287,3,1.6489,MORE
30,50,43,7,93,50,43,3.912023,3.7612,0.1508229,7.673223,3.912023,3.7612,0,0,1,1.324,4,0.9022,MORE
30,90,100,10,190,100,90,4.49981,4.60517,0.1053605,9.10498,4.60517,4.49981,1,1,1,1.5914,4,0.6137,MORE
30,96,100,4,196,96,100,4.564348,4.60517,0.04082199,9.169518,4.564348,4.60517,0,1,0,1.7372,2,1.8453,MORE
30,48,50,2,98,50,48,3.871201,3.912023,0.04082199,7.783224,3.912023,3.871201,1,1,1,1.4967,2,0.6646,MORE
30,44,50,6,94,50,44,3.78419,3.912023,0.1278334,7.696213,3.912023,3.78419,1,1,1,1.4287,3,0.7873,MORE
30,150,159,9,309,159,150,5.010635,5.068904,0.05826891,10.07954,5.068904,5.010635,1,1,1,1.5172,4,0.9498,MORE
30,138,150,12,288,150,138,4.927254,5.010635,0.08338161,9.937889,5.010635,4.927254,1,1,1,1.6477,4,1.4633,MORE
30,50,55,5,105,50,55,3.912023,4.007333,0.09531018,7.919356,3.912023,4.007333,0,1,0,1.3517,4,0.9089,MORE
30,92,100,8,192,100,92,4.521789,4.60517,0.08338161,9.126959,4.60517,4.521789,1,1,1,1.2342,4,0.6556,MORE
30,50,53,3,103,50,53,3.912023,3.970292,0.05826891,7.882315,3.912023,3.970292,0,1,0,1.3323,3,0.6263,MORE
30,55,50,5,105,50,55,4.007333,3.912023,0.09531018,7.919356,3.912023,4.007333,1,0,0,2.7292,1,1.267,MORE
30,92,100,8,192,92,100,4.521789,4.60517,0.08338161,9.126959,4.521789,4.60517,0,1,0,1.6478,1,1.0473,MORE
30,126,150,24,276,150,126,4.836282,5.010635,0.1743534,9.846917,5.010635,4.836282,1,1,1,1.3214,3,1.2124,MORE
30,56,50,6,106,50,56,4.025352,3.912023,0.1133287,7.937375,3.912023,4.025352,1,0,0,1.9377,2,1.0001,MORE
30,46,50,4,96,46,50,3.828641,3.912023,0.08338161,7.740664,3.828641,3.912023,0,1,0,1.9812,1,1.148,MORE
30,100,110,10,210,110,100,4.60517,4.70048,0.09531018,9.305651,4.70048,4.60517,1,1,1,1.266,2,1.5034,MORE
30,174,150,24,324,174,150,5.159055,5.010635,0.14842,10.16969,5.159055,5.010635,0,0,1,1.541,2,1.3805,MORE
30,100,114,14,214,114,100,4.60517,4.736198,0.1310283,9.341369,4.736198,4.60517,1,1,1,1.1154,3,1.3552,MORE
30,100,102,2,202,100,102,4.60517,4.624973,0.01980263,9.230143,4.60517,4.624973,0,1,0,1.3234,2,1.3802,MORE
30,150,126,24,276,126,150,5.010635,4.836282,0.1743534,9.846917,4.836282,5.010635,1,0,0,1.2209,2,1.4497,MORE
30,55,50,5,105,55,50,4.007333,3.912023,0.09531018,7.919356,4.007333,3.912023,0,0,1,1.1882,3,0.9611,MORE
30,40,50,10,90,50,40,3.688879,3.912023,0.2231436,7.600902,3.912023,3.688879,1,1,1,1.3486,3,0.8467,MORE
30,46,50,4,96,46,50,3.828641,3.912023,0.08338161,7.740664,3.828641,3.912023,0,1,0,1.9053,2,0.8562,MORE
30,141,150,9,291,150,141,4.94876,5.010635,0.0618754,9.959395,5.010635,4.94876,1,1,1,1.7977,3,0.8297,MORE
30,82,100,18,182,100,82,4.406719,4.60517,0.1984509,9.011889,4.60517,4.406719,1,1,1,3.6256,1,1.0334,MORE
30,98,100,2,198,100,98,4.584967,4.60517,0.02020271,9.190138,4.60517,4.584967,1,1,1,1.5523,2,0.7471,MORE
30,100,94,6,194,100,94,4.60517,4.543295,0.0618754,9.148465,4.60517,4.543295,0,0,1,1.3445,4,2.3882,MORE
30,60,50,10,110,60,50,4.094345,3.912023,0.1823216,8.006368,4.094345,3.912023,0,0,1,2.9146,1,0.793,MORE
30,100,96,4,196,96,100,4.60517,4.564348,0.04082199,9.169518,4.564348,4.60517,1,0,0,2.4582,2,2.4954,MORE
30,58,50,8,108,50,58,4.060443,3.912023,0.14842,7.972466,3.912023,4.060443,1,0,0,2.0513,2,0.871,MORE
30,96,100,4,196,100,96,4.564348,4.60517,0.04082199,9.169518,4.60517,4.564348,1,1,1,1.981,3,0.6518,MORE
30,114,100,14,214,114,100,4.736198,4.60517,0.1310283,9.341369,4.736198,4.60517,0,0,1,1.2003,4,0.9206,MORE
30,100,86,14,186,100,86,4.60517,4.454347,0.1508229,9.059517,4.60517,4.454347,0,0,1,2.2027,1,0.7391,MORE
30,150,174,24,324,174,150,5.010635,5.159055,0.14842,10.16969,5.159055,5.010635,1,1,1,1.5117,4,0.5122,MORE
30,126,150,24,276,150,126,4.836282,5.010635,0.1743534,9.846917,5.010635,4.836282,1,1,1,1.8242,3,1.2258,MORE
30,50,47,3,97,47,50,3.912023,3.850148,0.0618754,7.762171,3.850148,3.912023,1,0,0,2.8746,1,0.6933,MORE
30,150,147,3,297,147,150,5.010635,4.990433,0.02020271,10.00107,4.990433,5.010635,1,0,0,1.9133,3,0.6465,MORE
30,123,150,27,273,150,123,4.812184,5.010635,0.1984509,9.82282,5.010635,4.812184,1,1,1,1.8239,1,1.9819,MORE
30,50,57,7,107,50,57,3.912023,4.043051,0.1310283,7.955074,3.912023,4.043051,0,1,0,2.0598,1,1.0678,MORE
30,150,144,6,294,144,150,5.010635,4.969813,0.04082199,9.980449,4.969813,5.010635,1,0,0,1.3618,2,2.3526,MORE
30,144,150,6,294,144,150,4.969813,5.010635,0.04082199,9.980449,4.969813,5.010635,0,1,0,1.2845,2,3.2509,MORE
30,132,150,18,282,150,132,4.882802,5.010635,0.1278334,9.893437,5.010635,4.882802,1,1,1,1.0639,3,1.0268,MORE
30,45,50,5,95,45,50,3.806662,3.912023,0.1053605,7.718685,3.806662,3.912023,0,1,0,1.5371,3,1.0685,MORE
30,56,50,6,106,56,50,4.025352,3.912023,0.1133287,7.937375,4.025352,3.912023,0,0,1,3.6564,1,1.054,MORE
30,53,50,3,103,53,50,3.970292,3.912023,0.05826891,7.882315,3.970292,3.912023,0,0,1,2.0007,1,1.9293,MORE
30,168,150,18,318,150,168,5.123964,5.010635,0.1133287,10.1346,5.010635,5.123964,1,0,0,1.5176,2,1.0457,MORE
30,100,88,12,188,100,88,4.60517,4.477337,0.1278334,9.082507,4.60517,4.477337,0,0,1,1.6214,2,0.8095,MORE
30,45,50,5,95,50,45,3.806662,3.912023,0.1053605,7.718685,3.912023,3.806662,1,1,1,2.6565,1,0.8813,MORE
30,150,147,3,297,147,150,5.010635,4.990433,0.02020271,10.00107,4.990433,5.010635,1,0,0,2.4282,1,1.1037,MORE
30,50,51,1,101,50,51,3.912023,3.931826,0.01980263,7.843849,3.912023,3.931826,0,1,0,2.2743,1,0.9521,MORE
30,150,135,15,285,135,150,5.010635,4.905275,0.1053605,9.91591,4.905275,5.010635,1,0,0,1.427,3,1.7352,MORE
30,57,50,7,107,57,50,4.043051,3.912023,0.1310283,7.955074,4.043051,3.912023,0,0,1,1.8726,1,1.6491,MORE
30,47,50,3,97,50,47,3.850148,3.912023,0.0618754,7.762171,3.912023,3.850148,1,1,1,1.3031,4,0.6476,MORE
30,171,150,21,321,171,150,5.141664,5.010635,0.1310283,10.1523,5.141664,5.010635,0,0,1,2.5682,2,1.1076,MORE
30,135,150,15,285,150,135,4.905275,5.010635,0.1053605,9.91591,5.010635,4.905275,1,1,1,3.278,1,0.8471,MORE
30,50,58,8,108,58,50,3.912023,4.060443,0.14842,7.972466,4.060443,3.912023,1,1,1,1.4056,4,0.5194,MORE
30,129,150,21,279,150,129,4.859812,5.010635,0.1508229,9.870448,5.010635,4.859812,1,1,1,2.0135,4,1.1275,MORE
30,43,50,7,93,43,50,3.7612,3.912023,0.1508229,7.673223,3.7612,3.912023,0,1,0,2.8837,1,1.0647,MORE
30,100,116,16,216,100,116,4.60517,4.75359,0.14842,9.35876,4.60517,4.75359,0,1,0,3.0871,1,0.8318,MORE
30,159,150,9,309,150,159,5.068904,5.010635,0.05826891,10.07954,5.010635,5.068904,1,0,0,3.2152,2,2.4528,MORE
30,86,100,14,186,100,86,4.454347,4.60517,0.1508229,9.059517,4.60517,4.454347,1,1,1,2.256,3,1.1505,MORE
30,41,50,9,91,50,41,3.713572,3.912023,0.1984509,7.625595,3.912023,3.713572,1,1,1,2.7521,2,1.7364,MORE
30,50,42,8,92,50,42,3.912023,3.73767,0.1743534,7.649693,3.912023,3.73767,0,0,1,1.848,3,2.0501,MORE
30,150,153,3,303,153,150,5.010635,5.030438,0.01980263,10.04107,5.030438,5.010635,1,1,1,1.4379,4,1.9704,MORE
30,52,50,2,102,52,50,3.951244,3.912023,0.03922071,7.863267,3.951244,3.912023,0,0,1,1.6999,2,1.4711,MORE
30,150,120,30,270,120,150,5.010635,4.787492,0.2231436,9.798127,4.787492,5.010635,1,0,0,1.7569,2,1.1217,MORE
30,108,100,8,208,100,108,4.682131,4.60517,0.07696104,9.287301,4.60517,4.682131,1,0,0,1.6954,2,1.0453,MORE
30,162,150,12,312,150,162,5.087596,5.010635,0.07696104,10.09823,5.010635,5.087596,1,0,0,2.0231,3,0.7077,MORE
30,54,50,4,104,54,50,3.988984,3.912023,0.07696104,7.901007,3.988984,3.912023,0,0,1,1.214,2,1.0001,MORE
30,44,50,6,94,50,44,3.78419,3.912023,0.1278334,7.696213,3.912023,3.78419,1,1,1,1.2562,2,2.1913,MORE
30,106,100,6,206,106,100,4.663439,4.60517,0.05826891,9.268609,4.663439,4.60517,0,0,1,1.3649,2,1.1328,MORE
30,150,123,27,273,150,123,5.010635,4.812184,0.1984509,9.82282,5.010635,4.812184,0,0,1,2.0917,3,1.3392,MORE
30,50,40,10,90,40,50,3.912023,3.688879,0.2231436,7.600902,3.688879,3.912023,1,0,0,1.7776,2,0.7842,MORE
30,171,150,21,321,171,150,5.141664,5.010635,0.1310283,10.1523,5.141664,5.010635,0,0,1,1.9349,4,0.7122,MORE
30,150,141,9,291,141,150,5.010635,4.94876,0.0618754,9.959395,4.94876,5.010635,1,0,0,2.1595,1,0.8183,MORE
30,150,165,15,315,150,165,5.010635,5.105945,0.09531018,10.11658,5.010635,5.105945,0,1,0,1.542,1,1.067,MORE
30,100,92,8,192,92,100,4.60517,4.521789,0.08338161,9.126959,4.521789,4.60517,1,0,0,2.5003,2,1.3705,MORE
30,100,112,12,212,112,100,4.60517,4.718499,0.1133287,9.323669,4.718499,4.60517,1,1,1,1.8104,2,2.4739,MORE
30,177,150,27,327,177,150,5.17615,5.010635,0.1655144,10.18679,5.17615,5.010635,0,0,1,2.216,4,1.6174,MORE
30,50,44,6,94,44,50,3.912023,3.78419,0.1278334,7.696213,3.78419,3.912023,1,0,0,2.0961,2,2.1893,MORE
30,88,100,12,188,100,88,4.477337,4.60517,0.1278334,9.082507,4.60517,4.477337,1,1,1,1.7599,2,1.1248,MORE
30,100,104,4,204,104,100,4.60517,4.644391,0.03922071,9.249561,4.644391,4.60517,1,1,1,1.8174,2,0.8631,MORE
30,150,138,12,288,150,138,5.010635,4.927254,0.08338161,9.937889,5.010635,4.927254,0,0,1,2.1634,1,0.8397,MORE
30,100,90,10,190,90,100,4.60517,4.49981,0.1053605,9.10498,4.49981,4.60517,1,0,0,1.935,1,0.8011,MORE
30,42,50,8,92,50,42,3.73767,3.912023,0.1743534,7.649693,3.912023,3.73767,1,1,1,1.5765,4,0.9811,MORE
30,50,56,6,106,56,50,3.912023,4.025352,0.1133287,7.937375,4.025352,3.912023,1,1,1,1.4251,4,0.6144,MORE
30,54,50,4,104,54,50,3.988984,3.912023,0.07696104,7.901007,3.988984,3.912023,0,0,1,1.4278,3,1.5681,MORE
30,50,52,2,102,52,50,3.912023,3.951244,0.03922071,7.863267,3.951244,3.912023,1,1,1,1.3538,4,0.5507,MORE
30,120,100,20,220,120,100,4.787492,4.60517,0.1823216,9.392662,4.787492,4.60517,0,0,1,1.1552,3,1.0788,MORE
30,84,100,16,184,100,84,4.430817,4.60517,0.1743534,9.035987,4.60517,4.430817,1,1,1,1.2335,3,0.9505,MORE
30,150,132,18,282,150,132,5.010635,4.882802,0.1278334,9.893437,5.010635,4.882802,0,0,1,2.2467,1,1.02,MORE
30,50,46,4,96,46,50,3.912023,3.828641,0.08338161,7.740664,3.828641,3.912023,1,0,0,1.2212,4,0.6283,MORE
30,150,156,6,306,156,150,5.010635,5.049856,0.03922071,10.06049,5.049856,5.010635,1,1,1,1.4146,4,0.6126,MORE
30,150,168,18,318,168,150,5.010635,5.123964,0.1133287,10.1346,5.123964,5.010635,1,1,1,1.99,2,0.8144,MORE
30,50,57,7,107,57,50,3.912023,4.043051,0.1310283,7.955074,4.043051,3.912023,1,1,1,1.1218,4,0.5467,MORE
30,40,50,10,90,50,40,3.688879,3.912023,0.2231436,7.600902,3.912023,3.688879,1,1,1,1.1217,4,0.4985,MORE
30,50,59,9,109,50,59,3.912023,4.077537,0.1655144,7.98956,3.912023,4.077537,0,1,0,1.2905,2,1.5151,MORE
30,42,50,8,92,50,42,3.73767,3.912023,0.1743534,7.649693,3.912023,3.73767,1,1,1,1.1863,4,0.4665,MORE
30,57,50,7,107,57,50,4.043051,3.912023,0.1310283,7.955074,4.043051,3.912023,0,0,1,1.4205,2,0.9504,MORE
30,100,84,16,184,84,100,4.60517,4.430817,0.1743534,9.035987,4.430817,4.60517,1,0,0,1.5462,2,1.1381,MORE
30,150,168,18,318,168,150,5.010635,5.123964,0.1133287,10.1346,5.123964,5.010635,1,1,1,1.2227,3,0.9433,MORE
30,150,129,21,279,150,129,5.010635,4.859812,0.1508229,9.870448,5.010635,4.859812,0,0,1,1.4606,3,3.2005,MORE
30,50,48,2,98,48,50,3.912023,3.871201,0.04082199,7.783224,3.871201,3.912023,1,0,0,1.3584,2,1.1022,MORE
30,156,150,6,306,150,156,5.049856,5.010635,0.03922071,10.06049,5.010635,5.049856,1,0,0,1.1404,2,0.8478,MORE
30,100,98,2,198,100,98,4.60517,4.584967,0.02020271,9.190138,4.60517,4.584967,0,0,1,1.6758,1,0.9324,MORE
